path	sentence
crdo-NRU_F4_RENAMING_RenamingS031.wav	"tʰi˩˥, | gɯ˩-ʝi˥-dʑo˩ | tʰi˩˥, | ʈʂʰɯ˧ | zo˩no˥ | mv̩˧ ki˧-hĩ˧ tʰv̩˧-v̩˧-ki˧-dʑo˩ |
			tʰi˩˥, | njæ˧sɯ˩kv̩˩-dʑo˩, əəə… so˩kʰv̩˩-hĩ˥-ʈʂʰɯ˩-dʑo˩, ◊ ə˩-gi˩! |"
crdo-NRU_F4_CARAVANS_CaravansS286.wav	ʐwæ˩mi˩-tʰv̩˩-v̩˩˥ ◊ -dʑo˩ | tʰi˩˥, | ə˧mi˧=ɻæ˩-ɳɯ˩ | le˧-ʐɤ˧! |
crdo-NRU_AGRICULTURAL_ACTIVITIES_Agriculture_S079.wav	mɑ˩pv̩˩˥ | no˧ | ə˧-sɯ˥? | sɯ˧-ʝi˧ mæ˩! |
crdo-NRU_F4_HEALING_HealingS101.wav	hĩ˧ mo˥-hĩ˩-dʑo˩, | ʑi˧qʰwɤ˧-qo˧ | tʰv̩˧ne˧-ʝi˥ | tʰi˧-dzi˩. |
crdo-NRU_AGRICULTURAL_ACTIVITIES_Agriculture_S076.wav	<ə˧tso˧ mɤ˧-…> ə˧ʝi˧-ʂɯ˥ʝi˩-dʑo˩, | ɬi˧di˩-di˩mi˩ hɑ˩-dʑo˩, | ə˩kʰɯ˩-lɑ˥ ɲi˩ mæ˩! |
crdo-NRU_F4_TIGER2_Tiger2S132.wav	"""ə˧mi˧-ɳɯ˧ | no˧ qɑ˧~qɑ˥-bi˩! | no˧ | ɖwæ˩-mɤ˧-zo˧!"" | pi˧-zo˩. |"
crdo-NRU_F4_FOOD_SHORTAGE_FoodShortageS018.wav	"tʰi˩˥, | ɑ˩ʁo˧ | le˧-tʰv̩˧ | tʰi˩˥, | æ˧ʂæ˧-tɑ˩mv̩˩-dʑo˩, | əəə… ""mv̩˩ tɕʰi˩-bi˩-pi˥-hɯ˩-dʑo˩, | <di˩li˩-ʁo˩…> di˩li˩-ʁo˩bv̩˥ F | le˧-tʰv̩˧-ze˧, | mv̩˩ tɕʰi˩ le˥-wo˩-tsʰɯ˩!"", | pi˧-ɲi˥-tsɯ˩ ◊ -mv̩˩. |"
crdo-NRU_F4_FOOD_SHORTAGE2_FOOD_SHORTAGE2S025.wav	"əəə… 'mv̩˩ tɕʰi˩-bi˩-pi˥ hɯ˩-dʑo˩, | di˩li˩-ʁo˩bv̩˥ tʰv̩˩-ze˩! | zo˩no˥, | mv̩˩ tɕʰi˩ le˥-wo˩-tsʰɯ˩-ɲi˩'!"" |"
crdo-NRU_F4_DOG2_Dog2S021.wav	ʈʂʰɯ˧ne˧-ʝi˥ | tʰi˧-tɕɯ˧-ɲi˥-tsɯ˩ ◊ -mv̩˩. |
crdo-NRU_F4_FUNERAL_F4_FUNERAL_S199.wav	ɖɯ˧-tɕʰi˩-ɳɯ˩, | ʂe˧pʰæ˩ | ɖɯ˧-pʰæ˧˥! | ɖɯ˧-tɕʰi˩-ɳɯ˩, | ʂe˧pʰæ˩ | ɖɯ˧-pʰæ˧˥! |
crdo-NRU_F4_CARAVANS_CaravansS238.wav	"õ! ""tsʰe˧ | hwæ˧ le˧-po˧-jo˥, | li˩ hwæ˥ | le˧-po˧-jo˧! | pi˧, | ʈʂʰɯ˧-ki˧ |
			tʰi˧-hwɤ˩! | tɕɯ˧-pv̩˥-kʰɯ˩! |"
crdo-NRU_F4_ELDERS3_Elders3S059.wav	"ĩ˧! | ɬi˧di˩ dzi˩! | ə˧mi˧ | ɖɯ˧-v̩˧-lɑ˧ dʑo˧-ze˥! | …-dʑo˩ | tʰi˩˥, | ɖɯ˧-tɑ˧˥… | hĩ˧ mo˥-hĩ˩ | mɤ˧-dʑo˩-ze˩! | njæ˧sɯ˩kv̩˩, | zo˩no˥, | njæ˧sɯ˩kv̩˩, |
			<zo˧mv̩˥>[ʐv̩˧v̩˥-ʐv̩˩mi˩]-lɑ˩ dʑo˩-ze˩-mæ˩! |"
crdo-NRU_F4_DOG2_Dog2S032.wav	"tʰi˩˥, | zo˩no˥… | njæ˧sɯ˩kv̩˩ | hĩ˧mo˥=ɻæ˩-ɳɯ˩ | ɖɯ˧-njɤ˧ | ʐwɤ˩-kv̩˩˥ | mæ˩: | ""kʰv̩˩mi˩-ki˥-dʑo˩, | pʰv̩˩ɖɯ˩ ʝi˥-zo˩-kv̩˩!"" |"
crdo-NRU_F4_FOOD_SHORTAGE2_FOOD_SHORTAGE2S011.wav	tʰi˩˥, | ə˧mi˧-ɳɯ˧ | ʈʂʰɯ˧ne˧-ʝi˥ | pi˧-tsɯ˩ ◊ -mv̩˩:
crdo-NRU_F4_DOG2_Dog2S078.wav	ə˧mɑ˧ | zo˩no˥, | əəə… ə˧mɑ˧ | tʰi˧-dzi˩-hĩ˩ | tʰv̩˧-kʰwɤ˧-qo˩, | kʰv̩˩mi˩-ʈʂʰɯ˥ | tsʰe˩-kʰv̩˩-hĩ˥ | ɖɯ˧-v̩˧ | ʂɯ˧-dʑɯ˧! |
crdo-NRU_Naissance_du_Lac_V3_Lake3_S050.wav	tʰi˩˥, | dʑɯ˧-ɳɯ˧ | ɖɯ˧-tɑ˧˥ | ɳæ˧˥ | le˧-tsʰɯ˩-kwɤ˩tɕɯ˩-lɑ˩, | <pæ˧˥hwɤ˧> [kʰv̩˧tɕʰi˧] mɤ˧-dʑo˧ zo˩. |
crdo-NRU_F4_RENAMING_RenamingS034.wav	ə˧mi˧ tsʰɯ˩-pi˩, | ə˧mi˧ ʈʂɤ˧-ɲi˥-ze˩-mæ˩! |
crdo-NRU_F4_MUSHROOMS_MUSHROOMS_S163.wav	tʰi˧-tɕɯ˧-se˥-kwɤ˩tɕɯ˩-lɑ˩, | tʰi˩˥, | go˩-kwɤ˩tɕɯ˥-lɑ˩, | tʰv̩˧-kʰwɤ˥ | tʰi˧-ki˧ …kwɤ˧tɕɯ˥-lɑ˩ | tʰi˩˥, | <ts…> zo˩no˥, | zo˧mv̩˥ | tsʰe˧tʰv̩˧, | tʰææ̃˧-dʑo˩, | tʰææ̃˧ | tʰv̩˧-kʰwɤ˥ | ki˧-zo˩-kv̩˩-ɲi˩-ze˩!
crdo-NRU_F4_COMING_OF_AGE2_F4_ComingOfAge2S014.wav	ə˧dɑ˥-lɑ˩ | ə˧ʑi˧-ki˥ | le˧-bi˩-kv̩˩-ze˩-mæ˩! |
crdo-NRU_F4_HEALING_HealingS083.wav	ʈæ˧bɤ˧-ɳɯ˧, | ʈʂʰæ˧ɣɯ˧ | mɤ˧-ki˧; | dɑ˧pɤ˧-ɳɯ˧, | ʈʂʰæ˧ɣɯ˧ ki˩! | ə˩-ɲi˩˥? |
crdo-NRU_F4_HOUSEBUILDING2_HOUSEBUILDING2_S205.wav	wo˩-tɕæ˩ɻæ˥ tʰi˩-kʰɯ˩. |
crdo-NRU_F4_HEALING_HealingS072.wav	ʁo˧dɑ˧ | ɖɯ˧-so˩ kʰv̩˩-dʑo˩, | mɤ˧-dʑo˧-kwɤ˧tɕɯ˥-lɑ˩, | ɖɯ˧-njɤ˧ | ʈʂʰɯ˧ne˧-ʝi˥ | go˩-kv̩˩˥ ◊ -mæ˩! |
crdo-NRU_F4_MUSHROOMS_MUSHROOMS_S110.wav	tʰi˩˥, | zo˩no˧-dʑo˥, | ʐwɤ˩-mɤ˩-kv̩˥-hĩ˩ | ɖɯ˧-tɑ˧˥ | tʰi˧-dzɯ˥-dʑo˩! |
crdo-NRU_F4_FOOD_SHORTAGE2_FOOD_SHORTAGE2S048.wav	"""æ˧ʂæ˧ pi˧-kv̩˩-ni˩, | “di˩li˩-ʁo˩bv̩˥ tʰv̩˩-dʑo˩, | mv̩˩ tɕʰi˩ le˥-wo˩-tsʰɯ˩”-pi˩-kv̩˩!"" |"
crdo-NRU_F4_CARAVANS_CaravansS187.wav	"ʈʂʰɯ˧-ʑi˧=ɻ̍˧-ɳɯ˥, | ʁɑ˧ʂe˩-zo˩ | ŋwɤ˩-kv̩˩˥! | njɤ˧-bv̩˩ ŋwɤ˩-kv̩˩! | ʐwæ˧ |
			tsʰe˩-kv̩˩-hĩ˥-ʈʂʰɯ˩, | kʰv̩˧mæ˧-ɳɯ˧ | ɖɯ˧-tɑ˧˥ | le˧-ʈʂæ˧-po˥-hɯ˩-ɲi˩! |"
crdo-NRU_F4_COMING_OF_AGE2_F4_ComingOfAge2S045.wav	tʰi˩˥, | ʈʂʰɯ˧-ʑi˧=ɻ̍˧-ɳɯ˥, | tso˧~tso˧ ɖɯ˧-tɑ˧˥ | le˧-ʂo˧~ʂo˧ | po˧-jo˥! | tʰi˩˥, | ɬi˧-ki˥ ʈʰæ˩-ki˩ dʑi˩hṽ˩-ʈʂʰɯ˩-dʑo˩, | ʂe˧bæ˧, | ŋv̩˩-ʂe˩bæ˩-pi˥… | ʂe˧bæ˧ dʑo˧-kv̩˧˥ ◊ -mv̩˩! |
crdo-NRU_F4_CARAVANS_CaravansS186.wav	lo˧gv̩˩-hĩ˩ | ɖɯ˧-ʑi˩-bv̩˩ ɲi˩-tsɯ˩-zo˩! |
crdo-NRU_F4_CARAVANS_CaravansS012.wav	tʰv̩˧-v̩˧-dʑo˩, | lɑ˧do˧ mv̩˥ʈʂæ˩-kv̩˩-mæ˩! |
crdo-NRU_F4_FUNERAL_F4_FUNERAL_S189.wav	tʰi˩˥, | njɤ˧ | ə˧ʑi˧-se˥, | <njɤ˧… zo˩no˥…> njɤ˧=ɻ̍˩ | ɖɯ˧-tɑ˧˥ | əəə… ə˧v̩˧˥ | <ɖ… əəə…> zo˩no˥, | ə˧ʑi˧˥, əəə… | ə˧ʑi˧-se˥, | ʈæ˧bɤ˧ | <ʂ…> ɲi˧tsi˧-kv̩˧ ʁɑ˧ʂe˥-ɲi˩! |
crdo-NRU_F4_MOUNTAINS_F4_MountainsS157.wav	tʰi˩˥, | zo˧mv̩˥ | ʈʂʰɯ˧-qo˧-ɳɯ˧ | mv̩˩tɕo˧ ʈʂʰæ˧! | tʰi˧-hĩ˧-kʰɯ˥! |
crdo-NRU_AGRICULTURAL_ACTIVITIES_Agriculture_S045.wav	əəə… ɖɯ˧ɬi˧mi˧-qo˧-ɳɯ˧, | tv̩˧-ɲi˥ mæ˩! |
crdo-NRU_AGRICULTURAL_ACTIVITIES_Agriculture_S064.wav	mmm! ɖɯ˧-kʰv̩˧˥ | ɖɯ˧-ʂɯ˩-lɑ˩ mv̩˩-ɲi˩. |
crdo-NRU_F4_HOUSEBUILDING2_HOUSEBUILDING2_S233.wav	ə˧ʝi˧-ʂɯ˥ʝi˩, | nɑ˩-ʈʂʰɯ˥-dʑo˩, | tɑ˩˥fv̩˩˥ | pi˧-dʑo˩, | qʰæ˧ <-ʈʂʰɯ˧> do˧˥ | ɖwæ˩ ʝi˧-kv̩˥-ɲi˩ wɤ˩! |
crdo-NRU_F4_FOOD_SHORTAGE_FoodShortageS035.wav	dze˧ɭɯ˧-hɑ˧ɭɯ˧-ʈʂʰɯ˧-dʑo˩, | <zo˩no˧…> zo˩no˧-ni˩-zo˩, | ʈʂo˧ɭɯ˧-qo˩ | ʈʂo˧-hĩ˧ mɤ˧-ɲi˥-mæ˩! |
crdo-NRU_F4_TIGER2_Tiger2S003.wav	zo˩no˥, | mɤ˧-ni˩~ni˩-hĩ˩, | zo˩no˥, | ʈʂʰæ˩~ʈʂʰæ˩-qo˥, | zo˩no˥, | kwɤ˧wɤ˧ mɤ˧-ɲi˥-dʑo˩, | ʈʰæ˧-mɤ˥-kv̩˩-tsɯ˩ ◊ -mv̩˩!
crdo-NRU_F4_FOOD_SHORTAGE2_FOOD_SHORTAGE2S073.wav	"""ə˧mi˧! | ʈʂʰɯ˧ | zo˧ tɕʰi˧-bi˧-pi˧, | hɯ˧, | wɤ˩˥ | ʈʂʰɯ˧ | zo˧ ʈʂʰɯ˧-v̩˧ | ɑ˩ʁo˧ dʑo˩!"" | pi˧, | ʈʂʰɯ˧ne˧-ʝi˥ | ʐwɤ˧~ʐwɤ˩-dʑo˩. |"
crdo-NRU_F4_COMING_OF_AGE2_F4_ComingOfAge2S077.wav	ə˧mi˧… | ɖɯ˩-hĩ˩˥, | ɑ˩pʰo˩ dzɯ˩-hĩ˥, | ə˧mi˧ | ɖɯ˩-hĩ˩-ki˥ | bi˧! |
crdo-NRU_F4_MOUNTAINS_F4_MountainsS117.wav	hĩ˧ F | do˧-mɤ˧-dʑɯ˧-ɲi˥ F -dʑo˩, | do˧-mɤ˧-dʑɯ˧! |
crdo-NRU_F4_FOOD_SHORTAGE2_FOOD_SHORTAGE2S036.wav	le˧-tɕɤ˧˥ ◊ -dʑo˩ | tʰi˩˥, | gɤ˩˥ | le˧-tsɯ˥-dʑo˩, | tʰi˧-tɕɯ˥-kv̩˩ | mæ˩! |
crdo-NRU_F4_DOG2_Dog2S024.wav	"tʰi˩˥, | ""qʰv̩˩tsʰi˧-kʰv̩˥-ʁo˩to˩, | no˧sɯ˩kv̩˩ | ɖɯ˧-ɕi˧-kʰv̩˧ ɖɯ˧-bi˧, | no˧sɯ˩kv̩˩ | õ˧-bv̩˥-õ˩ ɲi˩-ze˩!"" |"
crdo-NRU_F4_FUNERAL_F4_FUNERAL_S039.wav	tʰi˩˥, | əəə… ʂe˧ʈʂe˩ | pʰv̩˩-hĩ˩-tʰv̩˩-ʁo˥! | pʰv̩˩tɕæ˩ɻæ˥-tʰv̩˩, | zo˩no˥, | əəə… ni˧fv̩˥ F | ɖɯ˧-ɭɯ˧ ʐv̩˧˥! |
crdo-NRU_F4_HEALING_HealingS059.wav	ʝi˧lv̩˧-bv̩˥ | ʈʂʰɻ̍˧ | ʈʰææ̃˧… | le˧-ʑi˩, | qwɤ˧-qo˧ | tʰi˧-qæ˧˥ ◊ -dʑo˩, ◊ ə˩-gi˩! |
crdo-NRU_F4_TIGER2_Tiger2S086.wav	lɑ˧-ʈʂʰɯ˧-ɳɯ˩, | ə˧mi˧-ʁæ˧ʈv̩˥ | tʰi˧-ʈʰæ˧˥ ◊ -tɕɯ˩-zo˩, | ɖɯ˧-ʈɤ˧, | ɖɯ˧-ʈɤ˧, | ɖɯ˧-ʈɤ˧-ɳɯ˧ | po˧-hɯ˥! |
crdo-NRU_F4_MOUNTAINS_F4_MountainsS142.wav	tʰi˩˥, | ʈʂʰɯ˧ne˧ ʝi˥-se˩-dʑo˩ | tʰi˩˥, | no˧sɯ˩kv̩˩, | əəə… æ˧ʂæ˧ gwɤ˩-bi˩-pi˩, | zo˧mv̩˥ | ʐwɤ˩-mɤ˩-kv̩˥-hĩ˩, | njæ˧sɯ˩kv̩˩, | æ˧ʂæ˧-ʈʂʰɯ˧-dʑo˩, | ə˧ʝi˧-ʂɯ˥ʝi˩, | æ˧ʂæ˧qʰwɤ˧-ʈʂʰɯ˥-dʑo˩, | hĩ˧ | ʈʂʰɯ˧ne˧-ʝi˥ | dʑo˧-ɲi˥-mæ˩! |
crdo-NRU_F4_CARAVANS_CaravansS236.wav	"njæ˧sɯ˩kv̩˩-ʁwɤ˩-qo˩, | ʐwæ˧ tɕɯ˩-hĩ˩, | njɤ˧ | ə˧v̩˧-lɑ˥ | ɖɯ˧-ʑi˩-lɑ˩ dʑo˩-ɲi˩! |
			ʐwæ˧-ʈʂʰɯ˧! |"
crdo-NRU_F4_FOOD_SHORTAGE_FoodShortageS057.wav	ə˧mɑ˧-lɑ˧ | ə˧dɑ˥ | tʰi˩˥ | ʝi˧-di˧ mɤ˧-dʑo˧˥! |
crdo-NRU_F4_ELDERS3_Elders3S002.wav	"tʰi˩˥, | ɖæ˩mi˧-ə˧lɑ˧ʁwɤ˧ | pi˧-hĩ˩-ʈʂʰɯ˩-dʑo˩, | zo˩no˥, | əəə… ɖæ˩mi˧ tʰi˧-di˩! |
			njæ˧sɯ˩kv̩˩, | tʰi˩˥, | ə˧ʝi˧-ʂɯ˥ʝi˩, | ə˧lɑ˧ʁwɤ˧ | pi˧, | ɖæ˩mi˧<-ɳɯ˧>-qo˧, |
			zo˩no˥… | hɤ˩-hĩ˩-ʈʂʰɯ˩-tɕi˥-ɳɯ˩, | ɖæ˩mi˧-ə˧lɑ˧ʁwɤ˧! pi˩-ɲi˩-tsɯ˩ ◊ -mv̩˩. |"
crdo-NRU_F4_MOUNTAINS_F4_MountainsS077.wav	tʰi˩˥, | njæ˧sɯ˩kv̩˩<-dʑ…>, | ə˧ʝi˧-ʂɯ˥ʝi˩, | ɬi˧di˩-di˩mi˩-qo˩-dʑo˩, | qv̩˧ɻ̍˧ ʈʂʰɯ˧-ɭɯ˧ ɖɯ˥-ʈʂɤ˩-kv̩˩-mæ˩! |
crdo-NRU_F4_HEALING_HealingS107.wav	"ʈʰæ˧ɻæ˩ so˩ | hɤ˩-hĩ˩˥ | mɤ˧-ʁo˥pv̩˩, | pi˧-dʑo˩ | tʰi˩˥, | wɤ˩˥ | mɤ˧-hɤ˩-ɲi˩-mæ˩!
			|"
crdo-NRU_Naissance_du_Lac_V3_Lake3_S025.wav	wɤ˩˥, | ʈʂʰɯ˧ | ʈʂʰɯ˧-qo˧ dzi˩-hɯ˩, | ʈʂʰɯ˧-qo˧ tʰi˧-li˧, | ʐo˩ dzɯ˩-ho˥-kwɤ˩tɕɯ˩-lɑ˩ | tʰi˩˥, |
crdo-NRU_F4_ELDERS3_Elders3S008.wav	so˧-ʑi˧-hĩ˧-ʈʂʰɯ˧ | tʰi˩˥, | ə˧lɑ˧-ʁwɤ˧ dzi˩. |
crdo-NRU_F4_FOOD_SHORTAGE2_FOOD_SHORTAGE2S052.wav	"""tʰi˩˥, | di˩li˩-ʁo˩bv̩˥ dzɯ˩! | əəə… tʰi˩˥, | hwɤ˧tɕi˥-ʁo˩bv̩˩ dzɯ˩."" |"
crdo-NRU_F4_CARAVANS_CaravansS050.wav	"ʈʂʰɯ˧ne˧-ʝi˥ | tʰi˩˥, | le˧-dʑo˧-ʁo˧-kwɤ˧tɕɯ˥-lɑ˩, | zo˧mv̩˥-ʈʂʰɯ˩ | le˧-hɤ˩; | le˧-ʂe˧,
			ɖɯ˧-ʁo˧-kwɤ˧tɕɯ˥-lɑ˩ | tʰi˩˥, | əəə… li˩˥ | le˧-tɕɯ˧-le˥-po˩-tsʰɯ˩! | tsʰe˧ |
			<le˧…> le˧-tɕɯ˧-le˥-po˩-tsʰɯ˩! | ʈʂʰɯ˧ne˧-ʝi˥ ◊ -kwɤ˩tɕɯ˩-lɑ˩, |"
crdo-NRU_Naissance_du_Lac_V3_Lake3_S024.wav	ʈʂʰɯ˧ | tʰv̩˧qo˧ dzi˩, | ɑ˩ʁo˧-hĩ˧ | ɖɯ˧-v̩˧ dʑo˥, | dɤ˧˥ | [ʈʂʰɯ˧]qo˧ | si˧dzi˩-ʈʰæ˩qo˩ | tʰi˧-li˧,
crdo-NRU_F4_FOOD_SHORTAGE_FoodShortageS042.wav	mv̩˧dze˧ | le˧-lɑ˧˥ ◊ -dʑo˩ | tʰi˩˥, | mv̩˧dze˧-ʈʂʰɯ˧ | mmm… mv̩˧ʈʂv̩˩-qo˩-ɳɯ˩ | le˧-ti˩! |
crdo-NRU_F4_TIGER2_Tiger2S095.wav	"""no˧ | njɤ˧ le˧-ʂv̩˧-jo˧!"" | pi˧-zo˩, | mv̩˩zo˩-ɳɯ˥ | ɖɯ˧-njɤ˧ | ŋv̩˩-ɲi˥-pi˩-tsɯ˩ ◊ -mv̩˩!"
crdo-NRU_F4_SEEDS_SeedsS023.wav	mv̩˩zɯ˩-ʈʂʰɯ˥-dʑo˩, | ʐwæ˧-mɤ˧-zo˧-ɲi˥! | əəə… tv̩˧-mɤ˧-zo˧-ɲi˥! |
crdo-NRU_AGRICULTURAL_ACTIVITIES_Agriculture_S002.wav	tʰi˩˥, | tsʰi˧ʝi˧ | ɖɯ˧-kʰv̩˧˥, | kʰv̩˧ʂɯ˥ <se˩>-ʁo˩to˩, ◊ ə˩-gi˩! |
crdo-NRU_F4_MUSHROOMS_MUSHROOMS_S127.wav	tɕɤ˧qʰɑ˧-mo˩-lɑ˩, | əəə… kʰwɤ˧pʰv̩˧-mo˧-ʈʂʰɯ˥-dʑo˩, | hĩ˧ dv̩˥-mɤ˩-kv̩˩! |
crdo-NRU_F4_MOUNTAINS_F4_MountainsS127.wav	tʰi˩˥, | ʈʰv̩˧-kʰɯ˧-qo˥-ɳɯ˩-dʑo˩, | ə˧ʝi˧-ʂɯ˥ʝi˩, | ʈʂʰɯ˧ne˧-ʝi˥ | le˧-tsʰɯ˩, | nɑ˩tsʰi˩˥, | nɑ˩tsʰi˩-ki˥-ɳɯ˩, | əəə… nɑ˩tsʰi˩˥, | əəə… <bo˩mi˧…> | əəə… ʐwæ˧pv̩˩-dzi˩. |
crdo-NRU_F4_MUSHROOMS_MUSHROOMS_S093.wav	mi˩zɯ˩˥ | ɖɯ˧-v̩˧ dʑo˩-dʑo˩, | tʰi˩˥, | gɯ˩-ʝi˥-dʑo˩, | zo˧mv̩˥ dʑo˩-tsɯ˩-mv̩˩, | ʈʂʰɯ˧-ʑi˧=ɻ-ɳɯ˥, | ʈʂʰɯ˧ne˧-ʝi˥ | pi˧-tsɯ˩-mv̩˩: |
crdo-NRU_Mariage_De_La_Soeur_V3_Sister3_S036.wav	ʂe˧-ʈʂʰɯ˧, | bo˩-ɬo˧-ʈʂʰɯ˩, | ɖɯ˧-pʰæ˧˥, | ɖɯ˧-ɭɯ˧, | ɖɯ˧-ɭɯ˧, | ɖɯ˧-ɭɯ˧ | hæ̃˩-kv̩˥-ze˩ mæ˩! | ɖɯ˩-hĩ˩-ki˥-dʑo˩, | ɖɯ˩-hĩ˩ tʰi˥-ki˩; |
crdo-NRU_Mariage_De_La_Soeur_V3_Sister3_S098.wav	ʈʂʰɯ˧ go˧mi˧ | tʰi˧-qæ˧-hĩ˥ | tʰv̩˧qo˧ tʰv̩˧-dʑo˧, | tʰi˩˥, | <mmm…>
crdo-NRU_F4_ELDERS3_Elders3S047.wav	tʰi˩˥, | hĩ˧-ʈʂʰɯ˧, | mɤ˧-dʑɤ˩-hĩ˩ so˩, | pi˧, | hĩ˧ | dʑɤ˩˥ | mɤ˧-kv̩˧˥! |
crdo-NRU_F4_FOOD_SHORTAGE_FoodShortageS109.wav	<ə˧ʝi˧-tsʰi˧ʝi˧-dʑo˩> ə˧ʝi˧-ʂɯ˥ʝi˩-dʑo˩, | ɖɯ˧-kʰv̩˧˥ | dzɑ˩qʰwɤ˩˥ | ɖɯ˧-dzi˧-lɑ˧ dʑo˥-kv̩˩! |
crdo-NRU_F4_COMING_OF_AGE2_F4_ComingOfAge2S067.wav	ʂe˧ʐe˧-ʂe˧sɑ˥ tʰi˩-po˩! | ʐɯ˧ tʰi˧-po˧˥! | ʈʂʰɯ˧ne˧-ʝi˥ | le˧-bi˩! | ɬo˧pv̩˥ | le˧-ti˩! |
crdo-NRU_F4_MOUNTAINS_F4_MountainsS118.wav	njɤ˧ | ə˧si˧-ɳɯ˧ | <ɖɯ˧…> ʈʂʰɯ˧ne˧-ʝi˥ | ʐwɤ˩-kv̩˩˥! |
crdo-NRU_F4_ELDERS3_Elders3S068.wav	"tʰi˩˥, | ʈʂʰɯ˧ne˧ ʝi˥-se˩-kwɤ˩tɕɯ˩-lɑ˩ | tʰi˩˥, | zo˩no˧-dʑo˥, | ə˧si˧ mɤ˧-dʑo˩ |
			tʰi˩˥, | njæ˧sɯ˩kv̩˩ | le˧-ɖɯ˩! |"
crdo-NRU_F4_ELDERS3_Elders3S069.wav	hĩ˧ mo˥-hĩ˩ | mɤ˧-dʑo˩-ze˩-mæ˩! | ə˧mi˧ ɖɯ˧-v̩˧-lɑ˧ dʑo˧-ze˥! |
crdo-NRU_F4_RENAMING_RenamingS030.wav	"tʰi˩˥, | ""ʁɑ˩mi˧!"" | pi˧, | le˧-hɯ˩-dʑo˩, | gɯ˩-ʝi˥, | tʰv̩˧-hɑ̃˩-dʑo˩, | zo˧hṽ̩˧-ɳɯ˥
			| mɤ˧-ŋv̩˩-tsɯ˩ ◊ -mv̩˩!"
crdo-NRU_Mariage_De_La_Soeur_V3_Sister3_S045.wav	gɤ˩-ʑi˥! | ʈʂʰɯ˧ne˧-ʝi˥ | ɖɯ˧-v̩˧~ɖɯ˧-v̩˧ | gɤ˩-ʑi˥, | mæ˧qo˩ tʰv̩˩-kwɤ˩tɕɯ˩-lɑ˩, | tʰi˩˥, | ʈʂʰɯ˧ ə˧mv̩˩-ʈʂʰɯ˩, | ə˧mv̩˩-ki˩ tʰv̩˩-kwɤ˩tɕɯ˩-lɑ˩, | ə˧mv̩˩ | ʈʂʰɯ˧ne˧-ʝi˥ | pi˧-tsɯ˩ ◊ -mv̩˩: |
crdo-NRU_F4_FUNERAL_F4_FUNERAL_S228.wav	"tʰi˩˥, | ʈʂʰɯ˧ne˧-ʝi˥ | qʰæ˧-bi˥-dʑo˩ | tʰi˩˥, | ""ə˧mi˧! | ʈʂʰɯ˧=ɻ̍˩, | hĩ˧ ʂɯ˧-ze˩; | njɤ˧=ɻ̍˩ | ə˧ʝi˧-ʂɯ˥ʝi˩ | ʈʂʰɯ˧-bv̩˩ | pɤ˩jɤ˧ qʰæ˥-ɲi˩! |"
crdo-NRU_F4_HOUSEBUILDING2_HOUSEBUILDING2_S343.wav	wɤ˩˥, | ɲi˧ʈʂæ˧ʑi˧˥ | ɖɯ˧-ɭɯ˧ dɑ˧˥! |
crdo-NRU_F4_TIGER2_Tiger2S103.wav	"""dʑɯ˩nɑ˩mi˩˥ | ʈʂʰɯ˧-ʂwæ˧~ʂwæ˧-hĩ˧-qo˩, | ə˧tse˧ ʝi˧ | no˧-tɑ˧kɤ˥ | se˧-ɲi˥?"" | pi˧-tsɯ˩ ◊ -mv̩˩. |"
crdo-NRU_F4_HOUSEBUILDING2_HOUSEBUILDING2_S008.wav	mv̩˩si˧-njɤ˧˥ | njɤ˧-lɑ˥ F | bi˧! | æ˩ mɤ˧-ʈwɤ˧ | bi˧! | əəə… tv̩˧tsʰɯ˧ | ŋwɤ˩-ɭɯ˩-qo˥ | bi˧! |
crdo-NRU_F4_HOUSEBUILDING2_HOUSEBUILDING2_S280.wav	tʰi˩˥, | tsʰi˧qʰæ˧-se˥, | ə˧tso˧ mɤ˧-ɲi˩ | dʑo˧-ze˧ | wɤ˩˥! | ə˧tso˧ mɤ˧-ɲi˩ ʁæ˩bæ˩ | dʑo˧, ◊ ə˩-gi˩! |
crdo-NRU_F4_CARAVANS_CaravansS047.wav	dʑɯ˩ʁo˩˥ | si˧kʰɯ˧-ʈʂʰɯ˧ | le˧-qwæ˧-le˥-po˩-tsʰɯ˩-dʑo˩, ◊ ə˩-gi˩! | li˩-mɤ˩-dʑo˩˥, | ɖɯ˧-njɤ˧ | ə˧mɑ˧ ə˧mi˧-ki˧ le˧-tɕɤ˧˥, | ʈʰɯ˩-ɲi˥-tsɯ˩ ◊ -mv̩˩!
crdo-NRU_F4_MOUNTAINS_F4_MountainsS170.wav	zo˩no˥, | njæ˧sɯ˩kv̩˩, | ʁɑ˩ʂɯ˧, | æ˧ʂæ˧ | gwɤ˩-kʰi˥-ɲi˩! |
crdo-NRU_F4_FUNERAL_F4_FUNERAL_S009.wav	le˧-ti˩-bi˩-se˩ | | tʰi˩˥, | ɖɯ˧-ʑi˩-ɳɯ˩, | hĩ˧ | ɖɯ˧-v̩˧ jo˧-kv̩˧˥ ◊ -mæ˩! |
crdo-NRU_F4_ELDERS3_Elders3S055.wav	əəə… zo˩no˧-dʑo˥, | zo˧ ɖɯ˧-v̩˧ mɤ˧-dʑo˩-ze˩! |
crdo-NRU_F4_FOOD_SHORTAGE2_FOOD_SHORTAGE2S004.wav	tʰi˩˥, | ɖɯ˧-ɲi˧-ɻ̍˧-dʑo˩, | hɑ˧-ʈʂʰɯ˧ | tɕʰɤ˧tɕʰɤ˧˥ | dzɯ˧-di˧ mɤ˧-dʑo˧˥, | ɖɯ˧-so˩ ɲi˩ gv̩˩-tsɯ˩ ◊ -mv̩˩. |
crdo-NRU_F4_TIGER2_Tiger2S126.wav	le˧-wo˥ | wɤ˩˥ | ɬi˧di˩ | le˧-tsʰɯ˩-dʑo˩, | tʰi˩˥, | gi˩˥, | gi˩˥, | gi˩˥ ◊ -dʑo˩, | mmm…
crdo-NRU_F4_CARAVANS_CaravansS042.wav	"ɑ˩ʁo˧… | æ˧ʂæ˧-tɑ˩mv̩˩, | ʈʂʰɯ˧ne˧-ʝi˥ | gwɤ˩-kv̩˩˥ ◊ -mæ˩: | ""ʂæ˧~ʂæ˩ | li˩ tɕɯ˧-le˥-po˩-tsʰɯ˩, | ə˧mɑ˧ mɤ˧-dʑo˩, | mɤ˧-gɤ˩-ze˩!"" | pi˧-zo˩. |"
crdo-NRU_F4_CARAVANS_CaravansS125.wav	"ə˧ʝi˧-ʂɯ˥ʝi˩-dʑo˩, | ɑ˩ʁo˧ ɬi˧di˩-ɳɯ˩ bi˩, | lo˧ʂv̩˩ hɑ̃˩-kv̩˩-ze˩-mæ˩! | ʐwæ˧ tɕɯ˩!
			|"
crdo-NRU_F4_DOG2_Dog2S050.wav	tʰv̩˧ɲi˧, | bo˩˥ | le˧-qʰo˧˥ ◊ -pi˩, | kʰv̩˩mi˩-ki˥, | əəə… s… sɤ˧ | tʰi˧-ʈʰɤ˩~ʈʰɤ˩-hĩ˩, | ʈʂʰɯ˧-ʈʰɤ˥, | hi˧lɤ˩ | tʰi˧-jɤ˩~jɤ˩-kʰɯ˩. |
crdo-NRU_F4_HOUSEBUILDING2_HOUSEBUILDING2_S020.wav	tʰi˩˥, | ɖɯ˧-tɑ˧˥… | ə˧tso˧-mɤ˧-ɲi˩, | tʰi˧-tsʰo˥-kʰɯ˩! |
crdo-NRU_F4_FOOD_SHORTAGE_FoodShortageS076.wav	ĩ˧! | ɣɯ˧ | le˧-dɑ˩! | ɣɯ˧ | le˧-dɑ˩ | <ʈʂʰɯ˧ʂ… ʁo… hwɤ˧…> ʈʂʰɯ˧-hwɤ˧~hwɤ˧-lɑ˩ gv̩˩-kv̩˩! | ɣɯ˧dzo˩! |
crdo-NRU_F4_RENAMING_RenamingS045.wav	æ˧ʂæ˧-dʑo˩, | ʈʂʰɯ˧ne˧-ʝi˥ | dʑo˧-kv̩˧˥ ◊ -wɤ˩!
crdo-NRU_F4_TIGER2_Tiger2S128.wav	"""ɖɯ˧-zɯ˧ | qʰwæ˧kʰwɤ˧ tsɤ˧-ze˩!"" | pi˧-zo˩, | tɕʰɤ˧ɲi˧ni˧˥ | ŋv̩˩-ɲi˥-tsɯ˩ ◊ -mv̩˩!"
crdo-NRU_F4_SEEDS_SeedsS046.wav	dze˧ʈʂʰɤ˥! | hĩ˧ | le˧-qæ˧˥ | ɖɯ˧-ɲi˥-dʑo˩, ə˩-gi˩! | hĩ˧ | le˧-qæ˧˥ | ɖɯ˧-ɲi˥ F | dze˧ʈʂʰɤ˥ | ŋwɤ˩-bæ˩ dʑo˩˥ ◊ -dʑo˩ | tʰi˩˥, | mmm… zɯ˧-ʈʂʰɯ˧, | zɯ˧-kʰɯ˧ʈɯ˥ | ʈʂʰɯ˧-dʑo˩, | mmm… zɯ˧-qʰɑ˧mi˧ | pi˧-kv̩˩! |
crdo-NRU_F4_FOOD_SHORTAGE_FoodShortageS016.wav	"<hw…> hwɤ˧tɕi˥-ʈʂʰɯ˩ | ʈʂʰɯ˧ne˧-ʝi˥ | gɤ˩-ʑi˧-lɑ˧ gv̩˩-sɯ˩-dʑo˩, | tʰi˩˥, | mmm… tʰi˧-di˩-dʑo˩, | ""ə˧mi˧! | ə˧mi˧! | zo˧ tɕʰi˧ tʰɑ˧-kv̩˧~kv̩˥, | ə˧zɯ˩!"" |"
crdo-NRU_F4_MOUNTAINS_F4_MountainsS033.wav	"""æ˧bv̩˧-ʂe˧bv̩˥, | õ˧˥ | tso˩ ʁo˩˥ | -ɲi˩!"""
crdo-NRU_F4_MUSHROOMS_MUSHROOMS_S142.wav	ə˧ʝi˧-tsʰi˧ʝi˧-dʑo˩, | sɑ˧tsʰv̩˩ | tʰæ˧ɻæ˧ dzɯ˧-tʰɑ˥, ◊ ə˩-gi˩!
crdo-NRU_F4_TIGER2_Tiger2S014.wav	tsʰi˧ʝi˧-dʑo˩ | tʰi˩˥, | no˧ | ɖɯ˧-pi˧˥ | mɤ˧-dʑɤ˩-ɲi˩! |
crdo-NRU_F4_MOUNTAINS_F4_MountainsS011.wav	"""æ˧bv̩˧-ʂe˧bv̩˥ F | tso˩-ʁo˩-hĩ˥-hĩ˩ tʰi˩-dzi˩-ɲi˩!"" | pi˧-dʑo˩ | tʰi˩˥, | ɖɯ˧-ɲi˥ F -dʑo˩… | ə˧tso˧-mɤ˧-ɲi˩, | dʑo˧! |"
crdo-NRU_F4_FUNERAL_F4_FUNERAL_S051.wav	"gɤ˩-ʈi˧, | li˩ tɕɤ˧˥ ◊ -kwɤ˩tɕɯ˩-lɑ˩, | əəə… ""no˧ | li˩ ʈʂwæ˧˥!"" | pi˧, | le˧-ɻwæ˥, | ʈʂʰɯ˧-v̩˧-ki˧!"
crdo-NRU_F4_MUSHROOMS_MUSHROOMS_S067.wav	tʰi˩˥, | ʈʂʰɯ˧ne˧-ʝi˥ | v̩˧ | ɖɯ˧-ɭɯ˧-qo˧-ɳɯ˧ | ɖɯ˧<-ɭɯ˧>-kʰwɤ˥-sɯ˩ | tʰi˧-tɕɤ˧˥!
crdo-NRU_F4_MOUNTAINS_F4_MountainsS092.wav	kɤ˧mv̩˧-ki˥-ɳɯ˩ | gɤ˩-pɤ˧-dʑo˩ | tʰi˩˥, | gɤ˩-pɤ˧-kwɤ˩tɕɯ˩-lɑ˩, | <ʂ…> ʂwæ˧gv̩˧-bi˥ lɑ˩-kwɤ˩tɕɯ˩-lɑ˩, | ʈʂʰɯ˧ne˧-ʝi˥ | ɖɯ˧-kʰwɤ˥-sɯ˩ | tʰi˧-lɑ˧-kv̩˥-mæ˩! | ɲi˧mi˧-kʰɯ˧ʂɯ˧-tʰv̩˧! |
crdo-NRU_F4_HEALING_HealingS002.wav	"le˧-go˩, | kʰv̩˧tɕʰi˥ | mɤ˧-dʑo˧-dʑo˥, | ə˧ʝi˧-ʂɯ˥ʝi˩-dʑo˩, | tʰi˩˥, | ə˧tso˧ ʝi˧-ɲi˥
			| mɤ˧-sɯ˥-mæ˩, ◊ ə˩-gi˩! | ɬo˧kʰv̩˧ qæ˧-pi˥-kv̩˩-mæ˩, | hĩ˧-ʈʂʰɯ˧! |"
crdo-NRU_F4_COMING_OF_AGE2_F4_ComingOfAge2S096.wav	tʰi˩˥, | əəə… ʁo˧dɑ˧-se˥, | əəə… ə˧ʝi˧-ʂɯ˥ʝi˩, | hĩ˧ | le˧-qʰo˩-hĩ˩, | tɑ˩hwɤ˩-kv̩˥-mæ˩! | hĩ˧-mo˥-hĩ˩-ki˩! |
crdo-NRU_F4_RENAMING_RenamingS044.wav	"ə˧si˧-ɳɯ˧ | ɻwæ˧-kv̩˩-mæ˩! | ə˧si˧, | ə˧pʰv̩˧-ɳɯ˧ | ɻwæ˧-kv̩˩mæ˩! | zo˧mv̩˥ |
			tɕi˩-hĩ˩-dʑo˥! | mv̩˧ ʂe˧, | ʈʂʰɯ˧ne˧-ʝi˥ | ʂe˧-kv̩˧˥! |"
crdo-NRU_F4_MUSHROOMS_MUSHROOMS_S154.wav	tsʰe˧tʰv̩˧ kv̩˧-hĩ˥ ɖɯ˩-ʁo˩ | dʑo˧-ɲi˥ mæ˩! |
crdo-NRU_F4_FOOD_SHORTAGE_FoodShortageS039.wav	dze˧dv̩˩-pɤ˩jɤ˩ pi˩! | <ɖɯ˧…> hĩ˧ v̩˧ ɖɯ˧-ɭɯ˧, | ɖɯ˧-ɭɯ˧, | ɖɯ˧-ɭɯ˧, | ɖɯ˧-ɭɯ˧, | ĩ˧! | dze˧dv̩˩-pɤ˩jɤ˩! | hĩ˧ v̩˧ ɖɯ˧-ɭɯ˧~ɖɯ˧-ɭɯ˧ | tʰi˧-qʰæ˧˥! |
crdo-NRU_F4_COMING_OF_AGE2_F4_ComingOfAge2S076.wav	tʰi˩˥, | le˧-jo˩-dʑo˩ | tʰi˩˥… | le˧-tsʰɯ˩-se˩-kwɤ˩tɕɯ˩-lɑ˩ | tʰi˩˥, | ɑ˩ʁo˧ | hĩ˧-tɕʰɯ˧ - hĩ˧-ʈʂɤ˧ | wɤ˩˥ | ɲi˩=ɻ̍˥ dʑo˩-dʑo˩, | bi˧-kv̩˧-ze˥-mæ˩! |
crdo-NRU_F4_MUSHROOMS_MUSHROOMS_S076.wav	dʑɯ˩-ʁo˩˥, | tʰv̩˧ | le˧-pɤ˥~pɤ˩ le˩-po˩-jo˩, | wɤ˩˥ | ʈʂʰæ˧ɣɯ˧ ʂe˩-zo˩-kv̩˩-mæ˩! |
crdo-NRU_AGRICULTURAL_ACTIVITIES_Agriculture_S032.wav	tʰi˩˥, | le˧-tsɑ˩~tsɑ˩! | tʰi˩˥, | le˧-tsɑ˩~tsɑ˩-se˩ | tʰi˩˥ | le˧-tv̩˧! |
crdo-NRU_F4_CARAVANS_CaravansS254.wav	"""njɤ˧=ɻ̍˩ | ʈʂʰɯ˧-ʂɯ˥-dʑo˩, | qʰwɤ˩ tɕɯ˥ | le˧-po˧-tsʰɯ˧˥!"" | əəə… ""ʂe˧ʈʂe˩ tɕɯ˩ |
			le˧-po˧-tsʰɯ˧˥!"" | pi˧. |"
crdo-NRU_F4_TIGER2_Tiger2S143.wav	"mv̩˩zo˩-ɳɯ˥: | ""njɤ˧ | ə˧mɑ˧-ɳɯ˧ | njɤ˧-ki˧ | ʈʂʰɯ˧ne˧-ʝi˥ | ʐwɤ˩-dʑɯ˩˥ ◊ -ɲi˩: | mmm… 'ə˧dɑ˧-ə˧mi˧-dʑo˩, õ˧-zɯ˧ pv̩˥-mɤ˩-kv̩˩! | õ˧˥ | tʰi˧-dʑo˩-hĩ˩-dʑo˩, | <ʂɯ˧-bi˧-dʑo˧, sɯ.gɯ…> le˧-ʂɯ˧-hĩ˧-gi˩-dʑo˩, | le˧-sɯ˩-hĩ˩, | bi˧-hĩ˩-mɤ˩-kv̩˩!' |"""
crdo-NRU_AGRICULTURAL_ACTIVITIES_Agriculture_S022.wav	qʰv̩˧ɬi˧mi˧, | ʂɯ˧ɬi˧mi˧, … | hõ˧ɬi˧mi˧! | hõ˧ɬi˧mi˧-<kʰɤ˧ʂɯ˧> [-ʁo˧ʑi˧˥], | wɤ˩˥ | jɤ˩jo˧ | <le˧-qwæ˩~qwæ˩> [le˧-qwæ˧ le˥-po˩-tsʰɯ˩]. |
crdo-NRU_F4_FOOD_SHORTAGE2_FOOD_SHORTAGE2S089.wav	ʈʂʰɯ˧ne˧ ʝi˥-kwɤ˩tɕɯ˩-lɑ˩ | tʰi˩˥, | æ˧ʂæ˧-tɑ˩mv̩˩-dʑo˩: |
crdo-NRU_F4_HOUSEBUILDING2_HOUSEBUILDING2_S017.wav	tʰi˩˥, | le˧-se˩-kwɤ˩tɕɯ˩-lɑ˩ | tʰi˩˥, | qæ˧do˧ | le˧-dɑ˧˥ | le˧-tʰv̩˧, | <ŋwɤ˧-pʰæ˧˥ | le˧… əəə…> gv̩˩pʰæ˩˥ | le˧-qɑ˩, | le˧-tʰv̩˧, | le˧-se˩-dʑo˩ | tʰi˩˥, | wɤ˩˥ | ɑ˩ʁo˧ | …-qo˧lo˩! |
crdo-NRU_F4_TIGER2_Tiger2S049.wav	hɑ˧ | <le… bv… le…> [ɑ˩ʁo˧ | õ˧-bv̩˥-õ˩] le˧-gv̩˩-hĩ˩ | ɖɯ˧-kʰwɤ˥ po˩, ◊ ə˩-gi˩! |
crdo-NRU_F4_HEALING_HealingS005.wav	zo˩no˥, | ʝi˧se˧-ɲi˩-pi˩, | ə˧tso˧ ɲi˩-pi˩-ʝi˩ | mɤ˧-do˩-mæ˩, ◊ ə˩-gi˩! |
crdo-NRU_F4_HOUSEBUILDING2_HOUSEBUILDING2_S061.wav	hĩ˧=ɻæ˥, | hĩ˧ hɤ˥-hĩ˩-ɳɯ˩ | dɑ˧˥, | pi˧-dʑo˩ | tʰi˩˥, | ʈʂʰwæ˩˥ | le˧-dɑ˩~dɑ˩, | tʰv̩˧-ɲi˥-ze˩! |
crdo-NRU_F4_RENAMING_RenamingS001.wav	ə˧ʝi˧-ʂɯ˥ʝi˩-dʑo˩, ◊ ə˩-gi˩! | zo˧mv̩˥-ʈʂʰɯ˩-dʑo˩, | əəə… zo˩no˥… | ə˧ʑi˧˥… | hĩ˧ | le˧-mo˩-hĩ˩, | le˧-mo˩-hĩ˩-ʈʂʰɯ˩ | tʰi˩˥, |
crdo-NRU_F4_HOUSEBUILDING2_HOUSEBUILDING2_S172.wav	tʰi˩˥, | so˧ʝi˥-dʑo˩ | wɤ˩˥ | ɑ˩ʁo˧ le˧-tʰv̩˧-dʑo˥, | ʑi˧qʰwɤ˧ tsʰi˧˥, | pi˧-kv̩˩ mæ˩! |
crdo-NRU_F4_FUNERAL_F4_FUNERAL_S236.wav	əəə… bi˧tɕo˧-hĩ˧-ki˧ F | tʰi˧-ki˧! |
crdo-NRU_F4_CARAVANS_CaravansS219.wav	kv̩˧tsʰɑ˥-ki˩ dzi˩-pv̩˩-kʰɯ˩-dʑo˩ | tʰi˩˥, | ʐwæ˧ tɕɯ˩! |
crdo-NRU_Mariage_De_La_Soeur_V3_Sister3_S023.wav	«tse˩ʈʂʰv̩˩-kʰv̩˥», | pi˧, | ɖɯ˧-njɤ˧ | mɤ˧-hɯ˧, | kʰv̩˩mi˩-ɳɯ˥ | mæ˧qo˩ | tʰi˧-dzi˩-ɳɯ˩ | tʰi˧-dzi˩, | pi˧-tsɯ˩ ◊ -mv̩˩. |
crdo-NRU_Mariage_De_La_Soeur_V3_Sister3_S112.wav	mi˩zɯ˩˥ | ʈʂʰɯ˧-dʑo˩ | hĩ˧-ki˧-ki˩ | pi˧-dʑo˩, | mmm… | æ˧ʂæ˧ | ʈʂʰɯ˧ne˧-ʝi˥ | pi˧-ɲi˥-mæ˩: |
crdo-NRU_F4_CARAVANS_CaravansS128.wav	ɬi˧di˩-lɑ˩ | lo˧gv̩˩, | so˩-hɑ̃˩ tʰi˥-hɑ̃˩-kv̩˩, | ə˧ʝi˧-ʂɯ˥ʝi˩! | so˩-hɑ̃˩˥! |
crdo-NRU_Mariage_De_La_Soeur_V3_Sister3_S141.wav	ə˧mv̩˧-go˧mi˥ F | pi˧-hĩ˧ | ʈʂʰɯ˧-dʑo˩ | tʰi˩˥, | ↑zo˧-dʑo˩ | tʰi˩˥, | <g…> ni˧mi˧-ki˧-dʑo˩, | go˧mi˧ pi˧-ɲi˥-ze˩-mæ˩! |
crdo-NRU_F4_MOUNTAINS_F4_MountainsS100.wav	əəə… | ŋwɤ˧hɑ̃˩-lɑ˩ | ʂwæ˧gv̩˧-ʈʂʰɯ˧ | wɤ˩˥ | pʰæ˧~pʰæ˧=ɻ̍˩ ɲi˩-kv̩˩-tsɯ˩ ◊ -mv̩˩!
crdo-NRU_F4_TIGER2_Tiger2S127.wav	"""ə˧mi˧! | õ˧˥, | qʰɑ˩ne˩˥ | õ˧-zɯ˧ bv̩˥-tso˩-ɲi˩? | õ˧-ə˧mi˥ F | lɑ˧-ɳɯ˧ | le˧-ʈʰæ˧-ɲi˥!"""
crdo-NRU_F4_HOUSEBUILDING2_HOUSEBUILDING2_S016.wav	tʰi˩˥, | ʈʂʰɯ˧ne˧-ʝi˥-kwɤ˩tɕɯ˩-lɑ˩ | tʰi˩˥, | <ŋwɤ˧-pʰæ˧˥… əəə…> gv̩˩pʰæ˩ tʰi˩-qɑ˥…-kwɤ˩tɕɯ˩-lɑ˩ | tʰi˩˥, | ʑi˧qʰwɤ˧ ɖɯ˧-ɭɯ˧-hĩ˧ | ʈʂʰɯ˧-dʑo˩ | tʰi˩˥, | ɑ˩pʰo˩˥ | ʈʂʰɯ˧ne˧-ʝi˥… | ɖɯ˧-ɭɯ˧-hĩ˧ | ʈʂʰɯ˧-dʑo˩, | le˧-se˩-ɲi˩-ze˩ mæ˩! |
crdo-NRU_F4_FOOD_SHORTAGE_FoodShortageS086.wav	tʰi˩˥, | ʈʂʰɯ˧-dʑo˧, | v̩˩tsʰɤ˧ ʝi˧! | ə˧ʝi˧-ʂɯ˥ʝi˩, | ʈʰæ˧mi˧-ɳɯ˩, | v̩˩tsʰɤ˧˥ | mɤ˧-dʑo˧-ɲi˥-mæ˩! | əəə… v̩˩tsʰɤ˧˥, | ɖɯ˧-sɑ˥ | mɤ˧-dʑo˧! | ə˩kʰɯ˩-lɑ˥ dʑo˩! |
crdo-NRU_F4_COMING_OF_AGE2_F4_ComingOfAge2S018.wav	tʰi˩˥… | ə˧dɑ˧-ki˧, | ɬo˧pv̩˥ ti˩-bi˩-kv̩˩-ze˩ mæ˩! |
crdo-NRU_F4_HEALING_HealingS017.wav	"""gi˩˥, | ɲi˧-ho˥-ze˩! | ʈæ˧bɤ˧ ʁɑ˧ʂe˩-tso˩-ɲi˩!"" | pi˧-zo˩, | wɤ˩˥… | ʈʰææ̃˧ | ɖɯ˧-njɤ˧ | ʈæ˧bɤ˧ ʁɑ˧ʂe˩-kv̩˩-tsɯ˩ ◊ -mv̩˩. |"
crdo-NRU_F4_MOUNTAINS_F4_MountainsS079.wav	əəə… ʂwæ˧gv̩˧ ŋwɤ˧hɑ̃˩ pi˩-kv̩˩-mv̩˩!
crdo-NRU_F4_FOOD_SHORTAGE_FoodShortageS023.wav	le˧-tɕɤ˧˥, | ɖɯ˧-pv̩˧-ɻ̍˩-kʰɯ˩, | tʰi˧-ɬi˧˥, | ɲi˧mi˧-qo˧ | le˧-ɬi˧˥, | le˧-pv̩˧-kʰɯ˧˥, | tʰi˩˥, | le˧-ʐv̩˩! |
crdo-NRU_F4_MUSHROOMS_MUSHROOMS_S008.wav	tʰi˩˥, | ə˧ʝi˧-ʂɯ˥ʝi˩-dʑo˩, | mo˧˥ | ʈʂʰɯ˧-dʑo˩, | mmm… zo˩no˥, | ʐɯ˩-mo˧ pi˥-hĩ˩ ɖɯ˩-ʁo˩ dʑo˩-kv̩˩-mv̩˩. |
crdo-NRU_F4_HOUSEBUILDING2_HOUSEBUILDING2_S284.wav	hĩ˧bæ˧ ɳɯ˩ | tʰi˩˥ | pʰɤ˧bɤ˧ po˧˥! | əəə… hĩ˧b[æ˧]…
crdo-NRU_F4_SEEDS_SeedsS024.wav	ʈʂʰɯ˧ne˧-ʝi˥ | tʰi˧-pʰo˧˥ ◊ -kwɤ˩tɕɯ˩-lɑ˩ | tʰi˩˥, | ʝi˧ | ɖɯ˧-lv̩˩-ɻ̍˩-ki˩, | ɖɯ˧-tsɑ˧˥ | <ts…> tsɑ˧-bi˥, | tʰɑ˩˥! | mɤ˧-tsɑ˧-bi˥, | tʰɑ˩˥! | ʈʂʰɯ˧ne˧-ʝi˥ | tʰi˧-pʰo˧˥ ◊ -kwɤ˩tɕɯ˩-lɑ˩, | mv̩˩zɯ˩-ʈʂʰɯ˥-dʑo˩, | ɖwæ˧˥ | dʑɤ˩-ɲi˥ ◊ -mæ˩! |
crdo-NRU_F4_HOUSEBUILDING2_HOUSEBUILDING2_S315.wav	"""no˧ | zo˧ gɤ˥ti˩-ho˩-ze˩ mæ˩! | zo˧ ɳɯ˩ | tsʰi˧ ʝi˥ mæ˩!"" | pi˧. | wɤ˩˥ | ʈʂʰɯ˧ne˧-ʝi˥ | ʐwɤ˧~ʐwɤ˩-ɻ˩. |"
crdo-NRU_F4_TIGER2_Tiger2S032.wav	ɬi˧di˩, | ʐv̩˧di˧ pi˥! | tʰi˩˥… |
crdo-NRU_F4_HOUSEBUILDING2_HOUSEBUILDING2_S101.wav	ʈʂo˩bo˩-ʈʂʰɯ˥, | <ʝi…> ʈʂe˧ | ʑi˩-mɤ˩-hĩ˩ ɲi˥-ze˩! |
crdo-NRU_F4_CARAVANS_CaravansS150.wav	njɤ˧ | ʁo˧dɑ˧ le˧-tsʰɯ˩-pi˩, | njɤ˧-ki˧ mv̩˥do˩! |
crdo-NRU_F4_HOUSEBUILDING2_HOUSEBUILDING2_S089.wav	mmm… ə˧ʝi˧-ʂɯ˥ʝi˩-dʑo˩, | ɲi˧ʈʂæ˧-ʑi˧ tsʰi˥-hĩ˩, | ʈʂʰɯ˧ | mɤ˧-tʰɑ˧˥ | dʑɤ˩˥ | dʑo˩-mɤ˩-kv̩˥ mæ˩! |
crdo-NRU_F4_SEEDS_SeedsS071.wav	tʰi˧-pʰo˧˥ ◊ -kwɤ˩tɕɯ˩-lɑ˩ | tʰi˩˥, | le˧-hæ̃˧˥ ◊ -tɕɯ˩, | ɑ˩ʁo˧ tʰi˧-tɕɯ˥, | le˧-lɑ˧-lɑ˥ ɲi˩-ze˩ ◊ -mæ˩! |
crdo-NRU_AGRICULTURAL_ACTIVITIES_Agriculture_S090.wav	tʰi˩˥, | wɤ˩˥ | ɣɯ˧ | le˧-dɑ˩. |
crdo-NRU_F4_TIGER2_Tiger2S066.wav	əəə… | tse˧bo˧ lɑ˩, | ɖɯ˧-ʂɯ˩ tʰi˩-lɑ˩! | kjɤ˩-tjɤ˧ljɤ˧ lɑ˩, | ɖɯ˧-ʂɯ˩ tʰi˩-lɑ˩! |
crdo-NRU_F4_FUNERAL_F4_FUNERAL_S244.wav	õ˧˥ | wɤ˩˥ | ə˧tso˧-mɤ˧-ɲi˩ | le˧-hwæ˧-tʰi˧-tɕɯ˥! | ə˧ʝi˧-tsʰi˧ʝi˧-se˥, | pi˧kæ˧ hwæ˧-ze˧! | ʂo˧ko˧-tʰɑ˩ hwæ˩-ze˩! | qo˩ho˧-qo˥!
crdo-NRU_AGRICULTURAL_ACTIVITIES_Agriculture_S070.wav	hĩ˧-di˧-qo˥ | no˧ | ɕi˧ɕjẽ˧ | dzɯ˧-bi˧-ni˧gv̩˧˥, | pi˧, | fæ˧tɕʰje˩ | ɖɯ˧-so˩-ɻ̍˩ <h…> [hwæ˩]; |
crdo-NRU_Mariage_De_La_Soeur_V3_Sister3_S116.wav	mi˩zɯ˩-ʈʂʰɯ˥-dʑo˩, | hĩ˧-ki˧-ki˩ | le˧-hɯ˩-hĩ˩ | ʈʂʰɯ˧-dʑo˩, | tʰi˩˥, | hĩ˧-ki˧-ki˩, | pi˧, | le˧-bi˩-dʑo˩, | ʈʂʰwɤ˧ | ɖɯ˧-mɤ˧-kv̩˧-tsɯ˥ ◊ -mv̩˩!
crdo-NRU_F4_FUNERAL_F4_FUNERAL_S040.wav	tʰi˩˥, | tʰv̩˧qo˧ kʰɯ˧˥! | tʰi˩˥, | le˧-tsɯ˧~tsɯ˧! |
crdo-NRU_F4_ELDERS3_Elders3S004.wav	"ə˧lɑ˧ʁwɤ˧ | qi˧qi˧-dʑo˧, | ə˧ʝi˧-ʂɯ˥ʝi˩, | õ˧dɤ˧ɻ̍˧ | …zo˩no˧ | …-dʑo˥ | tʰi˩˥,
			əəə… | ə˧lɑ˧ʁwɤ˧ hĩ˧ mɤ˧-ɲi˥-kv̩˩-tsɯ˩ ◊ -mv̩˩!"
crdo-NRU_F4_CARAVANS_CaravansS201.wav	ĩ˧, | ə˧ti˥dzi˩! | zo˩no˥, | po˧ʂæ˧-pi˧-hĩ˧ | ɖɯ˧-ʝi˧ ɲi˩-ə˩-di˩-wɤ˩? |
crdo-NRU_F4_FOOD_SHORTAGE2_FOOD_SHORTAGE2S029.wav	"""njæ˧=zɯ˩, | mv̩˩zo˩-lɑ˥ | njæ˧=zɯ˩ ɲi˩!"" | pi˧. | tʰi˩˥, | ""ə˧tse˥ | le˧-wo˧-tsʰɯ˧˥ ◊ -ɲi˩?"" | pi˧-tsɯ˩ ◊ -mv̩˩, | <tsʰo˩mo˩-ɳɯ˥ |> ə˧dɑ˥-ɳɯ˩. |"
crdo-NRU_F4_HOUSEBUILDING2_HOUSEBUILDING2_S152.wav	tʰi˩˥, | ə˧ʝi˧-tsʰi˧ʝi˧ ɲi˥-ze˩-se˩, | wɤ˩˥ | ʈʂʰɤ˧tsɯ˧-po˧-ɳɯ˧ | ʈɤ˧-tʰɑ˧-kv̩˥-ze˩ mæ˩! |
crdo-NRU_F4_FOOD_SHORTAGE_FoodShortageS028.wav	tʰi˩˥, | le˧-dzɯ˥ | le˧-se˩-dʑo˩ | tʰi˩˥, | ʈʂʰæ˧pv̩˩to˧, | hɑ˧ | le˧-mv̩˩-ze˩-tsɯ˩ ◊ -mv̩˩!
crdo-NRU_F4_MOUNTAINS_F4_MountainsS040.wav	hɤ˩-hĩ˥ | ɖɯ˧-ʑi˩-ɳɯ˩ | dzɑ˧-hĩ˧ | ɖɯ˧-ʑi˩-ki˩ ɲi˩-dʑo˩ | tʰi˩˥, |
crdo-NRU_F4_FUNERAL_F4_FUNERAL_S092.wav	wɤ˩˥ | hĩ˧ | ɖɯ˧-v̩˧ tsʰɯ˩-ɳɯ˩, | ɖɯ˧-ʂɯ˩ ŋv̩˩! |
crdo-NRU_F4_CARAVANS_CaravansS021.wav	"mi˩zɯ˩˥, | njɤ˧=ɻ̍˩ | so˩kv̩˩-lɑ˥ dʑo˩, | ʈʂʰɯ˧-ʈʂæ˩-qo˩! | njæ˧sɯ˩kv̩˩ | ə˧ʑi˧
			ʈʂʰɯ˧-ʈʂæ˩-qo˩! |"
crdo-NRU_F4_FUNERAL_F4_FUNERAL_S264.wav	<hĩ˧…> | ə˧dɑ˧-ə˧mi˧, | njæ˧sɯ˩kv̩˩, | nɑ˩-ʈʂʰɯ˥, | ə˧dɑ˧-ə˧mi˧ | ʂɯ˧-hĩ˧-ʈʂʰɯ˧, | ɖwæ˧˥ | pʰv̩˧ɖɯ˧ ʝi˥-kv̩˩! |
crdo-NRU_F4_SEEDS_SeedsS017.wav	mv̩˩zɯ˩-ʈʂʰɯ˥ | tʰi˩˥, | ə˧tse˥ | mɤ˧-ki˧? ◊ -dʑo˩ | tʰi˩˥, | mmm… ki˧-mɤ˧-bi˧-pi˧-zo˥! |
crdo-NRU_F4_FUNERAL_F4_FUNERAL_S090.wav	hĩ˧=ɻæ˥ | mɤ˩mv̩˩ ʈʂv̩˥-tsʰɯ˩-dʑo˩, | pɤ˩jɤ˧ gv̩˥, | po˧-jo˥-kv̩˩! | tʰi˩˥, | tʰv̩˧ne˧-ʝi˥ | tʰi˧-tɕɯ˥! |
crdo-NRU_F4_FUNERAL_F4_FUNERAL_S202.wav	ʂɑ˩tʰɑ˧-dze˧-pi˧-zo˥! | ho˩tʰɑ˩˥! |
crdo-NRU_F4_DOG2_Dog2S105.wav	dʑɯ˧, | ze˩-gɤ˧ ʑi˧-ɻ̍˩, | zo˩qo˧ dʑo˩-ɻ̍˩ ◊ -dʑo˩, | ʈʂʰɯ˧-ʂwæ˧-gv̩˧-kv̩˩, | ʁæ˧ʈv̩˥-pi˩ | ʈʂʰɯ˧-ʂwæ˧-gv̩˧-kv̩˩! |
crdo-NRU_F4_MUSHROOMS_MUSHROOMS_S084.wav	kv̩˧ mɤ˧-nɑ˩, | pi˧-dʑo˩, | tsʰi˧-ɲi˧ | mo˧˥ | le˧-dzɯ˥! | kv̩˧-ɳɯ˩ | nɑ˩˥ | pi˧, | mo˧˥ | tʰɑ˧-dzɯ˥! |
crdo-NRU_F4_FOOD_SHORTAGE2_FOOD_SHORTAGE2S057.wav	ʁwɤ˧ ɖɯ˧-ɭɯ˧-ʈʰæ˧qo˩-tʰv̩˩-dʑo˩, | hwɤ˧tɕi˥-ʈʂʰɯ˩ | ɖwæ˧˥ | ɖɯ˧-pʰæ˧ tʰi˧-di˥-tsɯ˩ ◊ -mv̩˩!
crdo-NRU_F4_CARAVANS_CaravansS060.wav	ɖɯ˧-tsʰi˥-ɳɯ˩, əəə… | ʈʰæ˧qʰwɤ˧… | ɲi˧-tsʰi˥-ɳɯ˩, | ʈʰæ˧qʰwɤ˧ | ɖɯ˧-ɭɯ˧-lɑ˥ tʰv̩˩-kv̩˩. |
crdo-NRU_F4_HEALING_HealingS056.wav	"tʰi˩˥, | ɖɯ˧-tɑ˧˥ | ʈʂʰɯ˧ne˧-ʝi˥ | le˧-qʰwɤ˧-dʑo˩ | tʰi˩˥, | ""ə˧mi˧! | dɑ˧pɤ˧-ʈʂʰɯ˧, |
			ʁɑ˩mi˧-ze˩!"" | pi˧-zo˩, | ə˧ʝi˧-ʂɯ˥ʝi˩, | dɑ˧pɤ˧-ʈʂʰɯ˧-dʑo˩ | tʰi˩˥, | ʈʂʰɯ˧ne˧-ʝi˥ ◊ -zo˩,
			| hĩ˧-ʈʂʰɯ˧, | dɑ˧pɤ˧-ki˧ | ɖwæ˧˥ | fv̩˧-ʝi˧-ɲi˥-tsɯ˩ ◊ -mv̩˩!"
crdo-NRU_F4_TIGER2_Tiger2S026.wav	"""ə˧dɑ˧-ə˧mi˧-dʑo˩, | zo˧mv̩˥ | zɯ˧ pv̩˩-hĩ˩ | mɤ˧-dʑo˩-ɲi˩!"" | pi˧-tsɯ˩ ◊ -mv̩˩. |"
crdo-NRU_F4_MUSHROOMS_MUSHROOMS_S139.wav	tɕi˧sɯ˧pɤ˧-ʈʂʰɯ˧-dʑo˩, | hĩ˧ | <le…> le˧-dzɯ˥, | ɖwæ˩˥ | tɕi˧-kv̩˧-tsɯ˥ ◊ -mv̩˩!
crdo-NRU_F4_DOG2_Dog2S019.wav	"tsʰe˩so˩-kʰv̩˩˥ | mɤ˧-gv̩˧-dʑo˧, | hĩ˧ | dʑɤ˩˥ | hĩ˧ mɤ˧-ʈʂɤ˧-ɲi˥! | pi˧- zo˩ | tʰi˩˥, | tsʰe˩so˩-kʰv̩˩-ʁo˥to˩-dʑo˩ | tʰi˩˥, | tɕɯ˩-ɲi˥-tsɯ˩ ◊ -mv̩˩! | ""tsʰe˩so˩-kʰv̩˩-ɳɯ˥ | tʰi˩˥, | qʰv̩˩tsʰi˧-kʰv̩˥ | tʰi˩˥, | no˧sɯ˩kv̩˩-ki˩ | ki˧-bi˧-ze˧!"" |"
crdo-NRU_F4_MUSHROOMS_MUSHROOMS_S039.wav	ʐɯ˩-mo˧-tʰv̩˥-dʑo˩, | ʁwɤ˧ ʂwæ˧-hĩ˧-qo˩ di˩-kv̩˩-tsɯ˩-mv̩˩. |
crdo-NRU_F4_FUNERAL_F4_FUNERAL_S200.wav	tʰi˩˥, | pɤ˩jɤ˧ qʰæ˥-kv̩˩-ze˩-mæ˩! | njɤ˧ F | hĩ˧ tɕʰɯ˧-ɳɯ˩, | zo˩no˥, | njɤ˧ F | ɑ˩ʁo˧ | æ˧mv̩˩ | hĩ˧ tɕʰɯ˧, ◊ ə˩-gi˩! | hĩ˧ tɕʰɯ˧-ɳɯ˩, | hĩ˧ ʂɯ˧, | pi˧-dʑo˩, | ɑ˩ʁo˧… | njɤ˧-ɳɯ˧ | pɤ˩jɤ˧ qʰæ˥-bi˩-zo˩-kv̩˩-ze˩-mæ˩! |
crdo-NRU_F4_FUNERAL_F4_FUNERAL_S159.wav	ʐv̩˧tsʰi˩gv̩˩-hɑ̃˩ gv̩˩-kwɤ˩tɕɯ˩-lɑ˩, | hĩ˧=ɻæ˥ | õ˧ ʐɤ˥, õ˩ tɕʰo˩-bi˩-kv̩˩-ze˩! | əəə… pi˧-zo˩, | ʈʂʰɯ˧ne˧-ʝi˥ | ʐwɤ˩-kv̩˩˥! | <hĩ˧-m…> æ˧ʂæ˧, hĩ˧ ʂɯ˧ F | njæ˧sɯ˩kv̩˩ | ʈʂʰɯ˧ne˧-ʝi˥… | hĩ˧ ʂɯ˧! |
crdo-NRU_F4_MOUNTAINS_F4_MountainsS094.wav	"""ə˧mi˧! | no˧sɯ˩kv̩˩, | gɤ˩-ʈi˥ | mɤ˧-bi˧!? | ʂwæ˧gv̩˧-ʁo˧ F | ɲi˧mi˧-kʰɯ˧ʂɯ˧ tʰi˧-qʰæ˧-ze˥! | ŋwɤ˧hɑ̃˩-ʁo˩ F | ɲi˧mi˧-kʰɯ˧ʂɯ˧ tʰi˧-qʰæ˧-ze˥!"" |"
crdo-NRU_Mariage_De_La_Soeur_V3_Sister3_S107.wav	go˧mi˧-ki˧ | ʈʂʰɯ˧-qo˧ | tʰi˧-kwɤ˩-kwɤ˩tɕɯ˩-lɑ˩, | go˧mi˧ | ʈʂʰɯ˧-ɖʐɯ˧~ɖʐɯ˥ F | tʰi˩˥, | mmm… le˧-qæ˧˥ | le˧-se˩-ɲi˩-tsɯ˩ ◊ -mv̩˩! |
crdo-NRU_F4_CARAVANS_CaravansS189.wav	hhhh! ə˧mi˧! | le˧-ɖwæ˩! | njɤ˧ | ə˧ʑi˧˥ | ʈʂʰɯ˧ne˧-ʝi˥ | pi˧-kv̩˩: |
crdo-NRU_F4_FUNERAL_F4_FUNERAL_S224.wav	tʰi˩˥, | so˧hwɤ˩-dʑo˩, | wɤ˩˥ | ʈʂʰɯ˧=ɻ̍˩ | hĩ˧ ʂɯ˧-pi˧, | njɤ˧-ɳɯ˧ | qʰæ˧-bi˧-zo˧-kv̩˩-ze˩-mæ˩! |
crdo-NRU_F4_RENAMING_RenamingS017.wav	<hĩ˧> no˧ <dzo˧ t…> dzo˧ | le˧-gv̩˩, | tʰi˧-tɕɯ˥! | tʰi˩˥, | <hĩ˧… |> no˧ | le˧-tsʰɯ˩-ɲi˩-ze˩-mæ˩, ◊ ə˩-gi˩! | hĩ˧ ɖɯ˧-v̩˧ mɤ˧-tsʰɯ˩! | no˩ le˩-tsʰɯ˩-ɲi˥-ze˩-mæ˩! |
crdo-NRU_F4_MOUNTAINS_F4_MountainsS058.wav	"tʰi˩˥ ◊ -dʑo˩, | gi˩˥ ◊ -dʑo˩ | tʰi˩˥, | ʈʂʰɯ˧ne˧ gv̩˧˥ | -kwɤ˩tɕɯ˩-lɑ˩, | hĩ˧-ki˧, | dzɑ˧-hĩ˧-ki˧: | ""ə˧mi˧! | no˧=ɻ̍˩ | tsɤ˧-ze˧!"" | ə˧sɯ˩kv̩˩ | <ɖɯ˧…> <ɖɯ˧-qɑ˧~qɑ˥-bi˩> qɑ˩~qɑ˧-bi˧! | pi˧. |"
crdo-NRU_F4_FUNERAL_F4_FUNERAL_S150.wav	"tʰi˩˥, | le˧-ʂɯ˧-hĩ˧, | õ˧-bv̩˥-õ˩ | bi˧! | mmm… le˧-dʑo˩-hĩ˩-dʑo˩ | tʰi˩˥, | ""õ˧ ə˧mi˥ F | le˧-ʂɯ˧-ze˧"" pi˧! |"
crdo-NRU_Mariage_De_La_Soeur_V3_Sister3_S090.wav	go˧mi˧ | le˧-ʂɯ˧-tsɯ˥ ◊ -mv̩˩!
crdo-NRU_F4_FOOD_SHORTAGE_FoodShortageS097.wav	õ˧-bv̩˥-õ˩ gv̩˩!
crdo-NRU_F4_CARAVANS_CaravansS052.wav	"""si˧kʰɯ˧-li˥nɑ˩ | ʈʰɯ˩-se˩-gɤ˥, | njɤ˧ ə˧mɑ˧ mɤ˧-dʑo˩, | tʰi˧-kwɤ˩-kʰɯ˩!"" | pi˧.
			|"
crdo-NRU_Naissance_du_Lac_V3_Lake3_S052.wav	ʈʂʰwæ˩-ʈʂʰɯ˥ | tʰi˩˥, | ʝi˧sɯ˥-dʑo˩, | ə˧mi˧ ʈʂʰɯ˧-v̩˧-lɑ˩ | mv̩˩ ʈʂʰɯ˩-v̩˩-ɳɯ˥ | ʈʂʰwæ˩tsʰɯ˩-ɲi˥-tsɯ˩ mv̩˩. |
crdo-NRU_F4_CARAVANS_CaravansS015.wav	"tʰi˩˥, | li˩ tɕɯ˧ le˥-po˩-jo˩-kv̩˩-tsɯ˩! | mmm… əəə… tʰi˩˥, | əəə… mɤ˩ tɕɯ˩˥, |
			le˧-po˧-jo˥-kv̩˩-ze˩! | ɑ˩ʁo˧ | tʰi˧-tɕi˥! |"
crdo-NRU_AGRICULTURAL_ACTIVITIES_Agriculture_S008.wav	gv̩˩ɬi˩mi˩˥ | tʰi˩˥, | le˧-ʂo˧-se˥, | le˧-hæ̃˧-se˥, | le˧-lɑ˧-se˥-kwɤ˩tɕɯ˩-lɑ˩ | tʰi˩˥, | wɤ˩˥ | so˧ʝi˧-bv̩˧ | tv̩˧-tso˧ [ʂo˧~ʂo˥] <ʈʂʰɯ˧>, | wɤ˩˥ | ʝi˧ | le˧-lv̩˩. |
crdo-NRU_F4_HOUSEBUILDING2_HOUSEBUILDING2_S136.wav	li˩˥, | ɖɯ˧-v̩˧ ɖɯ˧-qʰwɤ˧˥! | tɕæ˧ɻæ˩ tʰi˩-no˩ kʰɯ˩, | ʂe˧ tʰi˧-no˥-kʰɯ˩, | tʰi˩˥, | ʐɯ˧ tʰi˧-no˩. |
crdo-NRU_F4_HOUSEBUILDING2_HOUSEBUILDING2_S340.wav	õ˧ʈʂʰɯ˧ne˧-ʝi˥-zo˩, | ə˧ʝi˧-ʂɯ˥ʝi˩, | ʑi˧qʰwɤ˧ ɖɯ˧-ɭɯ˧-hĩ˧ ʈʂʰɯ˧-dʑo˩! | ɖwæ˧˥ | lo˧ hɑ˧ ɲi˥ wɤ˩! |
crdo-NRU_F4_COMING_OF_AGE2_F4_ComingOfAge2S065.wav	ə˧dɑ˥-lɑ˩ | ə˧ʑi˧ tʰv̩˧-ʑi˥-ki˩ | le˧-bi˩-kv̩˩-ze˩-mæ˩! |
crdo-NRU_F4_MOUNTAINS_F4_MountainsS108.wav	<mv̩˧d… əəə…> mv̩˧di˧˥ ◊ -dʑo˩, | tv̩˩-mɤ˩-kv̩˩-tsɯ˥! | ʑi˧qʰwɤ˧ | no˧˥ | tʰi˧-tsʰi˧˥! | hĩ˧ tʰi˧-dzi˧˥! |
crdo-NRU_F4_TIGER2_Tiger2S030.wav	ʐv̩˧di˧-ki˥ ɲi˩-kv̩˩-tsɯ˩ ◊ -mv̩˩! |
crdo-NRU_F4_MUSHROOMS_MUSHROOMS_S078.wav	ʝi˧-bi˧-di˧ mɤ˧-di˥-zo˩, | zo˩no˥, | tɕi˧-dʑɯ˩ pi˩-zo˩ | ɖɯ˧-ʁo˩ dʑo˩-kv̩˩-tsɯ˩-mv̩˩! | tɕi˧-dʑɯ˩ tv̩˩-kv̩˩-tsɯ˩-mæ˩! | tɕi˧-dʑɯ˩ tv̩˩! |
crdo-NRU_F4_FOOD_SHORTAGE2_FOOD_SHORTAGE2S017.wav	"mv̩˩zo˩˥ | <ɖɯ˧… so˧…> so˧-ɭɯ˧ dʑo˩; | ɖɯ˧-ɭɯ˧ ʂv̩˧; | <ɖɯ˧-ɭɯ˧-ɳɯ˧-dʑo˥, | əəə…> so˧-ɭɯ˧-ki˧, | ""ə˧mi˧! | ɲi˩-ɳɯ˥ | ə˧mɑ˧-qɑ˧ tɕʰo˧-bi˧˥?"" | pi˧, | mv̩˩-ɬi˧ | tʰv̩˧-v̩˧-ɳɯ˩: |"
crdo-NRU_F4_CARAVANS_CaravansS083.wav	əəə… ɖɯ˧-ɬi˧-ɖʐɯ˩-bi˩, | ɖɯ˧-ɬi˧ | kv̩˧dʑɯ˧-ʈʰæ˧qo˥ dzi˩! |
crdo-NRU_F4_SEEDS_SeedsS059.wav	sɑ˧-lɑ˩ | wo˩-ʈʂʰɯ˥-dʑo˩, | njæ˧-sɯ˩kv̩˩ | le˧-ʂɯ˧ | <li˩kʰɤ˧ mɤ˧-hĩ˧˥ ◊ -ɲi˩ ◊ -mæ˩! |> [tʰi˧-kwɤ˩-mɤ˩-hĩ˩!]
crdo-NRU_F4_TIGER2_Tiger2S055.wav	bv̩˩hwɤ˩-qo˥ | tʰv̩˧ ◊ -dʑo˩ | tʰi˩˥, | ʂe˧ tʰv̩˧-kʰwɤ˧ | tʰi˧-bv̩˥-tsɯ˩ ◊ -mv̩˩!
crdo-NRU_F4_FUNERAL_F4_FUNERAL_S133.wav	"""no˧=ɻ̍˩-ɳɯ˩, | no˧ mv̩˩-ɳɯ˩, | ʐɯ˧ hwɤ˩-tsʰɯ˩! | no˧=ɻ̍˩… | no˧=ɻ̍˩ | le˧-jo˩!"" | pi˧, | wɤ˩˥ | tʰi˧-dzi˩! | wɤ˩˥, | njɤ˧-ɳɯ˧ | le˧-ŋv̩˩! |"
crdo-NRU_F4_TIGER2_Tiger2S043.wav	tʰi˩˥, | ə˧ʝi˧-ʂɯ˥ʝi˩-dʑo˩, | mv̩˩sɯ˧-njɤ˧˥, | tv̩˧tsʰɯ˧ hõ˧-ɭɯ˥ | bi˧-dʑo˩ | tʰi˩˥, | bv̩˩hwɤ˩-pi˥-zo˩! |
crdo-NRU_F4_FOOD_SHORTAGE2_FOOD_SHORTAGE2S081.wav	"tʰi˩˥, | ə˧ʑi˧-mo˥ | tʰv̩˧-jɤ˩: | ""tʰi˩˥, | gv̩˧! | gv̩˧! | gv̩˧! | hɑ˧-ʐwɤ˩-dʑo˩, | hĩ˧ ʂɯ˧-mɤ˧-kv̩˩!"" |"
crdo-NRU_F4_COMING_OF_AGE2_F4_ComingOfAge2S017.wav	ə˧mi˧-ɳɯ˧ | le˧-pɤ˥~pɤ˩! | mv̩˩zɯ˩˥ | ʈʰæ˧qʰwɤ˧ | le˧-ki˩! |
crdo-NRU_F4_HOUSEBUILDING2_HOUSEBUILDING2_S334.wav	dʑɤ˩˥ | le˧-tsʰo˧-se˩ | tʰi˩˥ | ʈʰææ̃˧ | wɤ˩˥ | kɯ˧ʈʂʰwɤ˩ | le˧-gv̩˩! |
crdo-NRU_F4_HEALING_HealingS076.wav	"""tɕʰɯ˧ɭɯ˧ mo˩-ʝi˩, | le˧-qʰwɤ˧-ʝi˧!"" | pi˧, | ə˧ʝi˧-ʂɯ˥ʝi˩. |"
crdo-NRU_F4_HOUSEBUILDING2_HOUSEBUILDING2_S265.wav	ʂe˧ | ɖɯ˧-v̩˧ ɖɯ˧-pʰæ˧˥! | õ˧ʈʂʰɯ˧ne˧-ʝi˥ | tʰi˧-ki˧! |
crdo-NRU_F4_HOUSEBUILDING2_HOUSEBUILDING2_S158.wav	le˧-gɤ˧-zo˥ | pʰæ˧tɕi˥ | tʰææ̃˧ | <ʈʂʰɯ˧-qo˧ BEGAIEMENT | > [qʰwɤ˧to˩ | ] le˧-ʔw̃æ˧-dʑɯ˧-ɲi˥, | le˧-ʔw̃æ˧ ! |
crdo-NRU_Mariage_De_La_Soeur_V3_Sister3_S147.wav	ə˧mɑ˧ | wɤ˩˥ | ʈʂʰɯ˧ne˧-ʝi˥ | do˧-mɤ˧-dʑɯ˧! |
crdo-NRU_F4_HOUSEBUILDING2_HOUSEBUILDING2_S279.wav	ə˧ʝi˧-tsʰi˧ʝi˧-dʑo˩, | je˩tʰi˧-ʁæ˩bæ˩ pi˩ | wɤ˩˥… | si˧-ʁæ˧bæ˥ | mɤ˧-po˧-se˥ | dʑo˩ | wɤ˩˥ | jɤ˩tʰi˧-ʁæ˩bæ˩ pi˩-zo˩ | wɤ˩˥, | dʑɤ˩˥ | ə˧v̩˧-hĩ˥ | ɖɯ˧-ʁo˧ | le˧-tsʰɯ˩, ◊ ə˩-gi˩! |
crdo-NRU_F4_FUNERAL_F4_FUNERAL_S156.wav	tʰi˩˥, | ɑ˩ʁo˧ | si˧ F | ʈʂʰɯ˧=ɻæ˥ | le˧-to˧~to˧ le˧-po˧-jo˥! | ɬi˩ʈɯ˩mæ˥-tʰv̩˩ | põ! pi˧, | kʰɯ˧~kʰɯ˥ mɤ˩-kv̩˩-mæ˩, | ə˩-ɲi˩˥! | ə˧ʝi˧-ʂɯ˥ʝi˩! | əəə… hĩ˧mo˥=ɻæ˩-ɳɯ˩! |
crdo-NRU_F4_HOUSEBUILDING2_HOUSEBUILDING2_S142.wav	ə˧ʝi˧-ʂɯ˥ʝi˩, | æ̃˩˥ | ɖwæ˧˥ | dʑo˩-kv̩˩˥! | ə˧tse˧-ʝi˧ ɲi˥ | mɤ˧-do˩! |
crdo-NRU_F4_MUSHROOMS_MUSHROOMS_S145.wav	di˧qo˧-hĩ˧ ʈʂʰɯ˧-dʑo˩, | dzɯ˧-tʰɑ˩, | mɤ˧-tʰɑ˧˥, | ʈʂʰɯ˧-dʑo˩, | wɤ˩˥, | õ˧-bv̩˥-õ˩ sɯ˩! |
crdo-NRU_F4_CARAVANS_CaravansS048.wav	"tʰi˩˥, | ""si˧kʰɯ˧ ʈʰɯ˧-se˥-gɤ˩-se˩, | tʰi˧-kwɤ˩-kʰɯ˩! | njɤ˧ ə˧mi˧ le˧-ʂɯ˧, |
			tʰi˧-kwɤ˩-kʰɯ˩!"" pi˩-ɲi˩-tsɯ˩ ◊ -mv̩˩. |"
crdo-NRU_F4_HOUSEBUILDING2_HOUSEBUILDING2_S114.wav	ʈʂʰɯ˧ne˧ ʝi˥ | nɑ˩~nɑ˧ kv̩˥-ɲi˩! |
crdo-NRU_Naissance_du_Lac_V3_Lake3_S042.wav	mmm… zo˩no˥, | <tsʰe˩hõ˩…> tsʰe˩hõ˩-pʰo˥ ɲi˩-ze˩ mæ˩, ◊ ə˩-gi˩! |
crdo-NRU_F4_MUSHROOMS_MUSHROOMS_S066.wav	mmm… to˩pv̩˥ | ɖɯ˧-ɭɯ˧-qo˧-sɯ˧ | ɕjɤ˧-kv̩˥-mæ˩! | njæ˧-sɯ˩kv̩˩, | dʑɯ˩ʁo˩ bi˩˥ ◊ -dʑo˩, | dʑɯ˧ mɤ˧-dʑo˧-hĩ˧ mv̩˧di˧-qo˥ tʰv̩˩-dʑo˩! |
crdo-NRU_F4_MOUNTAINS_F4_MountainsS041.wav	"¨ə˧mi˧! | no˧=ɻ̍˩ | ə˧tso˧-mɤ˧-ɲi˩ F | dʑo˧! | dʑi˧mi˧ gv̩˧-wo˥ F | dʑo˧! | ʝi˧qv̩˥=ɻ̍˩-ɳɯ˩, | tʰi˧-gɤ˧ | ə˩-gɤ˩?"" | pi˧-ɲi˥-kv̩˩-tsɯ˩ ◊ -mv̩˩. |"
crdo-NRU_F4_DOG2_Dog2S023.wav	mmm… hĩ˧-dʑo˩ | tʰi˩˥, | qʰv̩˩tsʰi˧-kʰv̩˥ ʝi˩-ɲi˩-tsɯ˩ ◊ -mv̩˩!
crdo-NRU_F4_HOUSEBUILDING2_HOUSEBUILDING2_S047.wav	"""gæ˩pʰæ˧ dzi˩! | gæ˩pʰæ˧ dzi˩!"" | pi˧. |"
crdo-NRU_F4_CARAVANS_CaravansS064.wav	"no˧-ɳɯ˧ | ɕjɑ˧tɕo˧-ki˧ ki˩-ni˩-zo˩, ◊ ə˩-gi˩! | ɖʐv̩˧-ɳɯ˧ | le˧-hwæ˧ | le˧-po˧-jo˥! |
			bɑ˩lɑ˩ hwæ˥, | le˧-po˧-jo˥! | ʈʰæ˧qʰwɤ˧ hwæ˧, | le˧-po˧-jo˥! |"
crdo-NRU_F4_MOUNTAINS_F4_MountainsS147.wav	tʰi˩˥, | tʰv̩˧qo˧ tʰv̩˧-kwɤ˧tɕɯ˥-lɑ˩, | əəə… nɑ˩tsʰi˩-ki˥, | æ˧ʂæ˧ gwɤ˩-bi˩ | ɖɯ˧-ɲi˥-dʑo˩, | qv̩˧ɻ̍˧-ki˧-ɳɯ˩ | <ʈʂʰɯ˧ne˧-ʝi˥ |> le˧-bi˩-kv̩˩-ze˩-mæ˩! |
crdo-NRU_F4_FOOD_SHORTAGE2_FOOD_SHORTAGE2S008.wav	"""hĩ˧=ɻæ˥ | wɤ˩˥ | <mv…> ɖɯ˧-di˩-qo˩-dʑo˩, | hɑ˧ dʑo˧-tsɯ˧˥ ◊ -mv̩˩! | ə˧zɯ˩ | mv̩˩ tɕʰi˩ ə˥-bi˩?"" | pi˧-tsɯ˩ ◊ -mv̩˩. |"
crdo-NRU_F4_MOUNTAINS_F4_MountainsS085.wav	"dzo˧ lɑ˩-kv̩˩-tsɯ˩ ◊ -mv̩˩! | ""ə˧mi˧! | ʈʂʰɯ˧ɲi˧, | ŋwɤ˧hɑ̃˩-ʁo˩-gɤ˩, | hĩ˧-ɳɯ˩ | æ˧hi˩hi˩ kʰɯ˩-ze˩-pʰæ˩-di˩! | dzo˧ lɑ˩-ze˩!"" | pi˧. |"
crdo-NRU_F4_SEEDS_SeedsS007.wav	ni˧! |
crdo-NRU_F4_FUNERAL_F4_FUNERAL_S131.wav	"""njɤ˧ | no˧ ʂv̩˧ɖv̩˧-zo˥, | qʰɑ˩ne˩ gv̩˩-pi˥-zo˩?"" | ʈʂʰɯ˧ne˧-ʝi˥ | ŋv̩˩-kv̩˩˥ ◊ -mv̩˩, | kɤ˧kɤ˩ | tʰi˧-dzi˩! |"
crdo-NRU_F4_HOUSEBUILDING2_HOUSEBUILDING2_S033.wav	ʈʂʰɯ˧ne˧-ʝi˥, | le˧-tɕo˧ le˧-tsʰɯ˩, | kʰi˧ F | tʰi˩˥ | ʈʂʰɯ˧-qo˧ di˩-ɲi˩-ze˩ mæ˩! |
crdo-NRU_F4_CARAVANS_CaravansS211.wav	zo˩no˥, | pæ˧kʰwɤ˧ | pi˧-ɲi˥-mæ˩! | pæ˧kʰwɤ˧, ◊ ə˩-gi˩! | pæ˧kʰwɤ˧ | ɖɯ˧-ɭɯ˧! |
crdo-NRU_F4_CARAVANS_CaravansS076.wav	"ə˧v̩˧˥ | tɕi˩-hĩ˩˥ ◊ -dʑo˩ | tʰi˩˥, | əəə… ə˧v̩˧˥ | ɖɯ˩-hĩ˩-bv̩˩˥ | əəə… ʐwæ˧ tɕɯ˩!
			| ə˧v̩˧˥ | ɖɯ˩-hĩ˩˥ ◊ -dʑo˩, | zo˩no˥, | tsʰo˧pæ˧… tsʰo˧pæ˧-mv̩˥ʈʂæ˩-ɲi˩-mæ˩! |
			zo˩no˧-dʑo˥, | lo˧pæ˧-mv̩˧ʈʂæ˧˥ ◊ -dʑo˩, ◊ ə˩-gi˩! |"
crdo-NRU_AGRICULTURAL_ACTIVITIES_Agriculture_S083.wav	sɑ˧ | qwæ˩ɖʐæ˩-qo˥ | ʈʰæ˧˥, | ɖɯ˧-kʰɯ˩ | ɖɯ˧-kʰɯ˩ | le˧-ʂɤ˩, | ʈʂʰɯ˧-qo˧ | tʰi˧-ʈʂwæ˧˥ |
crdo-NRU_F4_MUSHROOMS_MUSHROOMS_S118.wav	<tʰv̩˧…> ə˧ʝi˧-ʂɯ˥ʝi˩, | hĩ˧ | ɖɯ˧-pi˧˥ | bæ˩-ɲi˥-ho˩! | njɤ˧-ɳɯ˧, | mo˧-ʈʂʰɯ˥-dʑo˩… | ɖwæ˧˥ | pʰv̩˧ʈʂʰe˩-kv̩˩-ze˩. |
crdo-NRU_F4_DOG2_Dog2S039.wav	njæ˧=ɻæ˩, | nɑ˩˥, | kʰv̩˧ʂe˧ dzɯ˧-mɤ˧-kv̩˩! |
crdo-NRU_F4_HOUSEBUILDING2_HOUSEBUILDING2_S196.wav	ɑ˩ʁo˧ | wɤ˩˥ | tv̩˧qʰv̩˧-zo˧~zo˩ | ɖɯ˧-ɭɯ˧ qwæ˧˥. | mv̩˩zɯ˩-mo˩nɑ˥ tʰi˩-kʰɯ˩. |
crdo-NRU_F4_HOUSEBUILDING2_HOUSEBUILDING2_S301.wav	ʈʂʰɯ˧ne˧-ʝi˥-zo˩, | əəə… ʝi˧-kv̩˩ mæ˩! |
crdo-NRU_Naissance_du_Lac_V3_Lake3_S006.wav	hɑ˧ | ɖɯ˧-ʈv̩˩, | ʈʂʰɯ˧ne˧-ʝi˥ | le˧-ʐv̩˧~ʐv̩˥, | hɑ˧ | ɖɯ˧-ʈv̩˩; | ʂe˧ | ɖɯ˧-kʰwɤ˥; |
crdo-NRU_F4_HOUSEBUILDING2_HOUSEBUILDING2_S115.wav	"əəə… ""ə˧tse˧… ə˧tse˧ ʝi˧-ɲi˥?"" | pi˧-dʑo˩, | ""ʂe˧ mɤ˧-dzɯ˧ ɲi˥!"" | pi˧-kv̩˩ mæ˩. |"
crdo-NRU_F4_ELDERS3_Elders3S012.wav	əəə… ə˧ʑi˧˥, | tsʰɯ˧ɻ̍˧-ɬɑ˩mv̩˩ pi˩-hĩ˩ ɖɯ˩-v̩˩ dʑo˩-ɲi˩-tsɯ˩ ◊ -mv̩˩!
crdo-NRU_F4_HOUSEBUILDING2_HOUSEBUILDING2_S246.wav	tʰi˩˥, | dʑɯ˩ʁo˩˥ | gɤ˧ bi˩-bi˩, | pv̩˧-hĩ˧ ʈʂʰɯ˧-dʑo˩, | ɖwæ˧˥ | po˧˥ | qʰæ˩-ɲi˥-ze˩ mæ˩! | mɤ˧-ʐɯ˧ ɲi˥-ze˩ mæ˩! |
crdo-NRU_F4_RENAMING_RenamingS042.wav	"""ə˧si˧=ɻæ˩, | njɤ˧-ki˧ | mv̩˧ | ɖɯ˧-kʰwɤ˥ ki˩-ɻ̍˩!"" | pi˧; | ""tsɤ˧-ʝi˧! tsɤ˧-ʝi˧! |
			njɤ˧-ɳɯ˧ ki˧-tsɤ˧-ɲi˩!"" | pi˧. |"
crdo-NRU_F4_CARAVANS_CaravansS281.wav	"ʐwæ˧-ʈʂʰɯ˧-dʑo˩ | tʰi˩˥, | no˧ | ɖɯ˧-v̩˧, | ɲi˧-kv̩˧-lɑ˥ mɤ˩-ɲi˩-mæ˩! | ʐwæ˧-ʈʂʰɯ˧, |
			ɲi˧tsi˧, | so˧tsʰi˧! |"
crdo-NRU_Mariage_De_La_Soeur_V3_Sister3_S115.wav	ki˧-mɤ˧-kv̩˧-tsɯ˥ ◊ -mv̩˩! | ɖɯ˧-mɤ˧-kv̩˧-tsɯ˥ ◊ -mv̩˩!
crdo-NRU_F4_FUNERAL_F4_FUNERAL_S119.wav	tʰi˩˥, | bi˧tɕo˧ ɲi˩-bi˩, | hĩ˧bæ˧ jo˧-ʝi˧-ɻ̍˥! | pi˧. | hĩ˧bæ˧ | le˧-qʰo˩. |
crdo-NRU_F4_MOUNTAINS_F4_MountainsS156.wav	tʰv̩˧qo˧-ɳɯ˧ | le˧-ʈʂʰæ˧~ʈʂʰæ˧! |
crdo-NRU_Mariage_De_La_Soeur_V3_Sister3_S019.wav	tʰi˩˥, | go˧mi˧ tʰi˧-ki˧-hĩ˧ ʈʂʰɯ˧-ʑi˥ | ɑ˩ʁo˧ tʰv̩˧-dʑo˩ | tʰi˩˥, | <g…>
crdo-NRU_F4_MOUNTAINS_F4_MountainsS036.wav	"""dʑi˧mi˧ gv̩˧-wo˥ F | dʑo˧-ɲi˥-lɑ˩, | ʝi˧qv̩˥=ɻ̍˩-ɳɯ˩ | tʰi˧-gɤ˧-ze˧!"" |"
crdo-NRU_F4_FUNERAL_F4_FUNERAL_S041.wav	tʰi˩˥, | dv̩˩pʰæ˧ pi˧-zo˥, ◊ ə˩-gi˩! | nɑ˩-ʈʂʰɯ˥-dʑo˩, | dv̩˩pʰæ˧ | <-po>[-dʑo˧], hĩ˧mo˩-tɕɯ˩-di˩-ɲi˩! | pi˧. |
crdo-NRU_F4_MUSHROOMS_MUSHROOMS_S050.wav	dʑɯ˩nɑ˩mi˩-ʁo˩˥ | ʂwæ˧-hĩ˧-qo˩, | dʑɯ˧ | mɤ˧-dʑo˧-ɲi˥-mæ˩! | ʈʂʰɯ˧-ʁo˥-dʑo˩, | dʑɤ˩˥ | ʂwæ˧-hĩ˧-qo˩, | dʑo˧-mɤ˧-kv̩˧˥! |
crdo-NRU_F4_HOUSEBUILDING2_HOUSEBUILDING2_S327.wav	tʰi˩˥, | ə˧mi˧ | ʐɤ˩ni˧-hĩ˧=ɻæ˥-dʑo˩, | ə˧mi˧ | ho˩-hĩ˥ | ɖʐv̩˧ | tʰv̩˧=ɻæ˥-dʑo˩, | tʰi˧-dzi˩, ◊ ə˩-gi˩! |
crdo-NRU_F4_COMING_OF_AGE2_F4_ComingOfAge2S030.wav	ɖɯ˧-pʰo˧˥ ◊ -dʑo˩, | bo˩ʈʂʰæ˥-bi˩ tʰv̩˩-kʰɯ˩! | kʰɯ˧tsʰɤ˧˥! | ɖɯ˧-pʰo˧˥ ◊ -dʑo˩, | ɕi˧ʈʂʰwæ˧-bi˩ tʰv̩˩-kʰɯ˩! |
crdo-NRU_F4_HOUSEBUILDING2_HOUSEBUILDING2_S226.wav	<gɤ˩…> gɤ˩-ʑi˥, | ʈʂʰwæ˩-kv̩˩ pi˥-zo˩! | v̩˩tsʰɤ˧˥ | ʈʂʰɯ˧ne˧ ʝi˥ | tʰi˧-qɑ˩. |
crdo-NRU_F4_DOG2_Dog2S077.wav	kʰv̩˧ | ɖɯ˧-v̩˧~ɖɯ˧-v̩˧, | gi˩˥ | ɖwæ˧˥ | zɯ˧ ʂæ˧! |
crdo-NRU_F4_CARAVANS_CaravansS287.wav	ə˧ʝi˧-ʂɯ˥ʝi˩-dʑo˩ | tʰi˩˥, | no˧ | ʈʂʰɤ˧tsɯ˧ | mɤ˧-tʰo˥! | ʈʰææ̃˧ | ʐwæ˧ tɕɯ˩-lɑ˩ ɲi˩-mæ˩! | ʐwæ˧ tɕɯ˩-zo˩, | ɖwæ˧˥ | ʈʰi˩˥, ◊ ə˩-gi˩! |
crdo-NRU_F4_ELDERS3_Elders3S033.wav	ə˧v̩˧˥ | ɬi˧-hĩ˧ | le˧-ʂe˧-le˧-po˧-tsʰɯ˧˥! |
crdo-NRU_F4_HEALING_HealingS050.wav	"tʰi˩˥, | ""no˧=ɻ̍˩ | pæ˧-wo˧-ho˥!"" | pi˧, | ""ə˧-dzɤ˥ | le˧-pæ˥!"" | pi˧-ɲi˥-tsɯ˩ ◊ -mv̩˩.
			|"
crdo-NRU_Mariage_De_La_Soeur_V3_Sister3_S102.wav	<əəə…> ə˧mv̩˧˥ | no˧-ʁo˧to˩ | mɤ˧-fv̩˧-di˩ | mɤ˧-dʑo˧. |
crdo-NRU_F4_FUNERAL_F4_FUNERAL_S103.wav	"""njɤ˧ | ə˧mi˧ ʂɯ˧-ze˧!"" | pi˧. |"
crdo-NRU_F4_FOOD_SHORTAGE_FoodShortageS012.wav	"""ə˧zɯ˩ | tʰi˩˥, | le˧-wo˥-le˩-bi˩-ze˩!"" | pi˧-zo˩ | tʰi˩˥, | kʰi˧-ɲi˥-tsɯ˩ ◊ -mv̩˩!"
crdo-NRU_F4_FUNERAL_F4_FUNERAL_S035.wav	ʈʂʰɯ˧-hwɤ˧-hĩ˧ | tʰi˩˥, | ɲi˧-gi˧ F | le˧-ɖʐɤ˧˥! |
crdo-NRU_F4_MOUNTAINS_F4_MountainsS043.wav	"""ə˧mi˧! | <njɤ˧…> di˧qo˧ mɤ˧-dʑo˧-hĩ˧, | njɤ˧ dʑo˧! | dʑɯ˩ʁo˩˥ | mɤ˧-dʑo˧-hĩ˧, | njɤ˧ dʑo˧!"" |"
crdo-NRU_F4_FOOD_SHORTAGE2_FOOD_SHORTAGE2S041.wav	tʰi˩˥, | ʈʂʰɯ˧-ʑi˧=ɻ̍˥-dʑo˩, | æ˧ʂæ˧ | ʈʂʰɯ˧ne˧ gv̩˧-ɲi˥-tsɯ˩ ◊ -mv̩˩!
crdo-NRU_F4_HOUSEBUILDING2_HOUSEBUILDING2_S220.wav	õ˧-ʈʂʰɯ˧-ʁo˥! | ɬi˧ʈv̩˥ gɤ˩-ʑi˩-kv̩˩! | ɬi˧ʈv̩˥ qwæ˩-bi˩-kv̩˩-ze˩! |
crdo-NRU_F4_HOUSEBUILDING2_HOUSEBUILDING2_S348.wav	ɲi˧ʈʂæ˧ʑi˧ dɑ˥ | tʰi˩˥ | ɖʐv̩˧=ɻæ˩ ɳɯ˩, | no˧ ɳɯ˧ njɤ˩ qɑ˩~qɑ˩ | le˧-dɑ˧˥! |
crdo-NRU_F4_MOUNTAINS_F4_MountainsS101.wav	ʈʂʰɯ˧ | ɖɯ˧-ʑi˩ ɲi˩-kv̩˩-tsɯ˩ ◊ -mv̩˩, | ʁɑ˩ʂɯ˧! | ŋwɤ˧hɑ̃˩-lɑ˩ | ʂwæ˧gv̩˧-ʈʂʰɯ˧! |
crdo-NRU_F4_HOUSEBUILDING2_HOUSEBUILDING2_S239.wav	hĩ˧-ʈʂʰɯ˧, | ʐæ˧v̩˩ tʰv̩˩! | ə˧tso˧ mɤ˧-ɲi˩, | hĩ˧-ɳɯ˩ | so˧-hĩ˧-lɑ˥ ɲi˩, ə˩-gi˩! |
crdo-NRU_Mariage_De_La_Soeur_V3_Sister3_S010.wav	tʰi˩˥, | ə˧mv̩˧˥ | le˧-mɤ˧-tsʰɯ˩-dʑo˩ | tʰi˩˥, |
crdo-NRU_AGRICULTURAL_ACTIVITIES_Agriculture_S013.wav	ʝi˧-le˧-lv̩˩-hĩ˩-bv̩˩ | ʈʂe˧ | le˧-tsɑ˩~tsɑ˩! | ʈʂe˧ tsɑ˩! |
crdo-NRU_F4_CARAVANS_CaravansS149.wav	"əəə… zo˩no˥, | hĩ˧ sɯ˧~sɯ˧-hĩ˧, | ɖʐv̩˧-ʈʂʰɯ˧, | ə˧zɯ˩, | no˧… | ə˧zɯ˩ |
			tɕʰo˧-tɕʰo˧-ɻ̍˩ | kʰi˧˥, | pi˧, | no˧ ʁo˧dɑ˧ | le˧-hɯ˩-pi˩, | no˧-ki˧ mv̩˥do˩, ◊ ə˩-gi˩! |
			njɤ˧ | le˧-mɤ˧-tsʰɯ˩-pi˩! |"
crdo-NRU_F4_TIGER2_Tiger2S013.wav	""" '<ʐæ˩ d…> lɑ˧ do˩, | ə˧dɑ˧ ʂɯ˧! | ʐæ˩ do˥, | ə˧mi˧ ʂɯ˧!' | pi˧!"" |"
crdo-NRU_F4_FOOD_SHORTAGE_FoodShortageS055.wav	õ˧˥ | qʰɑ˩ne˩˥ | ɖɯ˧-ʑi˩ ɖɯ˩-ho˩, | mɤ˧-do˩! | dʑɤ˩-hĩ˥ | ɖɯ˧-ʑi˩ ɖɯ˩-ho˩, | mɤ˧-do˩! | qʰwɤ˩-hĩ˩˥ | ɖɯ˧-ʑi˩ do˩-ho˩, | mɤ˧-do˩! |
crdo-NRU_F4_DOG2_Dog2S110.wav	tʰi˩˥, | le˧-wo˧-tʰo˥-tɕo˩, | kʰv̩˩mi˩-lɑ˥ | hĩ˧ | qæ˧~qæ˧-tɕɯ˩-zo˩ | tʰi˩˥, | hĩ˧-dʑo˩ | ɖɯ˧-pi˧˥ | le˧-tʰi˧! | kʰv̩˩mi˩˥ | ɖɯ˧-pi˧˥ | le˧-bæ˧! |
crdo-NRU_F4_DOG2_Dog2S114.wav	hĩ˧-ʈʂʰɯ˧, | ʁɑ˩ʂɯ˧, | õ˧ʈʂʰɯ˧ne˧ gv̩˧-kv̩˥, | pi˧-zo˩! |
crdo-NRU_F4_CARAVANS_CaravansS220.wav	"ʐwæ˧ | le˧-tɕɯ˧-le˥-po˩-tsʰɯ˩, | <ɖæ˩mi˧ tʰi…> ɖæ˩mi˧-sɯ˩pʰi˩-ki˩ ki˩!
			|"
crdo-NRU_F4_HOUSEBUILDING2_HOUSEBUILDING2_S230.wav	ʈʂʰɯ˧-ɖɯ˧-mi˧… | kʰɤ˧˥ | ʈʂʰɯ˧-ɖɯ˧-mi˧-hĩ˧ | ɖɯ˧-ɭɯ˧-qo˧-ɳɯ˧, | ʈʂʰɯ˧-ʂwæ˧-mi˧-hĩ˧ | ɖɯ˧-ɭɯ˧-qo˧ | ɖɯ˧-kʰɤ˧ ɖɯ˥-kv̩˩-ze˩. |
crdo-NRU_AGRICULTURAL_ACTIVITIES_Agriculture_S006.wav	gv̩˩ɬi˩mi˩˥ | bæ˩˥ | le˧-ʂo˥, | hɑ˧ | le˧-ʂo˥ | le˧-po˧-tsʰɯ˧˥, |
crdo-NRU_AGRICULTURAL_ACTIVITIES_Agriculture_S030.wav	tʰi˩˥, | ʐe˧ʈæ˥-ɬi˩-qo˩ tʰv̩˩, | wɤ˩˥ | dʑɯ˧li˧! |
crdo-NRU_F4_DOG2_Dog2S038.wav	ə˧ʝi˧-ʂɯ˥ʝi˩, | hɑ˧ʐwɤ˩ <dzi˩-kʰv̩˩… ɖɯ˩-kʰv̩˩… so˩-kʰv̩˩…> [tʰv̩˩-so˩-kʰv̩˩], | ʈʰææ̃˧, | kʰv̩˩mi˩-ʈʂʰɯ˥ | qʰɑ˩jɤ˩ dʑo˩˥ ◊ -dʑo˩, | hæ˧-ɳɯ˧ | le˧-qʰo˧-le˥-se˩-ɲi˩-mæ˩! |
crdo-NRU_F4_MUSHROOMS_MUSHROOMS_S129.wav	sɯ˧-hĩ˧-dʑo˩, | le˧-dzɯ˥! |
crdo-NRU_F4_MUSHROOMS_MUSHROOMS_S152.wav	<zo…> zo˧mv̩˥-zo˩, | zo˩no˥, | tsʰe˧tʰv̩˧-pi˧, | ə˧ʝi˧-ʂɯ˥ʝi˩, | ɖɯ˧-ʁo˩ dʑo˩-ɲi˩-mæ˩. |
crdo-NRU_Mariage_De_La_Soeur_V3_Sister3_S097.wav	ʂv̩˧ɖv̩˧ | ʐwæ˩˥, | pi˧<-zo˥> | tʰi˩˥, | hɯ˧-ɲi˥-tsɯ˩-mæ˩! |
crdo-NRU_F4_FUNERAL_F4_FUNERAL_S229.wav	"""ə˧mi˧! | njɤ˧ | wɤ˩˥ | ʈʂʰɯ˧-ki˩ | pɤ˩jɤ˧ qʰæ˥-bi˩-zo˩-ʝi˩!"" | pi˧-zo˩. |"
crdo-NRU_F4_FUNERAL_F4_FUNERAL_S182.wav	tsʰi˧qʰæ˧˥ ◊ -dʑo˩, | qʰæ˧-mɤ˧-bi˧-ze˩-tsɯ˩! |
crdo-NRU_AGRICULTURAL_ACTIVITIES_Agriculture_S085.wav	tʰi˩˥, | wɤ˩˥ | le˧-qo˥-lv̩˩, | ɖɯ˧-qo˥-lv̩˩~ɖɯ˩-qo˩-lv̩˩ | tʰi˧-kʰɯ˧˥ |
crdo-NRU_F4_FUNERAL_F4_FUNERAL_S093.wav	õ˧ʈʂʰɯ˧ne˧ ʝi˥-kv̩˩, | nɑ˩-ʈʂʰɯ˥! |
crdo-NRU_F4_MUSHROOMS_MUSHROOMS_S164.wav	<tsʰe˧…> tsʰe˧tʰv̩˧-dʑo˧, | ʝi˧-kʰv̩˥~ʝi˩-kʰv̩˩ | qv̩˧ʈʂæ˧-qo˥ | ʈʂʰɯ˧ne˧-ʝi˥ | ɖɯ˧-tʰv̩˧-ɳɯ˧ | mv̩˩tɕo˧ bi˧, ◊ ə˩-gi˩! | ɖɯ˧-tʰv̩˧-ɳɯ˧ | gɤ˩tɕo˧ jo˧-kv̩˧-mɤ˥-kv̩˩! |
crdo-NRU_F4_HOUSEBUILDING2_HOUSEBUILDING2_S070.wav	no˧ | tʰi˧-ʑi˧-hĩ˧ ʈʂʰɯ˧-qo˧, | ʈʂe˧ dɑ˥-ɲi˩ mæ˩! | õ! | õ˧-ʈʂʰɯ˧ ne˧-ʝi˥ | tʰi˩˥, | ʈʂe˧ dɑ˥-ʈʂʰɯ˩-dʑo˩, | <hĩ˧… | > si˧-po˩-ɳɯ˩ | le˧-gv̩˩. |
crdo-NRU_F4_TIGER2_Tiger2S037.wav	"tʰi˩˥, | ""bi˧-tsæ˧-ɲi˩!"" | pi˧ | tʰi˩˥, | ʈʂʰɯ˧ | pʰæ˧tɕi˥ | ʈʂʰɯ˧-v̩˧-ɳɯ˩: |"
crdo-NRU_F4_CARAVANS_CaravansS101.wav	"ə˧mi˧=ɻæ˩-bv̩˩ | tso˧~tso˧ tɕɯ˩-di˩-lɑ˩-ɲi˩-mæ˩! | le˧-tɕɯ˧˥, | ho˧di˧ tɕʰi˧-hɯ˧!
			|"
crdo-NRU_F4_HEALING_HealingS079.wav	ʝi˧kʰv̩˥-dʑo˩, | qʰwɤ˧! | ʝi˧kʰv̩˥-dʑo˩, | mɤ˧-qʰwɤ˧! |
crdo-NRU_F4_CARAVANS_CaravansS192.wav	bɑ˩lɑ˩˥ | mv̩˧-di˩ mɤ˩-dʑo˩! |
crdo-NRU_F4_FOOD_SHORTAGE2_FOOD_SHORTAGE2S083.wav	"""ə˩-sɯ˧kv̩˥, | ɖɯ˧-kʰv̩˧-lɑ˥ ɲi˩-kv̩˩, | ə˧-dzɤ˧-le˧-tsɤ˧-kv̩˧˥, | ə˧-sɯ˥!"" |"
crdo-NRU_F4_HOUSEBUILDING2_HOUSEBUILDING2_S308.wav	"""ə˧mi˧! | ɳæ˧=ɻ̩˩-se˩, | le˧-gɤ˩-ze˩ wɤ˩! | ʑi˧qʰwɤ˧ | ʈʂʰɯ˧ne˧-ʝi˥ | dʑɤ˩-hĩ˥ | ɖɯ˧-ɭɯ˧ tsʰɯ˧-õ˥!"" |"
crdo-NRU_F4_FOOD_SHORTAGE_FoodShortageS037.wav	le˧-pʰv̩˧-se˥-dʑo˩ | tʰi˩˥, | le˧-bv̩˩! |
crdo-NRU_F4_DOG2_Dog2S058.wav	tʰi˩˥, | əəə… gɯ˧-ɳɯ˧ | qʰæ˧-dʑo˧, | ə˧zɯ˩… | æ˧ʂæ˧-tɑ˩mv̩˩-ʈʂʰɯ˩-dʑo˩, | ʐwɤ˩˥ ◊ -dʑo˩, | ʐwɤ˩-kv̩˩˥! |
crdo-NRU_F4_RENAMING_RenamingS020.wav	"tʰi˩˥, | ʈʂʰɯ˧-v̩˧-ɳɯ˩: | tʰv̩˧-v̩˧-ɳɯ˩ | tʰi˩˥, əəə… | ""tsɤ˧-ʝi˧! | tsɤ˧-ʝi˧!"" |
			ə˧mi˧! ʈʂʰɯ˧-v̩˧-ɳɯ˩: | ""njɤ˧ tsʰi˧-ɲi˧ ɖɯ˧-sɑ˥ | mɤ˧-po˧˥!"" | pi˧-tsɯ˩ ◊ -mv̩˩. |"
crdo-NRU_F4_HEALING_HealingS087.wav	ʈʂʰo˧-lɑ˧-kv̩˥! |
crdo-NRU_F4_MUSHROOMS_MUSHROOMS_S056.wav	mɤ˧-ʈʂʰæ˧~ʈʂʰæ˧! | dʑɯ˧ F | mɤ˧-dʑo˧-ɲi˥-mæ˩! | <ʈʂʰɯ˧…> ʈʂe˧-ʈʂʰɯ˧ le˧-si˩~si˩! |
crdo-NRU_F4_CARAVANS_CaravansS134.wav	ə˧ʝi˧-ʂɯ˥ʝi˩-dʑo˩, | ʈʂʰɯ˧ne˧-ʝi˥ | le˧-tsʰɯ˩-mɤ˩-ɲi˩-ze˩-wɤ˩! |
crdo-NRU_F4_HOUSEBUILDING2_HOUSEBUILDING2_S231.wav	<õ˧-ʈʂʰɯ˧-lɑ˥ ɲi˩> [õ˧-ʈʂʰɯ˧-lɑ˩ ɲi˩]. | di˧qo˧-gɤ˧, | ʁæ˧mɤ˧-ʑi˧, | õ˧-bv̩˥-õ˩ | <ʑ…> gɤ˩-ʑi˥-hĩ˩, | ʝi˧se˧-hĩ˧-bv̩˧, | gɤ˩-ʑi˥-hĩ˩ | qwæ˩~qwæ˧˥ | dzɯ˧-lɑ˩-ɲi˩. |
crdo-NRU_Naissance_du_Lac_V3_Lake3_S072.wav	ʈʂʰɯ˧-ɲi˥-kv̩˩-ɳɯ˩ dʑo˩, | le˧-gv̩˩ | le˧-tʰv̩˧-ɲi˥-kv̩˩-tsɯ˩ mv̩˩! |
crdo-NRU_F4_HOUSEBUILDING2_HOUSEBUILDING2_S350.wav	le˧-se˧~se˥-kwɤ˩tɕɯ˩ lɑ˩ | tʰi˩˥, | ʑi˧qʰwɤ˧-ʈʂʰɯ˧, | ʑi˧mi˧ ɖɯ˧-ɭɯ˧, | ɲi˧ʈʂæ˧ʑi˧˥ | ɖɯ˧-ɭɯ˧ di˩-kv̩˩-ze˩! |
crdo-NRU_F4_FOOD_SHORTAGE_FoodShortageS034.wav	dze˧ɭɯ˧ | <le˧-lɑ˧˥… le˧…> le˧-kʰv̩˥ | le˧-po˧-tsʰɯ˧˥! | ə̃! dze˧ɭɯ˧ | le˧-lɑ˧˥, |
crdo-NRU_F4_FOOD_SHORTAGE2_FOOD_SHORTAGE2S023.wav	"""ə˧mi˧! | njɤ˧-mv̩˩! | ə˩zɯ˩˥, | ə˧mɑ˧ | no˧ | le˧-ʂv̩˧-po˧-tsʰɯ˧-hĩ˥, | ʈʂʰɯ˧-dʑo˩, | no˧ | tɕʰi˧-bi˧-pi˧-ɲi˥!"" |"
crdo-NRU_F4_CARAVANS_CaravansS271.wav	ɖɯ˧-hɑ̃˧-ɳɯ˥, | ʈʂʰɯ˧ne˧-ʝi˥ | qo˩tv̩˥ | ɖɯ˧-ɭɯ˧~ɖɯ˧-ɭɯ˧ ɲi˩! |
crdo-NRU_F4_DOG2_Dog2S020.wav	"""tsʰe˩so˩-kʰv̩˩˥, | ʁɑ˩ʂɯ˧, | no˧sɯ˩kv̩˩, | zo˧mv̩˥, | ʁo˧dɑ˧, | zɯ˧~zɯ˧ | qʰɑ˩ne˩˥ | ɖɯ˧-kv̩˧˥, | ʈʰæ˧ | le˧-ki˧!"" | pi˧-zo˩. |"
crdo-NRU_F4_SEEDS_SeedsS031.wav	mv̩˧ʁo˥-dʑo˩, | gɤ˧lɑ˧ ɲi˩, | pi˧-zo˩! |
crdo-NRU_F4_HOUSEBUILDING2_HOUSEBUILDING2_S258.wav	əəə… ɳɯ˩dʑɯ˥ | ɳæ˧ mɤ˥-kv̩˩! | ʐɯ˧-sɯ˧ | le˧-tɕɤ˧˥! | le˧-se˩-kʰɯ˩! | le˧-tʰv̩˧-kʰɯ˧˥! | tʰi˩˥, | ʐɯ˧ le˧-kʰɯ˩~kʰɯ˩! |
crdo-NRU_F4_MOUNTAINS_F4_MountainsS063.wav	bæ˧ | ʈʂʰɯ˧ne˧-ʝi˥ | ɖɯ˧-ʈʰɤ˥-ɳɯ˩ | tʰi˩˥ | -no˧˥ | ʝi˧-bi˧-di˧˥ F | mɤ˧-di˩! |
crdo-NRU_F4_MOUNTAINS_F4_MountainsS155.wav	əəə… qv̩˧ɻ̍˧-ʈʂʰæ˧nɑ˥-dʑɯ˩ le˩-ʈʂʰæ˩! | əəə… pi˧-zo˩, | ʈʂʰɯ˧ne˧-ʝi˥ | le˧-ʐwɤ˩-zo˩ | tʰi˩˥, | æ˧ʂæ˧-bv̩˧… | æ˧ʂæ˧-dʑɯ˩-ʈʰæ˩qo˩-ɳɯ˩, | æ˧ʂæ˧-dʑɯ˩ | ʈʂʰɯ˧ne˧-ʝi˥ | ɖɯ˧-ʈʰɤ˥ tʰi˩-bæ˩! |
crdo-NRU_F4_CARAVANS_CaravansS068.wav	"əəə… tsʰe˧! ə̃, | jɤ˧ŋɤ˧! | o! jɤ˧ŋɤ˧ hɯ˧-ɲi˥-wɤ˩! | jɤ˧ŋɤ˧-dʑo˧, | ʂe˧ʈʂe˩-lɑ˩ | əəə…
			ʁo˧ni˥ dʑo˩-kv̩˩! |"
crdo-NRU_F4_SEEDS_SeedsS072.wav	õ˧ʈʂʰɯ˧ne˧-ʝi˥… | ə˧ʝi˧-ʂɯ˥ʝi˩, | njɤ˧ ə˧si˧ | ʈʂʰɯ˧ne˧-ʝi˥ | ʐwɤ˩-kv̩˩˥ | wɤ˩! |
crdo-NRU_F4_FOOD_SHORTAGE_FoodShortageS045.wav	le˧-pʰi˧, | le˧-pʰi˧-se˩-dʑo˩ | tʰi˩˥, | wɤ˩˥ | ʈʂo˧ɭɯ˧-qo˩-ɳɯ˩… | ə˧ʝi˧-ʂɯ˥ʝi˩-dʑo˩, | ʈʂo˧ɭɯ˧, | hĩ˧-ɳɯ˩ | ʈʂo˩-ɲi˥-mæ˩! |
crdo-NRU_F4_HOUSEBUILDING2_HOUSEBUILDING2_S247.wav	ɖɯ˧-tso˧kʰwɤ˧ | tʰi˧-kʰɯ˩ | po˧-kʰi˥ | dʑo˩˥, | hĩ˧ ʈʂʰɯ˧, | ʐo˩-tɕʰæ˩ɻæ˥ gv̩˩ ɲi˩-ze˩ wɤ˩!
crdo-NRU_F4_CARAVANS_CaravansS200.wav	ə˧ti˥dzi˩!
crdo-NRU_F4_HOUSEBUILDING2_HOUSEBUILDING2_S024.wav	zɑ˩-bɑ˧lɑ˩ <ʈʂʰ…> | ʈʂʰɯ˧-qo˧ di˩, | si˧tʰv̩˧… | dʑɤ˩-hĩ˥… | ʂwæ˩gv̩˩˥ ◊ -dʑo˩, | ɖɯ˧-gi˥ | ʈʂʰɯ˧-gi˧ gv̩˥ le˩-jo˩, | ɖɯ˧-gi˥ | ʈʂʰɯ˧-gi˧ gv̩˥ le˩-jo˩, | tʰi˩˥, | zɑ˩-bɑ˧lɑ˩! | ə˧mɑ˧-ki˩, | no˧ | do˩-mɤ˥-do˩, ə˩-gi˩! |
crdo-NRU_Naissance_du_Lac_V3_Lake3_S022.wav	ɑ˩ʁo˧-hĩ˧-ɳɯ˩ | hɯ˧-dʑo˥ | tʰi˩˥, | li˧-hɯ˧-ɲi˥, -tsɯ˩ mv̩˩! |
crdo-NRU_F4_ELDERS3_Elders3S040.wav	njæ˧sɯ˩kv̩˩-ki˩, | zo˧mv̩˥-ki˩, | ɖwæ˧˥ | pʰv̩˧ɖɯ˧-ʝi˥-kv̩˩-mæ˩! |
crdo-NRU_F4_CARAVANS_CaravansS019.wav	"tʰi˩˥, | ho˧di˧ le˧… | wɤ˩˥ | ɖɯ˧-ɬi˧ tʰi˧-dzi˩. | le… əəə… ɑ˩ʁo˧ | le˧-tsʰɯ˩-dʑo˩
			| tʰi˩˥, | njæ˩sɯ˩kv̩˩-ki˩ | pʰɤ˧bɤ˧ | qʰɑ˩jɤ˩ le˥-po˩-jo˩-kv̩˩-mæ˩! |"
crdo-NRU_F4_MOUNTAINS_F4_MountainsS154.wav	"<no˧…> ʐwɤ˩-mɤ˩-hĩ˩-hĩ˥-ʈʂʰɯ˩-dʑo˩, | əəə… ""mɤ˧-ʂo˩ F | le˧-ʂo˩-kʰɯ˩! | mɤ˧-ze˩ F | le˧-ze˩-kʰɯ˩! |"
crdo-NRU_F4_TIGER2_Tiger2S116.wav	"""no˧ | ə˧mi˧-ki˧ | se˧pʰɤ˧ ʝi˧-mɤ˧-zo˧-ze˩!"" |"
crdo-NRU_F4_HOUSEBUILDING2_HOUSEBUILDING2_S311.wav	zo˧mv̩˥ hɤ˩-hĩ˩-dʑo˩, | ʈʂʰɯ˧ne˧-ʝi˥ | ʑi˧qʰwɤ˧ | dʑɤ˩-hĩ˥ tsʰi˩-kv̩˩! |
crdo-NRU_F4_CARAVANS_CaravansS075.wav	"njɤ˧ ə˧v̩˧-ʈʂʰɯ˧, | tʰo˩lo˧… | ɻ̍˩ɻ̍˧lo˩-pi˩-kv̩˩-mæ˩! | ə˧v̩˧˥ | ɖɯ˩-hĩ˩-ɳɯ˥! |
			ʈʂʰɯ˧ne˧-ʝi˥ | di˧˥ ◊ -dʑo˩! |"
crdo-NRU_F4_SEEDS_SeedsS012.wav	ʁo˧hṽ˧-qo˥-ʈʂʰɯ˩, | ɖɯ˧-qɑ˩… | ɖɯ˧-tsʰɤ˩~ɖɯ˩-tsʰɤ˩, | ɖɯ˧-tsʰɤ˩~ɖɯ˩-tsʰɤ˩ | tʰi˧-kʰɯ˧-kv̩˥ ◊ -mæ˩, ◊ ə˩-gi˩! |
crdo-NRU_Mariage_De_La_Soeur_V3_Sister3_S009.wav	tʰi˩˥, | go˧mi˧ | le˧-ɖɯ˩, |
crdo-NRU_F4_FOOD_SHORTAGE_FoodShortageS096.wav	"""ə˧ʝi˧-ʂɯ˥ʝi˩-dʑo˩, | dʑi˧hṽ˧-mv̩˩di˩ F | mɤ˧-dʑo˧! | əəə… hɑ˧ dzɯ˧-di˧˥ F | mɤ˧-dʑo˧! | mv̩˧di˧-qo˥, | hĩ˧ F | mɤ˧-dʑo˧!"" |"
crdo-NRU_F4_HOUSEBUILDING2_HOUSEBUILDING2_S090.wav	zo˩no˧, | hĩ˧ | <gɯ˩-ʝi˥… | > ɖwæ˧˥ | hɤ˩-hĩ˩˥, | hĩ˧ | zo˩no˧ | sɯ˧pʰi˧-ne˩-ʝi˩-hĩ˩ | ʈʂʰɯ˧-tɕi˩-ɳɯ˩, | ɲi˧ʈʂæ˧-ʑi˧ lɑ˥ ɲi˩ mæ˩! |
crdo-NRU_F4_COMING_OF_AGE2_F4_ComingOfAge2S041.wav	tʰi˩˥, | ʈʂʰɯ˧ne˧ ʝi˥-se˩-dʑo˩ | tʰi˩˥, | lo˩dʑo˥ tʰi˩-kʰɯ˩-kʰɯ˩! |
crdo-NRU_F4_HOUSEBUILDING2_HOUSEBUILDING2_S242.wav	v̩˩tsʰɤ˧˥ | ʂɯ˧-hĩ˥ F | dzɯ˧-di˧ dʑo˧-ɲi˥-ze˩! |
crdo-NRU_Naissance_du_Lac_V3_Lake3_S067.wav	tʰi˩˥, | hi˩nɑ˧mi˧-ʈʂʰɯ˧ | ʈʂʰɯ˧ne˧-ʝi˥ | le˧-tsʰɯ˩-kwɤ˩tɕɯ˩, | hĩ˧ ʈʂʰɯ˧-ɲi˥-kv̩˩ tɑ˩kɤ˩-lɑ˩ lv̩˩ ɲi˩-tsɯ˩. |
crdo-NRU_F4_TIGER2_Tiger2S123.wav	"""ə˩sɯ˧kv̩˥, | ʈʂʰæ˩~ʈʂʰæ˩˥ | kɤ˧wɤ˧-ljɤ˧-ɳɯ˥ | tʰi˧-dʑo˧-ɲi˥-ʝi˩!"" |"
crdo-NRU_Naissance_du_Lac_V3_Lake3_S062.wav	tʰi˩˥, ◊ -dʑo˩, | ɲi˧zo˧ | ʈʂʰɯ˧-mi˧-ɳɯ˥ | le˧-ʝi˥-zo˩, | tʰi˩˥, | hi˩nɑ˧mi˧ tsɤ˧-ɲi˥, -tsɯ˩ mv̩˩! |
crdo-NRU_F4_CARAVANS_CaravansS225.wav	ɖæ˩mi˧-sɯ˩-pʰi˩ | hĩ˧ ɲi˥-ze˩-mæ˩! | ə˧mv̩˧-gi˥zɯ˩-ni˩! |
crdo-NRU_F4_RENAMING_RenamingS004.wav	"""ə˧mi˧! | ə˧ʑi˧=ɻæ˥, | njɤ˧ | zo˧mv̩˥ | ʈʂʰɯ˧-ɭɯ˧ | ɖɯ˧-pi˧˥ | ŋv̩˩˥! | ʁɑ˩mi˧! | no˧ |
			pæ˧˥hwɤ˧ | ə˩-dʑo˧? |"
crdo-NRU_F4_FOOD_SHORTAGE2_FOOD_SHORTAGE2S084.wav	"""zo˧mv̩˥-dʑo˩, | tɕʰi˧-mɤ˧-ɖo˧!"" | pi˧-zo˩. |"
crdo-NRU_F4_CARAVANS_CaravansS209.wav	<ə˧ʝi˧…> ə˧ʝi˧-tsʰi˧ʝi˧-ni˧˥, | ŋv̩˧ | ʈʂʰɯ˧ne˧-ʝi˥ | ɖɯ˧-tɑ˩~ɖɯ˩tɑ˩, | zo˩qo˧ dʑo˧? |
crdo-NRU_F4_HEALING_HealingS091.wav	"le˧-qwæ˧˥! | tʰi˩˥, | <ɖɯ˧-bæ˧~ɖɯ˧-bæ˧ | le˧-pʰi˧˥> [ɖɯ˧-bæ˧ ɖɯ˧-kʰwɤ˥
			tʰi˩-kʰɯ˩], | ʈʂʰɯ˧ne˧-ʝi˥ | l le˧-tɕɤ˧˥ | le˧-ʈʰɯ˩-pi˩-zo˩! |"
crdo-NRU_F5_AHABALA2_F5_Ahabala2S002.wav	ʁo˧-ʂwæ˧-qo˧pv̩˩, | qo˧pv̩˩ tsɯ˩-lɑ˩ | ə˧mɑ˧ | njɤ˧ lwæ˧˥ -dʑo˩-ni˩-gv̩˩... jɤ! |
crdo-NRU_F4_FUNERAL_F4_FUNERAL_S219.wav	pɤ˩jɤ˧˥ | ʐv̩˩-ɭɯ˩˥, | ʐv̩˩-ɭɯ˩˥, | ʐv̩˩-ɭɯ˩˥, | ʐv̩˩-ɭɯ˩˥! | ʈæ˧bɤ˧ | tsʰe˩-kv̩˩ ʁɑ˩ʂe˥, | pi˧, | pɤ˩jɤ˧˥ | ʐv̩˧tsʰi˩-ɭɯ˩. |
crdo-NRU_Naissance_du_Lac_V3_Lake3_S018.wav	"tʰi˩˥, | ""ə˧tse˧-ʝi˧-ɲi˥! | ʈʂʰɯ˧ | tɕʰɤ˧ɲi˧-ne˧-ʝi˥, | ʐo˩˥ | le˧-po˧-pi˥, | mɤ˧-po˧˥, |"
crdo-NRU_F4_HOUSEBUILDING2_HOUSEBUILDING2_S218.wav	tsʰe˧-ɬi˧mi˧… | ʐe˧ʈæ˥-ɬi˩… | lɑ˩jɤ˧-ɬi˧… | ɖɯ˧-ɬi˧mi˧… | ɲi˧-ɬi˧mi˧ | … [tʰv̩˧-]qo˧ tʰv̩˧, | ɬi˧ʈv̩˥! |
crdo-NRU_F4_HEALING_HealingS028.wav	"tʰi˩˥, | dɑ˧pɤ˧-ɳɯ˧ | le˧-ʈʂʰo˧, | le˧-ʈʂʰo˧, | le˧-ʈʂʰo˧-dʑo˥, | ""no˧=ɻ̍˩-dʑo˩, | ʑi˧qʰwɤ˧ | tʰi˧-dzi˩-hĩ˩ | tʰv̩˧-kʰwɤ˧-qo˩, | ɖɯ˧-pi˧˥ | mɤ˧-dʑɤ˩!"" | pi˧-tsɯ˩ ◊ -mv̩˩. |"
crdo-NRU_F4_DOG2_Dog2S112.wav	zo˩no˥, | hĩ˧ F | zo˩qo˧ se˧, | kʰɯ˧tsʰɤ˧˥ | tsʰɑ! tsʰɑ! pi˧-bi˧, | ʈʂʰɯ˧ | le˧-sɯ˥-kwɤ˩tɕɯ˩-lɑ˩, | ʁwɑ! ʁwɑ! ʁwɑ! pi˧ | lv̩˩-ɲi˥! |
crdo-NRU_F4_MUSHROOMS_MUSHROOMS_S123.wav	ʈʂʰɯ˧-ɖɯ˧~ɖɯ˧, | ʈʂʰɯ˧-ɖɯ˧~ɖɯ˧-zo˥! | ʈʂʰɯ˧-ʂæ˧~ʂæ˧-zo˥! |
crdo-NRU_F4_TIGER2_Tiger2S031.wav	ʐv̩˧di˧-pi˥-kv̩˩-ze˩, | njæ˧sɯ˩kv̩˩-dʑo˩, | nɑ˩-dʑo˥! |
crdo-NRU_F5_AHABALA1_F5_Ahabala1S011.wav	ʁo˧-ʂwæ˧-qo˧pv̩˩, | qo˧pv̩˩ tsɯ˩-lɑ˩ | ə˧mɑ˧ | njɤ˧ lwæ˧˥ -dʑo˩-ni˩-gv̩˩... jɤ! |
crdo-NRU_F4_FUNERAL_F4_FUNERAL_S172.wav	tʰv̩˧-ʁo˥, | bo˩ʈʂʰæ˧, | qʰɑ˩jɤ˩ dʑo˩-kv̩˥-ɲi˩! |
crdo-NRU_F4_FOOD_SHORTAGE_FoodShortageS083.wav	wo˩-ʈʂʰɯ˥-dʑo˩ | tʰi˩˥, | nɑ˩-bv̩˥ | hɑ˧! | sɑ˧<-bv̩˧>-ʈʂʰɯ˧, | nɑ˩-bv̩˥ | dʑi˧hṽ˥! | pi˧, | æ˧ʂæ˧-tɑ˩mv̩˩-dʑo˩ | ʈʂʰɯ˧ne˧-ʝi˥ | dʑo˧-ɲi˥-mæ˩! |
crdo-NRU_F4_DOG2_Dog2S049.wav	ɖɯ˧-↑njɤ˧ | kʰv̩˩mi˩-ki˥ | ə˧tso˧ ʝi˧-bi˧-bi˧… | zo˩no˥, | bo˩ qʰo˧-bi˧-bi˧, | hi˧lɤ˩ | kʰv̩˩mi˩-ki˥-sɯ˩ | sɤ˧-sɯ˩ | ɖɯ˧-ʈʰɤ˧ tʰi˧-ʈʰɯ˧-kʰɯ˥! |
crdo-NRU_Mariage_De_La_Soeur_V3_Sister3_S017.wav	tʰi˩˥, | kʰv̩˩mi˩-ɳɯ˥, | tʰi˩˥, | <le˧…> | le˧-se˥, | le˧-se˥, | le˧-se˥-zo˩, | qo˩qɑ˩-ɳɯ˥ | le˧-bæ˧˥, | le˧-bæ˧˥, | le˧-bæ˧˥, | le˧-bæ˧-zo˥, | tʰi˩˥, |
crdo-NRU_F4_FUNERAL_F4_FUNERAL_S140.wav	nɑ˩-ʈʂʰɯ˥, | ə˧ʝi˧-ʂɯ˥ʝi˩, | hĩ˧ ʂɯ˧, | ʈʂʰɯ˧ne˧ ʝi˥-kv̩˩-mæ˩! |
crdo-NRU_F4_MOUNTAINS_F4_MountainsS055.wav	"""hĩ˧-ʈʂʰɯ˧ | so˩-ʈʂʰæ˩ hɤ˥ -bi˩, | ɖɯ˧-ʈʂʰæ˧ hɤ˥-mɤ˩-kv̩˩! | ɖwæ˩-mɤ˧-zo˧!"" | pi˧-ɲi˥-kv̩˩-tsɯ˩ ◊ -mv̩˩. |"
crdo-NRU_F4_RENAMING_RenamingS043.wav	zo˧mv̩˥-ki˩, | njæ˧sɯ˩kv̩˩ | ʈʂʰɯ˧ne˧-ʝi˥ | ki˧-kv̩˧˥! |
crdo-NRU_F4_ELDERS3_Elders3S050.wav	"tʰæ˧ɻæ˩ mɤ˩-so˩-hĩ˩-ɖʐɯ˩kʰɤ˩ tʰv̩˩, | pi˧-dʑo˩, | hĩ˧ kʰv̩˧-tʰɑ˧-hõ˧! | hĩ˧
			ʈʂæ˩-tʰɑ˩-hõ˩! | ə! lo˧ ʝi˧! | hɑ˧ dzɯ˧! | hĩ˧ kɤ˧ʈʂɯ˥ ɲi˩! | ɑ˩ʁo˧-ʑi˧dv̩˧ ʝi˧!
			|"
crdo-NRU_F4_CARAVANS_CaravansS180.wav	le˧-tɕɯ˩~tɕɯ˩ | le˧-po˧-tsʰɯ˧˥, | ɑ˩ʁo˧ tʰv̩˧-ho˩, | gi˧dʑɯ˧ kʰi˧ | tʰi˩˥, | jo˧gv̩˧-ŋv̩˧ɭɯ˧-ʈʰæ˧qo˩ tʰv̩˩-dʑo˩, |
crdo-NRU_F4_CARAVANS_CaravansS073.wav	ə˧ti˥-dzi˩-pi˩ | ɖɯ˧-ʝi˧ bi˧-kv̩˧˥, | ʐwæ˧ tɕɯ˩-hĩ˩! |
crdo-NRU_F4_SEEDS_SeedsS030.wav	mv̩˧ʁo˥-dʑo˩, | gɤ˧lɑ˧ ɲi˩ ◊ -mæ˩, ◊ ə˩-gi˩! | njæ˧-sɯ˩kv̩˩, | di˧qo˧-dʑo˧ | tʰi˩˥, | ʈʂe˧-lɑ˩ ɲi˩ ◊ -mæ˩, ◊ ə˩-gi˩! |
crdo-NRU_F4_MOUNTAINS_F4_MountainsS128.wav	ʐwæ˧pv̩˩-dzi˩-ʁo˩to˩-ɳɯ˩-dʑo˩ | tʰi˩˥, | qv̩˧ɻ̍˧-ʁo˧to˩, | qv̩˧ɻ̍˧-ʈʂʰæ˧nɑ˥! | nɑ˩tsʰi˩˥ | tɕʰɤ˧pɤ˧mi˧ pi˧-dʑo˩, | qv̩˧ɻ̍˧-ʈʂʰɯ˧, ʈʂʰæ˧-ʈʂʰɯ˥! |
crdo-NRU_Mariage_De_La_Soeur_V3_Sister3_S033.wav	mæ˧qo˩ tʰv̩˩-dʑo˩ | tʰi˩˥, <əəə…> tʰi˩˥, | wɤ˩˥, | tʰi˧-dzi˩-se˩-dʑo˩ | tʰi˩˥, <əəə…> hɑ˧ dzɯ˧-ho˥-ze˩-tsɯ˩ ◊ -mv̩˩! | hɑ˧ dzɯ˧-ho˥! |
crdo-NRU_F4_HOUSEBUILDING2_HOUSEBUILDING2_S257.wav	ʐɯ˧ tɕɤ˧˥ | kwɤ˧tɕɯ˥-lɑ˩, | əəə… ɳɯ˩dʑɯ˥ | tʰi˩˥, | ʐɯ˧ tɕɤ˧˥ | ɖɯ˧-ɲi˥, | ɳæ˧˥ | [dʑo˩], | dʑɤ˩ mɤ˧-kv̩˧ pi˥-zo˩! |
crdo-NRU_F4_COMING_OF_AGE2_F4_ComingOfAge2S075.wav	tʰi˩˥, | ə˧dɑ˧=ɻ̍˧-ɳɯ˥ | ɖʐe˧… | dʑi˧hṽ˧ tʰi˩-ki˩, | mv̩˩zo˩-ki˥! | ɖʐe˧ tʰi˧-ki˧! | le˧-jo˩-kv̩˩-ze˩-mæ˩! |
crdo-NRU_F4_DOG2_Dog2S007.wav	əəə… zo˩no˥, | njæ˧sɯ˩kv̩˩, | kʰv̩˧ʂɯ˥, | zo˩no˥… | <no> zo˧mv̩˥-ʈʂʰɯ˩ | ʈʰæ˩ ki˩˥, | ɬi˧ ki˥-hĩ˩ | ʈʂʰɯ˧-dʑo˩, | tsʰe˩so˩-kʰv̩˩-hĩ˥ | ɬi˧ ki˥-hĩ˩ | ʈʂʰɯ˧-dʑo˩, ◊ ə˩-gi˩! | æ˧ʂæ˧ | ʈʂʰɯ˧-dʑo˩ | tʰi˩˥, | hĩ˧ | ʈʂʰɯ˧-dʑo˩, | tsʰe˩so˩-kʰv̩˩-lɑ˥ ɖɯ˩-ɲi˩-tsɯ˩-mv̩˩, | zɯ˧~zɯ˧-ʈʂʰɯ˧! |
crdo-NRU_F4_COMING_OF_AGE2_F4_ComingOfAge2S023.wav	<mmm… j… jo˧… | > jo˩lo˩˥, | ʁwæ˧lo˥ dʑo˩-kv̩˩-mæ˩! |
crdo-NRU_F4_HOUSEBUILDING2_HOUSEBUILDING2_S088.wav	tʰi˩˥, | ʈʂʰɯ˧ne˧ ʝi˥ se˩ kwɤ˩tɕɯ˩ lɑ˩ | tʰi˩˥, | qæ˧do˧ le˧-dɑ˧˥, | ɑ˩ʁo˧ le˧-tʰv̩˧-dʑo˥ | tʰi˩˥, | wɤ˩˥ | le˧-ʈɤ˥~ʈɤ˩ | le˧-po˧-tsʰɯ˧˥, | le˧-gɤ˩~gɤ˩ | le˧-po˧-tsʰɯ˧˥, | ʈʂʰɯ˧ne˧ ʝi˥ se˩-dʑo˩ | tʰi˩˥, | wɤ˩˥ | ʑi˧mi˧ dɑ˧˥ -ɲi˩ pi˩. | ɬɬɬ! ʑi˧qʰwɤ˧ tsʰi˧˥ ◊ -ɲi˩ pi˩. |
crdo-NRU_F4_TIGER2_Tiger2S069.wav	ə˧ʝi˧-ʂɯ˥ʝi˩, | hĩ˧ mo˥-hĩ˩ | ʐwɤ˩-dʑɯ˩-tsɯ˥ ◊ -mv̩˩!
crdo-NRU_F4_RENAMING_RenamingS018.wav	tʰi˩˥, | no˩ tsʰɯ˩-ʁo˩-to˥-dʑo˩, | tʰi˧-ʈʂʰɻ̍˧˥ ◊ -kwɤ˩tɕɯ˩, |
crdo-NRU_F4_FOOD_SHORTAGE2_FOOD_SHORTAGE2S013.wav	"""zo˩qo˧ dʑo˩-bi˩-pi˩-bi˩-bi˩, | ə˧zɯ˩, | zo˩qo˧ tɕʰi˧-bi˧, | so˧hwɤ˩, | le˧-kv̩˧˥, | le˧-sɯ˥-dʑo˩, | ə˧zɯ˩-mv̩˩-lɑ˩ ɲi˩!"" | pi˧-tsɯ˩ ◊ -mv̩˩. |"
crdo-NRU_AGRICULTURAL_ACTIVITIES_Agriculture_S004.wav	kʰv̩˧ʂɯ˥, dʑo˩ | tʰi˩˥, əəə… | kʰv̩˧ʂɯ˥-se˩, | əəə… ɖɯ˧ɬi˧mi˧ | <kʰɤ˧ʂɯ˧-kv̩˩-ze˩ mæ˩!> [lo˧ ʝi˧-kv̩˩-ze˩ mæ˩!] |
crdo-NRU_F4_MUSHROOMS_MUSHROOMS_S082.wav	njæ˧-sɯ˩kv̩˩ | dʑɯ˩ʁo˩ bi˩˥, | ʈʰæ˧mi˧-ɳɯ˩, | kv̩˧ | tʰi˩˥ | <w… po˧˥… | > kv̩˧ | dʑɤ˩pi˧ po˥-bi˩-kv̩˩; | õ˧-bv̩˥-õ˩ tv̩˩! | zo˩no˧-ni˩, | hwæ˧-mɤ˧-zo˧! |
crdo-NRU_F4_CARAVANS_CaravansS072.wav	"jɤ˧ŋɤ˧-pi˧ | ɖɯ˧-ʝi˧ bi˧-kv̩˧˥, | ə˧ʝi˧-ʂɯ˥ʝi˩! | ho˧di˧-pi˧, | ɖɯ˧-ʝi˧ bi˧-kv̩˧˥!
			|"
crdo-NRU_F4_HOUSEBUILDING2_HOUSEBUILDING2_S336.wav	nɑ˩-ʈʂʰɯ˥ | ə˧ʝi˧-ʂɯ˥ʝi˩ | kɯ˧ʈʂʰwɤ˩ gv̩˩-k[v̩˩]… | ɖɯ˧-njɤ˧ | kɯ˧ʈʂʰwɤ˩ gv̩˩-kv̩˩ ɲi˩. |
crdo-NRU_F5_HINAMI_F5_SONG_HINAMIS002.wav	ə˧hɑ˧-bɑ˩lɑ˩ | mɤ˧-dɑ˩-mi˩, jɤ! ə˧hɑ˧-bɑ˩lɑ˩ | mɤ˧-dɑ˩-mi˩, jɤ!
crdo-NRU_AGRICULTURAL_ACTIVITIES_Agriculture_S105.wav	ə˧mɑ˧ | ɖɯ˧-kʰwɤ˥ | dʑo˧-ɲi˥ wɤ˩! | ə˧ʝi˧-ʂɯ˥ʝi˩-bv̩˩! |
crdo-NRU_F4_FUNERAL_F4_FUNERAL_S260.wav	le˧-ʂɯ˧ | le˧-po˧-bi˥-kv̩˩, | pi˧-zo˩! | gɯ˧-mɤ˧-gɯ˩, | mɤ˧-do˩! | hĩ˧ F | le˧-ʂɯ˧-ɲi˥-ze˩, ◊ ə˩-gi˩! |
crdo-NRU_F4_FUNERAL_F4_FUNERAL_S070.wav	hɑ˧ | ɲi˧-kʰwɤ˥~ɲi˩-kʰwɤ˩ kʰɯ˩-zo˩. | ɖɯ˧-ʂɯ˩ qwæ˩-se˩, | wɤ˩˥ | ɖɯ˧-kʰwɤ˥ | tʰi˧-kʰɯ˧˥! | pi˧. |
crdo-NRU_F4_COMING_OF_AGE2_F4_ComingOfAge2S007.wav	"""ə˧mi˧! | njɤ˧=ɻ̍˩, | ze˩mi˩ tʰv̩˩-ɭɯ˩˥, | ʈʰæ˩ ki˩-tso˥-ɲi˩!"" | pi˧. | njɤ˧=ɻ̍˩, | <ʐv̩˧v̩˧> [ʐv̩˧mi˧] tʰv̩˧-ɭɯ˧, | ʈʰæ˩ ki˩-tso˥-ɲi˩-ze˩!"" | pi˧. |"
crdo-NRU_F4_DOG2_Dog2S076.wav	kʰv̩˧ | tʰi˧-pʰæ˧-dʑo˥… | le˧-mo˩, | le˧-mo˩, | ʈʰææ̃˧ | mɤ˧-ʂɯ˧-zo˩, | tsʰe˩qʰɑ˩-kʰv̩˩ gv̩˩-ɳɯ˥, | ʂɯ˧-ɲi˥-tsɯ˩ ◊ -mv̩˩!
crdo-NRU_F4_SEEDS_SeedsS068.wav	mv̩˩zɯ˩-ʈʂʰɯ˥-dʑo˩, | ə˧ʝi˧-ʂɯ˥ʝi˩, | ʈʰææ̃˧ | ki˧-mɤ˧-kv̩˧-tsɯ˥! | mɤ˧-ʂo˩ ɲi˩ pi˩-zo˩. |
crdo-NRU_F4_HEALING_HealingS015.wav	"""tsʰi˧ɲi˧-dʑo˩, | ʈæ˧bɤ˧ | ʈʂʰɯ˧-qo˧ | dʑɤ˩-hĩ˥ | ɖɯ˧-ɲi˧-kv̩˧ dʑo˧˥"", | pi˧, |
			le˧-ʁɑ˥-ʂe˩ | le˧-po˧-tsʰɯ˧˥, |"
crdo-NRU_F4_MUSHROOMS_MUSHROOMS_S026.wav	mmm… tʰv̩˧-gi˥ | le˧-ʈʂʰv̩˩-se˩-dʑo˩ | tʰi˩˥, | ə˩ljɤ˩hæ̃˩ʂɯ˥-mo˩ | pi˧-hĩ˧-tʰv̩˥-dʑo˩, | wɤ˩˥ | ɖɯ˧-pi˧˥ | ɖwæ˩ ʝi˧-kv̩˥! | ə˧ʝi˧-ʂɯ˥ʝi˩! |
crdo-NRU_F4_RENAMING_RenamingS005.wav	əəə… njɤ˧ | zo˧mv̩˥ | tʰv̩˧-ɭɯ˧-ki˧ | mv̩˧ ɖɯ˧-kʰwɤ˥ | ki˧-ɻ̍˩-mo˩! |
crdo-NRU_F4_HEALING_HealingS003.wav	"""ʈʂʰɯ˧-hĩ˧, | ɬo˧kʰv̩˧ go˩!"" | pi˧-zo˩. | <ɬo˧… zo˩no˥…>"
crdo-NRU_F4_TIGER2_Tiger2S119.wav	le˧-hɯ˩-dʑo˩ | tʰi˩˥, | ɑ˩ʁo˧ tʰi˧-tʰv̩˧-dʑo˧, | ə˧pʰv̩˧-lɑ˧ | ə˧ʑi˧-ki˥ | ʈʂʰɯ˧ne˧-ʝi˥ | le˧-ʐwɤ˩, | le˧-ʐwɤ˩, | le˧-ʐwɤ˩-dʑo˩, | ə˧ʑi˧-lɑ˥ | ə˧pʰv̩˧-ɳɯ˧: |
crdo-NRU_F4_HEALING_HealingS036.wav	"<le…> dɑ˧pɤ˧-ɳɯ˧ | le˧-pv̩˧, | le˧-pv̩˧, | le˧-pv̩˧, | le˧-pv̩˧, |
			le˧-pv̩˧-dʑo˥, | sɯ˩tʰi˩ tʰv̩˩-nɑ˥ | le˧-ʑi˩-ɻ̍˩! |"
crdo-NRU_F4_CARAVANS_CaravansS255.wav	"""ə˧mi˧! | njɤ˧-ki˧ | qʰwɤ˩˥ | ɲi˧-tʰv̩˩ tɕʰi˩-ɻ̍˩!"" | pi˧. |"
crdo-NRU_F4_CARAVANS_CaravansS190.wav	"""ɖʐe˧ se˩, | tʰi˧-se˩-kʰɯ˩! | njɤ˧ | zo˧ <se˥-ze˩> [tʰi˧-se˥-ʝi˩], | njɤ˧ | zo˧
			| dʑɤ˩˥ | mɤ˧-do˧-ze˥!"" | pi˧-zo˩. |"
crdo-NRU_F4_CARAVANS_CaravansS058.wav	"tʰi˩˥, | ʈʂʰɯ˧ne˧-ʝi˥ | hɯ˧! | ho˧di˧-dʑo˧, | ɕi˧ʈʂʰwæ˧ tɕɯ˧-le˥-po˩-tsʰɯ˩! | ʂe˧ʈʂe˩
			tɕɯ˩-le˩-po˩-tsʰɯ˩! | ʂe˧ʈʂe˩! | ho… ho˧di˧-ʂe˧ʈʂe˩-pi˩, | ə˧ʝi˧-ʂɯ˥ʝi˩! |"
crdo-NRU_F4_HEALING_HealingS010.wav	ʈʂʰæ˧ɣɯ˧-ki˩-hĩ˩, | mɤ˧-dʑo˩-ɲi˩-ze˩-mæ˩! | ə˧ʝi˧-ʂɯ˥-ʝi˩-dʑo˩! |
crdo-NRU_F4_CARAVANS_CaravansS069.wav	"ho˧di˧-dʑo˧, | tsʰe˧<-ʈʂʰɯ˧> | tɕɯ˧-le˧-po˧-tsʰɯ˧˥ ◊ -ɲi˩! | ə˧mɑ˧ ʐwɤ˩ | wɤ˩˥ |
			<le˧-tsʰo˥-ze˩> [mɤ˧-ho˩-ze˩]! |"
crdo-NRU_F4_CARAVANS_CaravansS145.wav	"""ə˧mi˧! | kʰv̩˧mæ˧ ʁo˧pv̩˩ ə˩-hɯ˩?"" |"
crdo-NRU_F4_DOG2_Dog2S070.wav	tʰi˩˥, | kʰv̩˩mi˩-ʈʂʰɯ˥-dʑo˩, | gi˩˥, | ʈʂæ˧ʈʂɯ˧, | æ˧ʂæ˧-ʈʂʰɯ˧-dʑo˩, | kʰv̩˩mi˩-ʈʂʰɯ˥, | zɯ˧ ʂæ˧-ɲi˥-kv̩˩-tsɯ˩ ◊ -mv̩˩!
crdo-NRU_F4_FOOD_SHORTAGE2_FOOD_SHORTAGE2S043.wav	"""ə˩-sɯ˧kv̩˥, | <qʰwɤ˧ tʰ… ŋ…> kʰv̩˧ qʰwɤ˧ tʰv̩˧-zo˥! | no˧-ɳɯ˧ njɤ˩ ʂv̩˩ɖv̩˩ F | mɤ˧-tʰɑ˧-ze˥!"" |"
crdo-NRU_F4_HOUSEBUILDING2_HOUSEBUILDING2_S287.wav	əəə… ʑi˧qʰwɤ˧ ʂɯ˧ qo˥ dzi˩ | ɖɯ˧-ɲi˥-dʑo˩, | mv̩˩si˧njɤ˧˥, | njɤ˧lɑ˥, hĩ˧ | ɲi˧-kv̩˧ ɳɯ˥ | mv̩˧ kʰɯ˩-kv̩˩-ze˩. |
crdo-NRU_F4_TIGER2_Tiger2S075.wav	"mv̩˩-ɳɯ˥: | ""mɤ˧-bi˧! | ə˧mɑ˧, | ə˧zɯ˩ | ↑ɲi˧-kv̩˧˥ F | kɤ˧kɤ˩ | tʰi˧-hĩ˧-bi˧!"" | pi˧-tsɯ˩ ◊ -mv̩˩. |"
crdo-NRU_F4_HOUSEBUILDING2_HOUSEBUILDING2_S021.wav	tʰi˩˥, | əəə… si˧tʰv̩˧…-dʑo˩, | ʑi˩-nv̩˩mi˩ ɲi˥! | pi˧-kv̩˩ mæ˩. |
crdo-NRU_F4_FUNERAL_F4_FUNERAL_S036.wav	ɲi˧-gi˧ F | le˧-ɖʐɤ˧˥, | le˧-dʑɯ˩! | tʰi˩˥, | le˧-tsɯ˥! |
crdo-NRU_Mariage_De_La_Soeur_V3_Sister3_S080.wav	ʐæ˩sɯ˩˥ | tʰv̩˧-kʰwɤ˧-bi˥, | lo˩qʰwɤ˧ ʈʂʰɯ˧-pʰo˥-bi˩ ʈʂʰv̩˩, | ʐæ˩sɯ˩˥ | tʰi˧-mv̩˧-hĩ˧-ʈʂʰɯ˧ | ɖɯ˧-pʰæ˧ hæ̃˥, | tʰi˧-kwɤ˩!
crdo-NRU_F4_COMING_OF_AGE2_F4_ComingOfAge2S089.wav	tʰi˩˥, | ʈʰæ˩ ki˩-hĩ˥ | tʰv̩˧-ɭɯ˧-dʑo˩, | tsʰe˩-so˩-kʰv̩˩-hĩ˥ | tʰv̩˧-v̩˧-dʑo˩, | ʈʰæ˧qʰwɤ˧ tʰi˧-ki˩! |
crdo-NRU_F4_FUNERAL_F4_FUNERAL_S205.wav	əəə… ɕi˧ʈʂʰwæ˧-pɤ˩jɤ˩ | ɲi˩-jɤ˩˥! | əəə… li˩˥ | ɖɯ˧-jɤ˧˥! | ʈʂʰɯ˧ne˧-ʝi˥ ◊ -zo˩, | ŋv̩˧ | mɤ˧-ʈʂɤ˧-zo˩, | mv̩˩kʰv̩˧˥! |
crdo-NRU_F4_CARAVANS_CaravansS224.wav	zo˩no˥, | mv̩˧ɭɯ˩-dʑo˩, | ɖæ˩mi˧-hĩ˧-ni˧gv̩˧ ɲi˥-ze˩-mæ˩! |
crdo-NRU_F4_HOUSEBUILDING2_HOUSEBUILDING2_S180.wav	"ʈʂɤ˧bi˧-dʑo˥, | ""ooo!!! no˧=ɻ˩ | <tsʰe˧ɲi˧… tsʰe˧ʝi˧… |> [tsʰe˧ʝi˧-dʑo˩, | dʑɤ˩˥! |] ʑi˧mi˧-dʑo˧, | dɑ˧-tʰɑ˥-ho˩!"" |"
crdo-NRU_F4_FUNERAL_F4_FUNERAL_S222.wav	tʰi˩˥, | njɤ˧=ɻ̍˩ | hĩ˧ ʂɯ˧-dʑo˩, | ɑ˩pʰo˩-hĩ˥ | ɖɯ˧-ʑi˧-ɳɯ˧ qʰæ˧˥! |
crdo-NRU_F4_FOOD_SHORTAGE_FoodShortageS110.wav	"""ɖɯ˧-kʰv̩˧˥, | ʈʰæ˧qʰwɤ˧ ɖɯ˧-ɭɯ˧-lɑ˧ dʑo˧-kv̩˥!"" | pi˧-zo˩, | ə˧ʝi˧-ʂɯ˥ʝi˩, | ʈʂʰɯ˧ne˧-ʝi˥ | ʐwɤ˩-kv̩˩˥ ◊ -mæ˩! |"
crdo-NRU_F4_FOOD_SHORTAGE2_FOOD_SHORTAGE2S054.wav	"gi˧tɕʰo˧-gi˥lɑ˩ hɯ˩-dʑo˩ | tʰi˩˥, | ""ə˧mi˧! | õ˧=ɻ̍˥ | hɑ˧ ɳɯ˧; | hɑ˧ ʐwɤ˩; | zo˧ ʈʂʰɯ˧-si˥ | ʈʂʰɯ˩-jɤ˩ dʑo˩˥, | əəə… zo˧ ʈʂʰɯ˧-tɕi˩-ɳɯ˩ | mo˧qʰwɤ˧-zo˥! | ə˧tso˧ mɤ˧-ɲi˩ | le˧-dzɯ˥ | ɲi˧-mɤ˧-tʰɑ˧˥!"" | pi˧. |"
crdo-NRU_F4_HOUSEBUILDING2_HOUSEBUILDING2_S312.wav	"""ə˧mi˧! | njæ˧ɻæ˩-se˩, <ə˧zɯ…> | õ˧-ɳɯ˥ | le˧-mɤ˧-tɑ˥-zo˩!"" |"
crdo-NRU_F4_MOUNTAINS_F4_MountainsS029.wav	ʝi˧ ɲi˧-pʰo˧˥, | ʈʂʰɯ˧ne˧-ʝi˥ | tʰi˧-tɕɤ˩-kv̩˩-mv̩˩!
crdo-NRU_F4_FOOD_SHORTAGE2_FOOD_SHORTAGE2S068.wav	""" “mv̩˩ tɕʰi˩-bi˩-pi˥-hɯ˩-dʑo˩, | di˩li˩-ʁo˩-bv̩˥ tʰv̩˩, | mv̩˩ tɕʰi˩-le˥-wo˩-tsʰɯ˩”-pi˩-kv̩˩!"" |"
crdo-NRU_F4_FUNERAL_F4_FUNERAL_S082.wav	tʰi˩˥, | mɤ˩mv̩˩-ʈʂʰɯ˥, | tɕʰɤ˧ɲi˧ni˧˥ | tʰi˧-ʈʂv̩˩. |
crdo-NRU_F5_AHABALA2_F5_Ahabala2S001.wav	mɤ˧-dʑo˧, | mɤ˧-tɕʰɯ˧˥, | mɤ˧-ʂv̩˧ɖv̩˧-lɑ˧! | ə˧mɑ˧ | tʰi˧-dʑo˩-lɑ˩, | ʂv̩˧ɖv̩˧-ze˧...jɤ! |
crdo-NRU_F4_FUNERAL_F4_FUNERAL_S197.wav	hĩ˧-ʈʂʰɯ˧, | ɑ˩ʁo˥ | mɤ˧-tsʰɯ˩-bi˩, | zo˩no˥, | ʈæ˧bɤ˧-ʈʂʰɯ˧ | le˧-ʁɑ˥ʂe˩-pi˩… | no˧, | zo˩no˥, | ɑ˩ʁo˧ dʑo˩, | njɤ˧ | hĩ˧ ʂɯ˧ mɤ˧-tsʰɯ˩-bi˩, | no˧-ɳɯ˧ | ɑ˩ʁo˧-ɳɯ˧ | ʈʂʰo˧-bi˧! |
crdo-NRU_F4_HOUSEBUILDING2_HOUSEBUILDING2_S187.wav	ʈʂʰwæ˩ ʝi˩-bi˩˥ | pi˧-dʑo˩ | tʰi˩˥, | tsʰe˩do˩-hõ˥-ɲi˩ qo˩ tʰv̩˩-kʰɯ˩. |
crdo-NRU_F4_SEEDS_SeedsS008.wav	əəə… ni˧ | tʰɑ˧-sɯ˧-kɤ˧ʈʂɯ˥ ◊ -mv̩˩! | nv̩˩ɭɯ˧ ki˧-ɲi˥-kv̩˩-tsɯ˩ ◊ -mv̩˩! | ʈʂʰɯ˧ | <so…> ŋwɤ˩-bæ˩-sɯ˥ | ki˧-ɲi˥-tsɯ˩ ◊ -mv̩˩! |
crdo-NRU_F4_HOUSEBUILDING2_HOUSEBUILDING2_S324.wav	æ˧ʂæ˧-dʑo˩, | ʈʂʰɯ˧ne˧-ʝi˥ | ʐwɤ˧~ʐwɤ˩ kv̩˩ mæ˩! |
crdo-NRU_F4_ELDERS3_Elders3S007.wav	"ə˧lɑ˧-ʁwɤ˧ dzi˩, -dʑo˩ | tʰi˩˥, | njæ˧sɯ˩kv̩˩, | ə˧ʝi˧-ʂɯ˥ʝi˩, | zo˩no˥, əəə… |
			<ɖɯ˩…> hɤ˩-hĩ˩˥, | sɯ˧pʰi˧-ɳɯ˧, ◊ ə˩-gi˩! | njæ˧sɯ˩kv̩˩ tʰv̩˩-qo˩ | ə˧lɑ˧-ʁwɤ˧ |
			so˧-ʑi˧, | kɤ˧˥tʰɑ˩ ɖɯ˧-ʑi˩-pi˩-tsɯ˩ ◊ -mv̩˩; | əəə… lɑ˧tʰɑ˧mi˥ | ɖɯ˧-ʑi˩; | ə˧lɑ˧ ɖɯ˧-ʑi˩;
			| njæ˧sɯ˩kv̩˩, | so˧-ʑi˧ ɲi˩-ze˩-mæ˩! |"
crdo-NRU_F4_CARAVANS_CaravansS057.wav	"li˩ tɕɯ˧˥ | le˧-po˧-tsʰɯ˧˥ ◊ -dʑo˩, | ə˧mi˧! | õ˧˥ | ə˧mi˧ | le˧-ʂɯ˧-ze˧! | ə˧mi˧
			mɤ˧-dʑo˩, | mɤ˧-gɤ˩-ze˩!"" | pi˧. | ʈʂʰɯ˧ne˧-ʝi˥ | gwɤ˩-ɲi˥-mæ˩! | ʐwæ˧ tɕɯ˩-zo˩-ɳɯ˩, |
			ə˧ʝi˧-ʂɯ˥ʝi˩. |"
crdo-NRU_F4_HOUSEBUILDING2_HOUSEBUILDING2_S048.wav	mv̩˩pʰæ˧-dʑo˩ | tʰi˩˥, | bo˩-hɑ˥ tɕɤ˩! | hɑ˧ gv̩˥! |
crdo-NRU_F4_FOOD_SHORTAGE_FoodShortageS019.wav	"""zo˧ tɕʰi˧-bi˧-pi˧, | hɯ˧-dʑo˧, | hwɤ˧tɕʰi˥-ʁo˩bv̩˩ F | le˧-tʰv̩˧-ze˧! | tʰi˩˥, | <le˧-w…> le˧-bi˩-ze˩!"" | pi˧, | le˧-wo˧-tsʰɯ˧˥ ◊ -dʑo˩ | tʰi˩˥, | hwɤ˧tɕi˥ | le˧-ɖʐɤ˧-le˥-po˩-tsʰɯ˩! | ɑ˩ʁo˧! |"
crdo-NRU_F4_FUNERAL_F4_FUNERAL_S142.wav	ɬv̩˧gv̩˧ ki˩-ɲi˩-pi˩, | ʈʂʰɯ˧-dʑo˧ | hɑ˧ ki˩-ɲi˩-pi˩, |
crdo-NRU_F4_DOG2_Dog2S102.wav	"""no˧ | ɖʐv̩˧nɑ˥mi˩-ʁæ˩ʈv̩˩-ni˩-zo˩! | <le˧-ʂɯ˧-mɤ˧-tʰɑ˧-hĩ˧ pi˧-zo˥! |>"
crdo-NRU_F4_COMING_OF_AGE2_F4_ComingOfAge2S008.wav	ze˩v̩˩-ze˥mi˩-ki˩-dʑo˩, | ə˧v̩˧-ɳɯ˥ | pʰv̩˧ɖɯ˧ ʝi˥-kv̩˩-mæ˩, | nɑ˩-ʈʂʰɯ˥-dʑo˩! |
crdo-NRU_F4_FUNERAL_F4_FUNERAL_S006.wav	əəə… ʈʂʰɯ˧ne˧-ʝi˥ | ɬo˧pv̩˥ ti˩. |
crdo-NRU_F4_CARAVANS_CaravansS025.wav	õ! tʰv̩˧-pʰæ˧-qo˩ lɑ˩-hĩ˩-tʰv̩˩! |
crdo-NRU_F4_HEALING_HealingS034.wav	əəə… sɯ˩tʰi˩˥ | le˧-ʑi˩, | mv̩˧-qo˩ | tʰi˧-qæ˧˥, |
crdo-NRU_AGRICULTURAL_ACTIVITIES_Agriculture_S108.wav	õ˧ʈʂʰɯ˧ne˧-ʝi˥ | ɖɯ˧-kʰwɤ˧ dʑo˧-ɲi˥! | õ˧ʈʂʰɯ˧-bæ˧ | dʑo˧-ɲi˥ mæ˩! |
crdo-NRU_F4_MUSHROOMS_MUSHROOMS_S058.wav	ʂe˧ | tʰi˧-kʰɯ˧˥ ◊ -dʑo˩, | mo˧-ʈʂʰɯ˧ | dʑɯ˧ tsɤ˧-zo˩! |
crdo-NRU_F4_DOG2_Dog2S040.wav	ʝi˧kʰv̩˥ | le˧-pi˥-dʑo˩, | wɤ˩˥, | kʰv̩˧ʂe˧ | ʈʂʰæ˧ɣɯ˧ ɲi˥! | əəə… <fv̩˧ʂɯ˩ go˩> [ɻ̃˧ go˧ - nɑ˥ go˩]-mɤ˩-kv̩˩-tsɯ˩-pi˩! | dzɯ˧-kv̩˩! |
crdo-NRU_Mariage_De_La_Soeur_V3_Sister3_S070.wav	tʰi˧-ʂɯ˧-ze˧-tsɯ˥ ◊ -mv̩˩! | tɕʰi˧sɯ˥-ze˩. |
crdo-NRU_F4_HEALING_HealingS027.wav	tʰi˩˥, | dɑ˧pɤ˧ | ʁɑ˧ʂe˩-hɯ˩-tsɯ˩ ◊ -mv̩˩!
crdo-NRU_F4_TIGER2_Tiger2S115.wav	"""tɕi˧wɤ˧-ɳɯ˩, | ʈʂʰɯ˧ne˧ gv̩˧-ɲi˥-ʝi˩!"" |"
crdo-NRU_F4_COMING_OF_AGE2_F4_ComingOfAge2S019.wav	tʰi˩˥, | tʰv̩˧-so˩-dʑo˩, | əəə… zo˩no˥… | mmm… ʈʰæ˩ ki˩˥ ◊ -dʑo˩, | zo˩no˥, | əəə… ɖæ˩-lɑ˧so˧ | le˧-qæ˧˥; | əəə… mv̩˩si˧-njɤ˧˥! |
crdo-NRU_F4_FUNERAL_F4_FUNERAL_S045.wav	tʰi˧-tɕɯ˥ F-dʑo˩ | tʰi˩˥, | mmm… v̩˧ | ɖɯ˧-ɭɯ˧ | tʰi˧-qo˩. | mmm… kʰɤ˧˥ | ɖɯ˧-ɭɯ˧ | tʰi˧-qo˩. |
crdo-NRU_Naissance_du_Lac_V3_Lake3_S054.wav	ʈʂʰɯ˧-qo˧ | tʰi˧-dzi˩-kwɤ˩tɕɯ˩, | tɕʰo˩˥ | ɖɯ˧-nɑ˧ | tʰi˧-po˧, tsɯ˥ mv̩˩. |
crdo-NRU_F4_HOUSEBUILDING2_HOUSEBUILDING2_S159.wav	mi˧tʰv̩˧!
crdo-NRU_Mariage_De_La_Soeur_V3_Sister3_S016.wav	go˧mi˧ | hĩ˧-ki˧-ki˩-hĩ˩ tʰv̩˩, | kʰv̩˩mi˩-ɳɯ˥ | ɳv̩˧-pʰæ˧-di˥-tsɯ˩ ◊ -mv̩˩. |
crdo-NRU_F4_MUSHROOMS_MUSHROOMS_S034.wav	hæ̃˩-ni˩-gv̩˩-ɲi˥-ze˩-mæ˩! | ʈʂʰɯ˧ | ɣɯ˩kɯ˧-ʈʂʰɯ˥ | bo˧-zo˩! |
crdo-NRU_F4_MOUNTAINS_F4_MountainsS099.wav	kɤ˧mv̩˧-lɑ˥ | æ˧ʂæ˧-ʈʂʰɯ˧-dʑo˩ | tʰi˩˥, | pʰæ˧~pʰæ˧=ɻ̍˩ ɲi˩-kv̩˩-tsɯ˩ ◊ -mv̩˩!
crdo-NRU_F5_AHABALA2_F5_Ahabala2S003.wav	tʰi˧-dʑo˧, | tʰi˧-wɤ˧, | wɤ˧-mɤ˧-kv̩˩-lɑ˩ | tʰi˧-ʂe˧ | tʰi˧-kʰɤ˧ɕjɤ˧-ɻ˧ ɲi˥... jɤ! |
crdo-NRU_F4_FUNERAL_F4_FUNERAL_S005.wav	"""ʁɑ˩mi˧! | njɤ˧ | ə˧mi˧ tʰi˧-mɤ˧-dʑo˩-ze˩!"" | əəə… pi˧. |"
crdo-NRU_F4_FUNERAL_F4_FUNERAL_S201.wav	ɖɯ˧-sɑ˥ F ◊ -bi˩, | tʰɑ˧-lɑ˧˥! | zo˩no˥, | ʂo˧qo˧-tʰɑ˩, | ə˧ʝi˧-ʂɯ˥ʝi˩-dʑo˩, | əəə… dze˧! |
crdo-NRU_F4_FOOD_SHORTAGE2_FOOD_SHORTAGE2S082.wav	"əəə… ""hṽ˩-ɖʐæ˩ɻæ˥ | gv̩˧-ze˧-gɤ˧, | dzɯ˧ tʰɑ˧-kv̩˩! | hĩ˧ mɤ˧-dv̩˥-ze˩, | dzɯ˧-tʰɑ˧-kv̩˩!"" |"
crdo-NRU_AGRICULTURAL_ACTIVITIES_Agriculture_S073.wav	hĩ˧, | əəə… tɕʰi˩tsɯ˧-qɑ˥, | wɤ˩˥, | tsʰi˧-qʰæ˧˥, | ʈʂʰɯ˧-gɤ˧ | tʰi˧-tv̩˧-dʑo˧-ze˥, | pi˧-zo˩, | ʁo˧dɑ˧-se˥, | tɕʰi˩tsɯ˧-dʑo˧, | ɬi˧di˩-di˩mi˩-qo˩ | ʐwɤ˩˥ F | mɤ˧-kv̩˧˥, | mɤ˧-sɯ˥! | ʐwɤ˩ mɤ˩-kv̩˥, | mɤ˧-sɯ˥! |
crdo-NRU_F4_DOG2_Dog2S006.wav	tʰi˩˥, | kʰv̩˩mi˩-ʈʂʰɯ˥ | ʂæ˧-dʑo˧ | tʰi˩˥, | <kʰv̩˩mi˩-zɯ˩~zɯ˥ | tʰv̩˧-v̩˧-ki˧-dʑo˩, |> hĩ˧-zɯ˧~zɯ˥ | ʂe˧-hĩ˧ | tʰv̩˧-v̩˧-ɳɯ˩-dʑo˩, | kʰv̩˩mi˩-ki˥: |
crdo-NRU_F4_CARAVANS_CaravansS036.wav	mmm… -dʑo˩ | tʰi˩˥, | ɖɯ˧-v̩˧ ɖɯ˧-pi˧˥ | le˧-po˧-tsʰɯ˧˥, | ho˧di˧ | ɖɯ˧-ʈʂwæ˥ tɕɯ˩ | le˧-po˧-tsʰɯ˧˥, | əəə… ho˧di˧-dʑo˥, | wɤ˩˥, | ɕi˧ʈʂʰwæ˧ le˧-po˧-jo˥-kv̩˩-ze˩-wɤ˩! |
crdo-NRU_AGRICULTURAL_ACTIVITIES_Agriculture_S096.wav	[lɑ˧nɑ˧˥] <lɑ˧ɬɑ˧˥>, | nɑ˩˥ | ɖɯ˧-sɑ˥ | v̩˩tsʰɤ˧˥ | dʑo˧-mɤ˧-kv̩˧˥! |
crdo-NRU_F4_CARAVANS_CaravansS127.wav	pæ˧ɻæ˩ʈʂʰo˩-ɳɯ˩ | le˧-se˥-jo˩-ɳɯ˩, | lo˧gv̩˩-lɑ˩ tʰv̩˩-ɲi˩! |
crdo-NRU_Mariage_De_La_Soeur_V3_Sister3_S104.wav	no˧-ki˧-dʑo˩, | mɤ˧-fv̩˧-di˩ | mɤ˧-dʑo˧. |
crdo-NRU_F4_HOUSEBUILDING2_HOUSEBUILDING2_S206.wav	tʰi˩˥ | wɤ˩˥ | əəə… v̩˩tsʰɤ˧-tsʰɑ˧nɑ˥, | di˩-kv̩˩˥! | ə˧ʝi˧-ʂɯ˥ʝi˩! |
crdo-NRU_F4_TIGER2_Tiger2S118.wav	"""no˧ | õ˧-bv̩˥-õ˩ | ə˧ʑi˧-lɑ˥ | ə˧pʰv̩˧-ki˧ | le˧-hõ˩!"" | pi˧-zo˩ | tʰi˩˥, | əəə… le˧-hɯ˩-ɲi˩-tsɯ˩ ◊ -mv̩˩!"
crdo-NRU_F4_MUSHROOMS_MUSHROOMS_S117.wav	ə˧tso˧, | zo˩no˥ | ʈʂʰɯ˧ne˧-ʝi˥, | le˧-ɖʐɤ˧˥, | tɕʰi˧-hĩ˧, | ʈʰææ̃˧, | tʰv̩˧=ɻæ˧-qo˥, | le˧-ɖʐɤ˧˥, | tɕʰi˧ ʝi˧-ɻ̍˥! ◊ ə˩-gi˩! | tʰi˩˥, | hĩ˧ F | mɤ˧-dv̩˩! |
crdo-NRU_F4_MUSHROOMS_MUSHROOMS_S012.wav	tʰi˩˥, | ʈʂʰɯ˧-dʑo˩, | əəə… zo˩no˥… | ə˧ʝi˧-ʂɯ˥ʝi˩, | mo˧-ʈʂʰɯ˧-dʑo˩, | ze˩-bæ˧ | dzɯ˧-tʰɑ˩, | ze˩-bæ˧ | dzɯ˧-mɤ˧-tʰɑ˩, | zo˩no˥… | zo˩no˥, | əəə… ə˩ljɤ˩hæ̃˩ʂɯ˥-mo˩-ʈʂʰɯ˩-dʑo˩, | hĩ˧ | mɤ˧-tʰɑ˧˥ | dv̩˩-mɤ˧-kv̩˧˥! | əəə… ʐɯ˩-mo˧-tʰv̩˥, | hĩ˧ | dv̩˩-mɤ˩-kv̩˥! | mmm… dzɯ˧-kv̩˩-mæ˩! |
crdo-NRU_F4_TIGER2_Tiger2S108.wav	"""njɤ˧ | ə˧mɑ˧ | le˧-ʈʰæ˧-po˧-hɯ˥-ze˩!"" | pi˧-zo˩, | ŋv̩˩-ɲi˥-tsɯ˩ ◊ -mv̩˩!"
crdo-NRU_Mariage_De_La_Soeur_V3_Sister3_S077.wav	ʁɑ˩mi˧ pi˧-dʑo˩, | ə˧mv̩˩-ɳɯ˩ | ↑hæ̃˧˥, |
crdo-NRU_F4_FUNERAL_F4_FUNERAL_S186.wav	ɖɯ˧-ʈæ˩tsʰo˩ ɲi˩-pi˩-kv̩˩-tsɯ˩ ◊ -mv̩˩! | ʈæ˩tsʰo˧ | ɖɯ˧-ɭɯ˧ ɲi˩-pi˩-kv̩˩-tsɯ˩ ◊ -mv̩˩!
crdo-NRU_F4_TIGER2_Tiger2S077.wav	tʰi˩˥, | ə˧mi˧, | lɑ˧-ɳɯ˧ | le˧-ʈʰæ˧-ɲi˥-tsɯ˩ ◊ -mv̩˩!
crdo-NRU_F4_FUNERAL_F4_FUNERAL_S148.wav	le˧-dʑo˩-hĩ˩-dʑo˩, | le˧-dʑo˩-ɲi˩-ze˩ pi˩! |
crdo-NRU_F4_CARAVANS_CaravansS107.wav	njæ˧sɯ˩kv̩˩ | so˩kv̩˩-ki˥-dʑo˩, | hæ̃˩bɑ˥lɑ˩ | ʂæ˧tsɯ˧! |
crdo-NRU_F4_HOUSEBUILDING2_HOUSEBUILDING2_S037.wav	tso˩qʰv̩˩ɻ̍˥ | pi˧-hĩ˧ | ʈʂʰɯ˧-dʑo˩ | tʰi˩˥, | kʰi˧bɤ˧ | gɤ˩-tɕo˧ ʁɑ˧-kwɤ˧tɕɯ˥-lɑ˩, | ʈʂʰɯ˧ne˧-ʝi˥ | tʰi˧-pʰæ˧~pʰæ˧-ɲi˥ mæ˩! |
crdo-NRU_F4_CARAVANS_CaravansS208.wav	"ʈʂʰɯ˧ | hĩ˧ | ɖɯ˧-ʑi˩, | ɑ˩ʁo˧ | tʰi˩˥ | lo˩jɤ˧ | tsʰe˩-pʰæ˩ dʑo˩-ze˥-se˩, |
			<tsʰi˧…> tsʰi˧ʝi˧ | ɖɯ˧-kʰv̩˧˥ | ə˧tso˧ mɤ˧-ɲi˩, | le˧-dzɯ˥ | le˧-lv̩˩-ɲi˩! |"
crdo-NRU_AGRICULTURAL_ACTIVITIES_Agriculture_S012.wav	tʰi˩˥, | gv̩˩ɬi˩mi˩˥, | tsʰe˧ɬi˧mi˧, əəə… | ɖɯ˧ɬi˧mi˧-qo˧ | tʰv̩˧-kwɤ˧tɕɯ˥-lɑ˩, | tʰi˩˥, | ʈʂe˧ tsɑ˩. mmm… | ʈʂe˧ tsɑ˩. |
crdo-NRU_F4_MOUNTAINS_F4_MountainsS018.wav	tʰi˩˥, | ɖɯ˧-pʰo˧~ɖɯ˥-pʰo˩-hĩ˩-dʑo˩, | tsʰe˩hõ˩-pʰo˥ ɲi˩-ze˩-mæ˩, ◊ ə˩-gi˩! |
crdo-NRU_F4_HOUSEBUILDING2_HOUSEBUILDING2_S314.wav	"tʰi˩˥ | wɤ˩˥ | ɖɯ˧-v̩˧~ɖɯ˧-v̩˧ ɳɯ˧: ""pʰe! | ɖwæ˩ mɤ˧-zo˧! | hĩ˧ ʈʂʰɯ˧-dʑo˩, | ɖɯ˧-zɯ˧ ɲi˩."" |"
crdo-NRU_AGRICULTURAL_ACTIVITIES_Agriculture_S003.wav	tsʰi˧ʝi˧ | lo˧ | le˧-ʝi˥ | le˧-se˩, -dʑo˩, | tʰi˩˥, | so˧ʝi˧-bv̩˧ | kʰv̩˧ʂɯ˥, ◊ ə˩-gi˩! |
crdo-NRU_F4_HEALING_HealingS052.wav	"ʈʂʰɯ˧ | tʰi˧-dzi˩-hĩ˩-bv̩˩, | <dʑɯ…> ʑi˧qʰwɤ˧ dʑɯ˩ʁo˩ tʰv̩˩-kʰwɤ˩-dʑo˩, |
			mɤ˧-dʑɤ˩-pi˩-ɲi˩-ze˩-mæ˩. |"
crdo-NRU_F4_CARAVANS_CaravansS245.wav	mmm… ɬɑ˧sɑ˧-bv̩˧, mv̩˩tɕo˧ tɕɯ˧˥! | əəə… dʑɤ˧do˩-bv̩˩, | gɤ˩tɕo˧ tɕɯ˧˥! |
crdo-NRU_F4_FUNERAL_F4_FUNERAL_S206.wav	mv̩˩kʰv̩˧˥, | ʈæ˧bɤ˧ ʈʂʰo˧-kv̩˧-ze˥-mæ˩, | ʈʂʰɯ˧ne˧-ʝi˥ | tʰi˧-dzi˩ | tʰi˩˥, | le˧-ʈʂʰo˥, | le˧-ʈʂʰo˥, | le˧-ʁæ˩-kwɤ˩tɕɯ˩-lɑ˩, |
crdo-NRU_F4_FUNERAL_F4_FUNERAL_S134.wav	əəə… ʁwɤ˧qo˧-hĩ˧, | ɖɯ˧-ʑi˩~ɖɯ˩-ʑi˩ F | le˧-hwɤ˩. | ʈʂʰɯ˧ne˧ ʝi˥-se˩-dʑo˩ | tʰi˩˥, | tʰv̩˧-hɑ̃˩-dʑo˩ | tʰi˩˥, | so˧ɲi˥ | qæ˧-ho˥ ɖɯ˩-hɑ̃˩-dʑo˩, | ʈʂʰɯ˧-ɲi˧ | ʐɯ˧ hwɤ˩! |
crdo-NRU_F4_CARAVANS_CaravansS154.wav	kɤ˧zo˧ mv̩˥ʈʂæ˩-hĩ˩ tʰv̩˩-v̩˩-dʑo˩, | hĩ˧ tsʰo˧pæ˧ ʝi˧! | əəə… tso˧~tso˧ hwæ˩! | əəə… ŋv̩˩ tʰi˩-po˩˥! |
crdo-NRU_F4_FUNERAL_F4_FUNERAL_S078.wav	"""hĩ˧ | le˧-ʂɯ˧-hĩ˧-ki˧-dʑo˩, | hɑ˧ | ɖɯ˧-qwæ˧-ɻ̍˧-kv̩˥!"" | hĩ˧-ɳɯ˩ | ʐwɤ˩-kv̩˩-pi˥! |"
crdo-NRU_F4_HOUSEBUILDING2_HOUSEBUILDING2_S104.wav	õ˧-ʈʂʰɯ˧ne˧ ʝi˥-dʑo˩, | ə˧ʝi˧-ʂɯ˥ʝi˩-dʑo˩, | si˧ ʈʂʰɯ˧-dʑo˩, | ɖwæ˩˥ | lo˧hɑ˧ ɲi˥! |
crdo-NRU_F4_FUNERAL_F4_FUNERAL_S245.wav	jɤ˧ hwæ˧-ze˧! | li˩ tʰi˧ kʰɯ˧˥! | jɤ˧ tʰi˧-kʰɯ˧˥! | ʂo˧ko˧-tʰɑ˩ tʰi˩-kʰɯ˩! ĩ˧! |
crdo-NRU_F4_MUSHROOMS_MUSHROOMS_S119.wav	tʰi˩˥, | zo˩no˥, | di˧qo˧-dʑo˩, | wɤ˩˥ | mo˧˥, | dʑo˧-kv̩˧˥ ◊ -mv̩˩. |
crdo-NRU_F4_CARAVANS_CaravansS205.wav	le˧-tɕɯ˧-le˥-po˩-jo˩, | ɬi˧di˩-di˩mi˩-qo˩, | ə˧mi˧=ɻæ˩, | dʑi˧ qæ˧, | dʑi˧hṽ̩˥-ʈʂʰɯ˩-dʑo˩ | tʰi˩˥, | hwæ˧-kv̩˧-ze˥-mæ˩! |
crdo-NRU_Mariage_De_La_Soeur_V3_Sister3_S024.wav	tʰi˩˥, | hĩ˧bæ˧ ʈʂʰɯ˧-tɕi˩ | ɖɯ˧-tɑ˧˥ | kɤ˧kɤ˩ | tʰi˧-dzi˩-kʰɯ˩-tsɯ˩ ◊ -mv̩˩. |
crdo-NRU_F4_FOOD_SHORTAGE_FoodShortageS001.wav	ə˧ʝi˧-ʂɯ˥ʝi˩, ◊ ə˩-gi˩! | njɤ˧ | ə˧ʑi˧-ɳɯ˥, | ʈʂʰɯ˧ne˧-ʝi˥ | ʐwɤ˩-kv̩˩˥ ◊ -mv̩˩. |
crdo-NRU_F4_MOUNTAINS_F4_MountainsS034.wav	"""ʈʂʰɯ˧ | ʝi˧qv̩˥=ɻ̍˩-ɳɯ˩ | tʰi˧-gɤ˧-hĩ˧-ʈʂʰɯ˧-dʑo˩, | tʰi˩˥, | hĩ˧-bi˥ | wɤ˩-hĩ˩-zo˩-ho˥-ze˩!"" | pi˧-zo˩ | tʰi˩˥, | mv̩˩tɕo˧ zɑ˩-tsʰɯ˩-zo˩! |"
crdo-NRU_F4_MOUNTAINS_F4_MountainsS046.wav	ʂe˩bv̩˩ ɲi˥-pi˩, | ə˧sɯ˩kv̩˩ | bv̩˧, | zo˩no˥, | tʰi˧-tso˩-dʑo˩-mæ˩, ◊ ə˩-gi˩! | ʈʂʰɯ˧-ʁo˥ tso˩-ɲi˩-tsɯ˩ ◊ -mv̩˩!
crdo-NRU_F4_FUNERAL_F4_FUNERAL_S248.wav	tʰi˩˥, | ə˧ʝi˧-ʂɯ˥ʝi˩-dʑo˩, | ʈʰææ̃˧… | əəə… ʈʂʰɯ˧ | pɤ˩jɤ˧˥ | ɖɯ˧-qo˩ho˩ po˩-tsʰɯ˩-pi˩, | pɤ˩jɤ˧˥ | ɲi˧-ɭɯ˧ | le˧-wo˧-kʰɯ˥-kv̩˩-mæ˩! | qo˩ho˧-qo˥! |
crdo-NRU_F4_TIGER2_Tiger2S015.wav	"""ə˩zɯ˩˥, | ə˧dɑ˧ ʂɯ˧-ho˥-ɲi˩!"" |"
crdo-NRU_F4_HEALING_HealingS070.wav	dɑ˧pɤ˧-ɳɯ˧, | ʈʂʰɯ˧ | ʈʂʰæ˧ɣɯ˧ ki˧! |
crdo-NRU_F4_HEALING_HealingS100.wav	zo˧mv̩˥zo˩=ɻæ˩-ki˩ | ʈʰæ˧ɻæ˩ so˩. |
crdo-NRU_F4_ELDERS3_Elders3S028.wav	ʈʂʰɯ˧ | qʰv̩˧-kv̩˧ dʑo˧-ɲi˥-ze˩-mæ˩! |
crdo-NRU_F4_CARAVANS_CaravansS043.wav	tʰi˩˥, | ʐæ˩ʂæ˥-hĩ˩-ɳɯ˩ | li˩˥ | le˧-tɕɯ˧-le˥-po˩-tsʰɯ˩-dʑo˩, ◊ ə˩-gi˩! |
crdo-NRU_F4_COMING_OF_AGE2_F4_ComingOfAge2S057.wav	tʰi˩˥, | ə˧v̩˧-ki˥ ti˩! | ə˧v̩˧-ɳɯ˥ | ŋv̩˧ | tʰi˧-ki˧! | ʈʂʰɯ˧ne˧-ʝi˥ | kɤ˧kɤ˩ | tʰi˧-dzi˩. |
crdo-NRU_F4_HOUSEBUILDING2_HOUSEBUILDING2_S123.wav	tʰi˩˥, | æ̃˩ ʈwɤ˧-kwɤ˧tɕɯ˥-lɑ˩, | le˧-pɤ˥~pɤ˩, | bi˧-kv̩˧-ze˥ mæ˩! |
crdo-NRU_F4_HOUSEBUILDING2_HOUSEBUILDING2_S252.wav	ʑi˧qʰwɤ˧ dɑ˧˥ | ɖɯ˧-ɲi˥-dʑo˩ | tʰi˩˥, | v̩˩tsʰɤ˧˥ | le˧-dʑo˧-ze˧! | ɳɯ˩dʑɯ˥ ɳæ˩-kv̩˩-ze˩! | õ˧=bv̩˥ õ˩ | ɳɯ˩dʑɯ˥ ʈʂʰɯ˩-dʑo˩! |
crdo-NRU_F4_FUNERAL_F4_FUNERAL_S147.wav	le˧-ʂɯ˧-hĩ˧-dʑo˩, | le˧-ʂɯ˧-ɲi˥-ze˩ pi˩! |
crdo-NRU_F4_FUNERAL_F4_FUNERAL_S100.wav	"<ʈæ˧bɤ˧ | ɖɯ˧-v̩˧-ɳɯ˧… ""no˧ | ɖɯ˧-ɲi˧ ʈʂʰo˥!"" | pi˧> [mv̩˩˥ | ɖɯ˧-v̩˧-ɳɯ˧, | ʈæ˧bɤ˧ | ɖɯ˧-ɲi˧-ʈʂʰo˥! | pi˧-ɲi˥. |]"
crdo-NRU_F4_HOUSEBUILDING2_HOUSEBUILDING2_S109.wav	h… hæ˧-di˩-dʑo˩, | ʂe˧ | mɤ˧-dzɯ˥ | tʰɑ˧˥! | ɬi˧di˩-di˩mi˩-qo˩, | ʂe˧ | mɤ˧-dzɯ˥ | mɤ˧-tʰɑ˧˥! |
crdo-NRU_AGRICULTURAL_ACTIVITIES_Agriculture_S072.wav	po˧po˧tsʰɤ˧˥ | dʑo˧-ɲi˥ bo˩! | ho˩lo˧pv̩˥ | dʑo˧-ɲi˥ bo˩! | ə˧tso˧-mɤ˧-ɲi˩ | dʑo˧-ɲi˥! |
crdo-NRU_F4_MUSHROOMS_MUSHROOMS_S120.wav	di˧qo˧-ʈʂʰɯ˧-dʑo˩, | kʰwɤ˧pʰv̩˧-mo˧ pi˥-zo˩! | kʰwɤ˧pʰv̩˧-pi˧-zo˥, | zɯ˧ tʰi˧-di˥-hĩ˩-qo˩! |
crdo-NRU_AGRICULTURAL_ACTIVITIES_Agriculture_S049.wav	hĩ˧-lɑ˩ | le˧-ɬi˥! əəə… | lv̩˧-lɑ˧ | le˧-ɬi˥! |
crdo-NRU_F4_TIGER2_Tiger2S097.wav	tʰi˧-ʑi˧ŋv̩˥-dʑo˩, | ə˧tso˧, | ɖɯ˧-v̩˧-ɳɯ˧ | gɤ˩-tɕʰɯ˧-ni˧˥ ◊ -zo˩, | tʰi˩˥, | ə˧mi˧-qv̩˧ʈʂæ˧ mv̩˥ | le˧-po˧-tsʰɯ˧-zo˥; | ə˧mi˧-ɳɯ˧: |
crdo-NRU_F4_RENAMING_RenamingS022.wav	"tʰi˩˥, | ɖɯ˧-sɑ˥ | mɤ˧-po˧˥ ◊ -dɑ˩, | pi˧-dʑo˩, | gi˩˥ ◊ -dʑo˩ | tʰi˩˥, | ""tsɤ˧-ʝi˧! | tsɤ˧-ʝi˧! | ɖɯ˧-sɑ˥ | mɤ˧-po˧˥, | njɤ˧ mɤ˧-ɖwæ˩!"" | pi˧-tsɯ˩ ◊ -mv̩˩. ""ɖɯ˧-sɑ˥ | mɤ˧-po˧˥, | njɤ˧ mɤ˧-ɖwæ˩!"" | pi˧-dʑo˩, |"
crdo-NRU_F4_COMING_OF_AGE2_F4_ComingOfAge2S042.wav	tʰi˩˥, | lo˩pv̩˧ tʰi˥-kʰɯ˩-kʰɯ˩! |
crdo-NRU_F4_HOUSEBUILDING2_HOUSEBUILDING2_S211.wav	ə˧mɑ˧-bv̩˧ | hæ̃˧pɤ˧ ʈʂʰɯ˧ne˧ ʝi˥ | tsʰɤ˩-ne˩˥, | <le˧-…> ɖɯ˧-tsʰɤ˩~ɖɯ˩-tsʰɤ˩ | le˧-tsʰɤ˩! |
crdo-NRU_F4_FOOD_SHORTAGE_FoodShortageS024.wav	le˧-ʐv̩˩, | pɤ˩jɤ˧ gv̩˥, | pɤ˩jɤ˧˥ | hĩ˧-v̩˧ | ɖɯ˧-ɭɯ˧~ɖɯ˧-ɭɯ˧ | tʰi˧-ki˧! |
crdo-NRU_F4_HOUSEBUILDING2_HOUSEBUILDING2_S124.wav	"""ə˧mi˧! | tsʰi˧-ɲi˧, | qæ˧do˧-dʑo˥, | tsʰi˧-ɲi˧ | ʈʂʰɯ˧-qo˧ tʰv̩˥-ho˩-ze˩! | tʰv̩˧-qo˧-dʑo˧, | dʑɯ˧ mɤ˧-dʑo˧!"" | pi˧. |"
crdo-NRU_F4_FUNERAL_F4_FUNERAL_S076.wav	"ɖɯ˩lo˧-hĩ˧-ʈʂʰɯ˧, | ""no˧… | no˧ | hɑ˧ qwæ˩-hĩ˩-lɑ˩, | ə˧tse˧ ʝi˧-ɲi˥?"" | ə˧mi˧=ɻæ˩-ɳɯ˩ | ɕjɤ˩tʰv̩˧-kv̩˥! |"
crdo-NRU_F4_CARAVANS_CaravansS120.wav	əəə… hõ˧-kv̩˥ tɕɯ˩, | pi˧-dʑo˩, | wɤ˩˥, | <ʐv…> ɲi˩-kv̩˩˥! |
crdo-NRU_F4_TIGER2_Tiger2S006.wav	"tʰi˩˥, | ""lɑ˧ do˩, | ə˧dɑ˧ ʂɯ˧!"" | pi˧-hĩ˧-ʈʂʰɯ˧-dʑo˩ | tʰi˩˥, | ə˧ʝi˧-ʂɯ˥ʝi˩, | zo˩no˥, | dʑɯ˩ʁo˩-ʈʂʰɯ˥, | zo˧ ɖɯ˧-v̩˧-ʈʂʰɯ˧, | dʑɯ˩nɑ˩mi˩ʁo˩ hɯ˩-ɲi˥-tsɯ˩ ◊ -mv̩˩!"
crdo-NRU_F4_CARAVANS_CaravansS179.wav	njɤ˧ | ə˧v̩˧˥ | tɕi˩-hĩ˩˥ | ɖɯ˧-pi˧˥ | hɤ˩˥! | ə˧ʝi˧-ʂɯ˥ʝi˩-dʑo˩, | ʐwæ˧ tɕɯ˩-zo˩, | kʰv̩˧mæ˧-ɳɯ˧ | tsʰɤ˧-lɑ˥-ɲi˩-mæ˩, ◊ ə˩-gi˩! |
crdo-NRU_F4_HOUSEBUILDING2_HOUSEBUILDING2_S117.wav	əəə… tʰi˩˥, | ɖʐo˧ | le˧-ɖʐo˥-kwɤ˩tɕɯ˩-lɑ˩ | tʰi˩˥, | hĩ˧-ʈʂʰɯ˧ | ʂe˧ | mɤ˧-dzɯ˥ | mɤ˧-tʰɑ˧-ɲi˥-kv̩˩ tsɯ˩ mv̩˩! |
crdo-NRU_F4_FUNERAL_F4_FUNERAL_S116.wav	ɑ˩pʰo˩ dʑo˩-hĩ˥… | ɑ˩ʁo˧ dʑo˩-hĩ˩ tʰv̩˩-v̩˩-dʑo˩ | tʰi˩˥, | tʰv̩˧-ɲi˧ | tʰv̩˧-so˩, | ʈæ˧bɤ˧ | qʰɑ˩jɤ˩ ʁɑ˩ ʂe˥, | ɑ˩ʁo˧ le˧-ʝi˥! |
crdo-NRU_F4_HOUSEBUILDING2_HOUSEBUILDING2_S190.wav	"""ə˧mi˧! | njɤ˧=ɻ˩ | ʑi˧qʰwɤ˧ <gv̩˩> tsʰi˧-tso˧-ɲi˥"" | pi˧! | ʐɯ˧ tɕɤ˧˥! | ə˧ʝi˧-ʂɯ˥ʝi˩! | mmm… ɳɯ˩-dʑɯ˥ ɳæ˩. | …zo˩no˧! |"
crdo-NRU_F4_FUNERAL_F4_FUNERAL_S105.wav	ɖɯ˧-ʑi˩-ɳɯ˩, | ɖɯ˧-v̩˧~ɖɯ˧-v̩˧ ɻwæ˧! |
crdo-NRU_F4_FUNERAL_F4_FUNERAL_S144.wav	ʐv̩˧tsʰi˩-lɑ˩ | gv̩˧-hɑ̃˩-ki˩, | əəə… <ʁɑ˧ʂ…> ʈæ˧bɤ˧ ʁɑ˧ʂe˩-se˩-kwɤ˩tɕɯ˩-lɑ˩ | tʰi˩˥, | hĩ˧-ʈʂʰɯ˧, | no˧ | le˧-ʂɯ˧-hĩ˧-dʑo˩, | no˧ | hɯ˧! |
crdo-NRU_AGRICULTURAL_ACTIVITIES_Agriculture_S066.wav	əəə… ʈʂʰɯ˧, | ə˧tso˧-mɤ˧-ɲi˩ | mv̩˩-ɲi˥ mæ˩, | dze˧ɭɯ˧ | mv̩˩-ɲi˥, | ɬi˩bi˩˥, | v̩˩tsʰɤ˧˥, | po˧po˧tsʰɤ˧˥, | ho˩lo˧pv̩˥, | əəə… tɕi˧kwɤ˧… | ə˧tso˧-mɤ˧-ɲi˩, | dʑo˧-ɲi˥! |
crdo-NRU_F4_MOUNTAINS_F4_MountainsS106.wav	ʈʂʰɯ˧ne˧-ʝi˥, | ʈʂʰɯ˧ne˧-ʝi˥, | ʈʂʰɯ˧ne˧-ʝi˥, | ɖɯ˧-kʰɯ˩ le˩-hɯ˩-dʑo˩, | gɤ˩dzɤ˧, | zo˩no˥, | qv̩˧ɻ̍˧-ʁo˧qʰwɤ˥ dzi˩-hĩ˩, | mv̩˩-lo˥ʝi˩ | ʂæ˧ ɲi˩-pi˩! |
crdo-NRU_F4_TIGER2_Tiger2S078.wav	lɑ˧-ɳɯ˧ | ɖɯ˧-ʈɤ˧-ɳɯ˧ | le˧-ʈɤ˧-po˧-hɯ˥-tsɯ˩ ◊ -mv̩˩!
crdo-NRU_F4_HOUSEBUILDING2_HOUSEBUILDING2_S084.wav	gɤ˩tɕo˧… | dʑɯ˩nɑ˩mi˩-ʁo˩˥ | ʂwæ˧hĩ˧-qo˩-ɳɯ˩ | mv̩˩tɕo˧… gɤ˧˥! |
crdo-NRU_F4_COMING_OF_AGE2_F4_ComingOfAge2S083.wav	tʰi˩˥, | tsʰe˧do˧ ɲi˧-ɲi˧ <kʰɤ˧ʂɯ˧-dʑo˩> [-ɳɯ˩], | hĩ˧ qʰo˧-kv̩˥-ze˩-mæ˩! |
crdo-NRU_Mariage_De_La_Soeur_V3_Sister3_S060.wav	ə˧mv̩˩-ki˩, | zo˩no˥, | ə˧-sɯ˩kv̩˩, | hæ˧-ʐwɤ˩ | le˧-po˧-tsʰɯ˧ pi˥: | ti˩tjɛ˧ lo˧-↑dzɑ˧ ʝi˧-ɲi˥-tsɯ˩-mæ˩, ◊ ə˩-gi˩! | [ə˧mv̩˩-ki˩ | ɖɯ˩-lo˧ | dzɑ˧ | ʐwæ˩˥! |]
crdo-NRU_F4_CARAVANS_CaravansS078.wav	"ə˧v̩˧˥ | tɕi˩-hĩ˩˥ | dʑo˩ | tʰi˩˥, | <əəə…> ə˧so˧, | zo˩no˥, | no˧ tʰv̩˧-qo˧
			tʰæ˧ɻæ˩-bi˩ | tʰi˧-tɕi˩-ni˩, | ʈæ˧ʂɯ˧-pæ˩pʰæ˩ | pi˧-hĩ˧ tʰv̩˧-v̩˧-dʑo˩, | əəə… lɑ˧do˧
			ʝi˧-kʰɯ˩! | ʐwæ˧ tɕɯ˩! | ʐwæ˧ lv̩˩! |"
crdo-NRU_F4_MOUNTAINS_F4_MountainsS164.wav	ʈʂʰɯ˧ne˧-ʝi˥ | le˧-ʈʂʰɻ̍˧˥, | ʈʂʰɯ˧-qo˧ | ɖɯ˧-ʈʂʰɻ̍˧ tʰi˥-tɕɯ˩;
crdo-NRU_F4_HOUSEBUILDING2_HOUSEBUILDING2_S164.wav	"əəə… ""ɖɯ˧-zɯ˧, | le˧-gɤ˩-ze˩!"" | pi˧ | wɤ˩˥ | ɑ˩ʁo˧! | tʰi˩˥, | hĩ˧ mo˥=ɻæ˩-ɳɯ˩. |"
crdo-NRU_AGRICULTURAL_ACTIVITIES_Agriculture_S021.wav	tʰi˩˥, | go˩bo˥ | pv̩˩-tʰɑ˩-kʰɯ˥, | le˧-li˧. |
crdo-NRU_F4_MOUNTAINS_F4_MountainsS098.wav	əəə… æ˧ʂæ˧-lɑ˧ | kɤ˧mv̩˧-ʈʂʰɯ˥-dʑo˩, | ɖɯ˧-v̩˧-dʑo˧, | mi˩zɯ˩˥! | ɖɯ˧-v̩˧-dʑo˧, | zo˧! | ĩ˧! |
crdo-NRU_F4_COMING_OF_AGE2_F4_ComingOfAge2S047.wav	zo˧mv̩˥ ki˩! | ɑ˩ʁo˧-hĩ˧=ɻæ˥, | ə˧dɑ˧-ə˧mi˧ | hɯ˩-hĩ˩˥, | ə˧ʑi˧-ə˧pʰv̩˧˥ | hɯ˩-hĩ˩˥, | ʈʂʰɯ˧-tɕi˩-ɳɯ˩, | ɖɯ˧-v̩˧~ɖɯ˧-v̩˧ F | tʰi˧-ki˧-kv̩˧˥ ◊ -mv̩˩! |
crdo-NRU_F4_CARAVANS_CaravansS102.wav	"əəə… ho˧di˧-bv̩˧ | tso˧~tso˧, | le˧-wo˧-tɕɯ˥ | le˧-po˧-tsʰɯ˧˥, | wɤ˩˥ | ɬi˧di˩ tɕʰi˩,
			| ə˧ʝi˧-ʂɯ˥ʝi˩! | <ʐv…> əəə… zo˩no˥, | ʐɤ˩ se˩-zo˩-ʈʂʰɯ˥-dʑo˩, | ʈʂʰɯ˧ne˧ ʝi˥, |
			tʰi˩˥, | ho˧di˧ | ɖɯ˧-ʂɯ˩ hɯ˩ | le˧-tsʰɯ˩, | ʂe˧ʈʂe˩ | le˧-po˧-tsʰɯ˧˥; |"
crdo-NRU_F4_MUSHROOMS_MUSHROOMS_S090.wav	tʰi˩˥, | gɤ˩-ʈʂʰæ˧˥ ◊ -dʑo˩, | hĩ˧ | mɤ˧-dʑo˩-zo˩! |
crdo-NRU_Mariage_De_La_Soeur_V3_Sister3_S026.wav	«hɑ˧mi˥-hĩ˩ | ɖɯ˧-v̩˧-pʰæ˧di˧-zo˩!» | tʰi˩˥, | <tɕ…>
crdo-NRU_F4_MOUNTAINS_F4_MountainsS087.wav	"hæ̃˧-ʈʂʰɯ˧, | ""bo˩…bo˥!"" | pi˧ | le˧-tʰv̩˧; | dzo˧ | ʈʂʰɯ˧-ɖɯ˧~ɖɯ˧-hĩ˧ lɑ˩-kv̩˩-tsɯ˩ ◊ -mv̩˩!"
crdo-NRU_F4_FOOD_SHORTAGE_FoodShortageS051.wav	tʰi˧-mɤ˧-ɲi˥, | zo˧ tɕʰi˧ F | zo˧-ɳɯ˩ | nv̩˩mi˩˥ | le˧-tɕʰɯ˧-ɲi˥-ze˩-mæ˩! |
crdo-NRU_F4_FUNERAL_F4_FUNERAL_S190.wav	ɲi˧tsi˧-kv̩˧-hĩ˧-tʰv̩˧… | ŋv̩˧ | ʈʂʰɯ˧=ɻæ˥ | dʑɤ˩pi˧ tʰi˥-ki˩-ɲi˩! | hĩ˧ F … | zo˩no˥… | ʈæ˧bɤ˧ | ɖɯ˩-hĩ˩ tʰv̩˩-v̩˩-ki˥, | ʝi˩tɕʰɤ˧-kʰwɤ˧! | mmm… v̩˧pɤ˩-kʰwɤ˩, | ŋwɤ˧ɕi˧-mæ˥, | ɖɯ˧ʈv̩˧-mæ˩, | so˩ɕi˩-mæ˥! |
crdo-NRU_F4_HOUSEBUILDING2_HOUSEBUILDING2_S359.wav	si˧dzi˩ tʰi˩-mɤ˩-di˩-hĩ˩ qo˩ mæ˩, | pi˧-dʑo˩, | hĩ˧-ʈʂʰɯ˧, | ɖɯ˧-↑sɑ˥ | le˧-ʂe˧, | ɖɯ˧-mɤ˧-kv̩˧˥! | ʈʰææ̃˧… | ʂo˩-qæ˩ɻæ˥ gv̩˩ | pi˧-kv̩˩ <| pi˧-kv̩˩>, | æ˧ʂæ˧-ʈʂʰɯ˥-dʑo˩! |
crdo-NRU_F4_SEEDS_SeedsS015.wav	tʰi˩˥, | ni˧ pʰo˩-ɲi˩-tsɯ˩ ◊ -mv̩˩!
crdo-NRU_F4_CARAVANS_CaravansS087.wav	"tʰi˩˥, | mmm… əəə… ʐwæ˧ tɕɯ˩-zo˩ | ɖɯ˧-ʂɯ˩ hɯ˩, | pʰi˧ | ɖɯ˧-tɑ˧˥ | le˧-ʑi˧-po˧-hɯ˥,
			| ho˧di˧ tɕʰi˧-hɯ˧-dʑo˥, | ŋv̩˧ | ɖɯ˧-mɤ˧-kv̩˧-tsɯ˥ | mv̩˩! |"
crdo-NRU_F5_AHABALA2_F5_Ahabala2S004.wav	ɖɯ˧-v̩˧-gi˧-ɳɯ˥, | ɖɯ˧-ʂv̩˧-ɻ˥-lɑ˩, | ə˧mɑ˧ | tʰi˧-jɤ˩-bi˩-ʝi˩-ze˩... jɤ! |
crdo-NRU_F4_MOUNTAINS_F4_MountainsS039.wav	ɲi˧-hɯ˧ | tʰi˩˥, | hĩ˧ dzɑ˧-hĩ˧ | ɖɯ˧-ʑi˩ dʑo˩-ɲi˩-ho˩-ze˩-mæ˩, ◊ ə˩-gi˩! |
crdo-NRU_F4_COMING_OF_AGE2_F4_ComingOfAge2S069.wav	tʰi˩˥, | le˧-wo˧-tsʰɯ˧˥ ◊ -kwɤ˩tɕɯ˩-lɑ˩, | ɑ˩ʁo˧ | gɤ˩qwɤ˧-ki˧ ti˥! |
crdo-NRU_F4_FUNERAL_F4_FUNERAL_S073.wav	əəə… tʰi˧-dʑo˩-hĩ˩, | ə˧sɯ˩kv̩˩, | dzɯ˧-hĩ˧-dʑo˩, | ɲi˧-ʂɯ˩ qwæ˩! |
crdo-NRU_F4_RENAMING_RenamingS016.wav	"njɤ˧ zo˧hṽ̩˧-ki˥ | mv̩˧ ɖɯ˧-kʰwɤ˥ | ki˧-ɻ̍˩! | ʁɑ˩mi˧!” | pi˧, | to˩pv̩˧ |
			le˧-tsʰɯ˩-hĩ˩ tʰv̩˩-v̩˩! |"
crdo-NRU_F4_FUNERAL_F4_FUNERAL_S136.wav	ʐɯ˧ | le˧-hwɤ˩, | dɑ˧pɤ˧ | tʰv̩˧-v̩˧-ki˥, | ʐɯ˧ ɖɯ˧-tɕɯ˧ tʰi˥-ki˩! |
crdo-NRU_F4_RENAMING_RenamingS027.wav	tʰi˩˥, | tʰv̩˧-v̩˧-ki˧ | hɑ˧ ɖɯ˧-kʰwɤ˧ gv̩˥, | tʰi˧-ki˧! |
crdo-NRU_F4_COMING_OF_AGE2_F4_ComingOfAge2S060.wav	"""əəə! ʈʰæ˧ ki˧-ze˥!"", | pi˧, | fv̩˧! | mv̩˩zo˩ tʰv̩˩-ɭɯ˩˥ | tʰi˩˥, | fv̩˧-kv̩˧-ze˥-mæ˩! |"
crdo-NRU_F4_HOUSEBUILDING2_HOUSEBUILDING2_S354.wav	kʰi˧mi˧ | gɤ˩tɕo˧ ʁɑ˧-dʑo˥ | tʰi˩˥, | kʰi˧mi˧ | ɖɯ˩-hĩ˥ | ɖɯ˧-pɤ˩. |
crdo-NRU_F4_MUSHROOMS_MUSHROOMS_S132.wav	njæ˧-sɯ˩kv̩˩, | ɖɯ˧-ʑi˩=ɻ̍˩, | ə˧ʝi˧-ʂɯ˥ʝi˩, | mɤ˧-ɳv̩˥, | mo˧-ɳɯ˥ | dv̩˩-ɲi˥-tsɯ˩-mv̩˩. |
crdo-NRU_F4_MUSHROOMS_MUSHROOMS_S157.wav	mo˩kv̩˧-bv̩˧ kʰɯ˩ʈɯ˩, | ə̃, | ʈʂʰɯ˧ | le˧-tɕɤ˧˥, | ʈʰɯ˩-kwɤ˩tɕɯ˥-lɑ˩ | tʰi˩˥, | <fɑ˩pje˧-zo˩> [æ˩-ʂe˩ tsʰɯ˩˥ | ʐwæ˩˥!] ɖɯ˧-tɑ˧˥ | ɑ˩pʰo˩ tʰv̩˩-kv̩˥, | pi˧-zo˩. |
crdo-NRU_F4_DOG2_Dog2S011.wav	"tʰi˩˥, | əəə… ""ʁɑ˩mi˧! | njæ˧sɯ˩kv̩˩, | hĩ˧-ʈʂʰɯ˧-dʑo˩, | kv̩˧ʝi˥ | le˧-ɖæ˥ | le˧-ʐwæ˩-ze˩!"" | kʰv̩˩mi˩-zɯ˩~zɯ˩ tʰv̩˩-v̩˩-ki˥! |"
crdo-NRU_F4_HEALING_HealingS023.wav	"""ə˧mi˧! | no˧=ɻ̍˩ | ə˧tse˧ ɲi˥? | no˧=ɻ̍˩-dʑo˩ | ʈʂʰɯ˧ne˧-ʝi˥ | le˧-qʰwɤ˧-ze˧! |"
crdo-NRU_F4_FUNERAL_F4_FUNERAL_S091.wav	"tʰi˩˥, | hĩ˧mo˩ tʰv̩˩-mo˩-ki˩-dʑo˩, | ""o! <no˧…> | ʈʂʰɯ˧=ɻ̍˩-ɳɯ˩, | mɤ˩mv̩˩ ʈʂv̩˥-tsʰɯ˩-ze˩! | no˧ li˧-tsʰɯ˩-ze˩!"" | pi˧. |"
crdo-NRU_F4_FOOD_SHORTAGE_FoodShortageS056.wav	le˧-tɕʰi˧ | dʑo˩ | tʰi˩˥, | ə˧mɑ˧ F | do˩-mɤ˩-ho˥! | mɤ˧-tɕʰi˧-ɳɯ˧ F | dzɯ˧-di˧ mɤ˧-dʑo˧˥! |
crdo-NRU_F4_CARAVANS_CaravansS177.wav	"qʰv̩˧-kv̩˧-hĩ˧-tʰv̩˧, | tʰi˩˥, | njɤ˧ | ə˧v̩˧˥ | ɖɯ˩-hĩ˩˥ | no˧˥ | le˧-tɕɯ˧˥,
			|"
crdo-NRU_F4_FUNERAL_F4_FUNERAL_S108.wav	ʝi˧kʰv̩˥-dʑo˩, | qo˩ho˧ tʰi˥-po˩! | qo˩ho˧˥ | ʝi˧-ɭɯ˧ po˧˥! | ɖʐe˧ po˧-bi˥-kv̩˩-mæ˩! |
crdo-NRU_F4_HOUSEBUILDING2_HOUSEBUILDING2_S192.wav	ɬi˩bi˩˥, | ə˩kʰɯ˩˥, | ʈʂʰɯ˧-dʑo˩, | ɖwæ˧˥ | dʑɤ˩-kv̩˧˥! |
crdo-NRU_F4_MUSHROOMS_MUSHROOMS_S021.wav	zo˩no˥, | mo˩ɻ̍˥-lɑ˩ | mo˩kv̩˥ | ʈʂʰɯ˧-dʑo˩, | ʈʂe˧-qo˩-ɳɯ˩ | gɤ˩-ʑi˥-hĩ˩ | mɤ˧-ɲi˩-mæ˩! | mmm… si˧dzi˩, | si˧-qo˩-ɳɯ˩ | tʰv̩˧-ɲi˥-mæ˩! | ĩ˧! |
crdo-NRU_Mariage_De_La_Soeur_V3_Sister3_S108.wav	tʰi˧-mɤ˧-ɲi˥, | so˩ɲi˩-lɑ˥ | so˩hɑ̃˩ qæ˥-ɲi˩-tsɯ˩ ◊ -mv̩˩!
crdo-NRU_F4_ELDERS3_Elders3S014.wav	"tʰi˩˥, | ʈʂʰɯ˧sɯ˩kv̩˩-dʑo˩ | tʰi˩˥, | əəə… ə˧si˧ ɲi˩-ze˩-wɤ˩! | ə˧pʰv̩˧
			mɤ˧-ɲi˩-ze˩-wɤ˩! |"
crdo-NRU_F4_COMING_OF_AGE2_F4_ComingOfAge2S006.wav	əəə… zo˩no˥, | ɑ˩ʁo˧-ɳɯ˧, | ə˧v̩˧-ɳɯ˥, | ə˧tso˧-mɤ˧-ɲi˩, | ʂv̩˧~ʂv̩˧-kv̩˧-ze˥-mæ˩! |
crdo-NRU_F4_FUNERAL_F4_FUNERAL_S209.wav	"əəə… ""tsʰɯ˧ɻ̍˧-ɬɑ˩mv̩˩-ɳɯ˩ | pɤ˩jɤ˧ qʰæ˥-tsʰɯ˩!"" pi˩. |"
crdo-NRU_F4_TIGER2_Tiger2S005.wav	"""ʐæ˩ do˥, | ə˧mi˧ ʂɯ˧! | lɑ˧ do˩, | ə˧dɑ˧ ʂɯ˧!"" | pi˧-kv̩˩-tsɯ˩ ◊ -mv̩˩. |"
crdo-NRU_F4_HOUSEBUILDING2_HOUSEBUILDING2_S303.wav	tʰi˩˥, | ɖæ˩-lɑ˧so˧ | le˧-qæ˧-se˥-dʑo˩ | tʰi˩˥, | əəə… tʰv̩˧ɲi˧-dʑo˩, | hĩ˧ qʰo˧˥! | hĩ qʰo˧˥, | hĩ˧=ɻæ˧ ɳɯ˥, | pʰɤ˧bɤ˧ | qʰɑ˩jɤ˩ po˥-jo˩-kv̩˩! |
crdo-NRU_F4_COMING_OF_AGE2_F4_ComingOfAge2S048.wav	tʰi˩˥, | ʈʂʰɯ˧ne˧-ʝi˥ | le˧-ki˧-se˩-dʑo˩ | tʰi˩˥, | zo˩no˥, | ə˧mi˧ tʰv̩˧-v̩˧-ɳɯ˩ | dʑi˧hṽ˥ | le˧-mv̩˧-kʰɯ˧-se˥-dʑo˩ | tʰi˩˥, | əəə… le˧… ɖɯ˧-tɑ˧˥ | le˧-mv̩˧-se˩-dʑo˩, | tʰi˩˥, | ɬo˧pv̩˥ ti˩-kv̩˩-ze˩-mæ˩! |
crdo-NRU_F4_FUNERAL_F4_FUNERAL_S221.wav	"tʰi˩˥, | ""ʈʂʰɯ˧-ɳɯ˧ | qʰæ˧-tsʰɯ˧˥ ◊ -ɲi˩!"" | pi˧. |"
crdo-NRU_Naissance_du_Lac_V3_Lake3_S047.wav	hĩ˧ | ɖɯ˧-tɑ˧˥ | tʰi˧-ɳæ˧˥ | tɕɯ˩, -kwɤ˩tɕɯ˩-lɑ˩, | tʰi˩˥, |
crdo-NRU_F4_HEALING_HealingS081.wav	"ɖɯ˧-ʑi˩=ɻ̍˩, | ʈʰææ̃˧, | ʈʰææ̃˧, | tʰi˩˥, | ɖɯ˧-v̩˧ | le˧-qʰwɤ˧, | ɖɯ˧-v̩˧ | le˧-go˩;
			| ɖɯ˧-v̩˧ | le˧-qʰwɤ˧, | ɖɯ˧-v̩˧ | le˧-go˩; | ə˧tso˧ go˩-ɲi˩, | mɤ˧-sɯ˥! |"
crdo-NRU_F4_MUSHROOMS_MUSHROOMS_S049.wav	tʰi˩˥, | <õ˧-ʈʂʰɯ˧-ʑ…> ʂɯ˧-ɬi˧mi˧-qo˧-gɤ˧-dʑo˥, | njæ˧sɯ˩-kv̩˩ | dʑɯ˩ʁo˩˥ | si˧ tɕɯ˩-bi˩-dʑo˩, ◊ ə˩-gi˩! | tʰv̩˧-ʁo˥ tɕɤ˩-dʑo˩, | ɑ˩ʁo˧ | ʂe˧ | ʝi˧-kʰwɤ˥ po˩-bi˩! |
crdo-NRU_F4_HOUSEBUILDING2_HOUSEBUILDING2_S057.wav	ɑ˩ʁo˧-ɳɯ˧ | gv̩˩˥! | tʰi˩˥, | ʈʂʰo˧do˩ | tʰi˧-di˩-hĩ˩-ʈʂʰɯ˩-dʑo˩ | tʰi˩˥, | ɑ˩ʁo˧ | hɑ˧ gv̩˥-ɲi˩, | pi˧-zo˩, | hɑ˧ | ɖɯ˧-tɕʰi˩ gv̩˩-ɳɯ˩, | ʈʂʰo˧do˩-ʁo˩ | ɖɯ˧-kʰwɤ˥ tʰi˩-tɕɯ˩. |
crdo-NRU_F4_COMING_OF_AGE2_F4_ComingOfAge2S004.wav	ʈʰæ˩ ki˩˥ ◊ -dʑo˩ | tʰi˩˥, | əəə… zo˩no˥… | ə˧dɑ˧ dʑo˧-hĩ˥, | ɲi˩-bi˧-bi˧, | zo˩no˥, | ɑ˩ʁo˧, | nɑ˩-ʈʂʰɯ˥-dʑo˩, | dʑo˩˥, | pi˧, | ə˧v̩˧-ɳɯ˥, | ɖwæ˧˥ | pʰv̩˧ɖɯ˧ ʝi˥-kv̩˩-ze˩-mæ˩! |
crdo-NRU_F4_HOUSEBUILDING2_HOUSEBUILDING2_S283.wav	tʰi˧-dzi˩ | tʰi˩˥, | hĩ˧ qʰo˧˥! | dʑɤ˩ tsʰo˥! | əəə… tʰi˩˥, | hĩ˧bæ˧ qʰo˧˥! |
crdo-NRU_F4_CARAVANS_CaravansS264.wav	"tʰi˩˥, | mv̩˩zɯ˩-ni˥mi˩=ɻæ˩ dʑo˩-hĩ˩-dʑo˩, | hĩ˧=ɻæ˥… | ""ʈʂʰɯ˧,
			mv̩˩zɯ˩-ʝi˥-hĩ˩ ʈʂʰɯ˩-v̩˩, | ʐwæ˧ tɕɯ˩-hɯ˩! | hɤ˩˥ | ʐwæ˩˥!"" | pi˧-zo˩. |"
crdo-NRU_F4_RENAMING_RenamingS012.wav	"tʰi˩˥, əəə… | ""dzo˧ | ɖɯ˧-pɤ˩ tso˩-hõ˩!"" | pi˧-dʑo˩ | tʰi˩˥, | ʈʂʰɯ˧, əəə… mmm…
			ə˧mi˧ | ʈʂʰɯ˧-jɤ˩-ɳɯ˩: |"
crdo-NRU_F4_HOUSEBUILDING2_HOUSEBUILDING2_S157.wav	ʁwɤ˧ | ʂwæ˧-hĩ˧-qo˩-dʑo˩, | ʈɤ˧! |
crdo-NRU_F4_MUSHROOMS_MUSHROOMS_S011.wav	əəə… æ̃˩ʂe˧li˥-mo˩-pi˩-hĩ˩ ɖɯ˩-ʁo˩ dʑo˩-kv̩˩-mv̩˩. |
crdo-NRU_F4_HOUSEBUILDING2_HOUSEBUILDING2_S038.wav	kʰi˧ | ʈʂʰɯ˧-pɤ˥ ɲi˩ | tʰi˩˥, | tso˩qʰv̩˩ɻ̍˥-dʑo˩, | ʈʂʰɯ˧-qo˧ di˩, | ʈʂʰɯ˧-qo˧ di˩! |
crdo-NRU_F4_HEALING_HealingS020.wav	tsʰe˩ŋwɤ˩-ɲi˥ | ɖɯ˧-ʂɯ˩ ʁɑ˩ʂe˩; | tsʰe˧do˧ ɖɯ˧-ɲi˥ | ɖɯ˧-ʂɯ˩ ʁɑ˩ʂe˩. |
crdo-NRU_F4_HOUSEBUILDING2_HOUSEBUILDING2_S244.wav	tʰææ̃˧, | pv̩˧-hĩ˧-lɑ˩ dzɯ˩! |
crdo-NRU_Naissance_du_Lac_V3_Lake3_S023.wav	ʈʂʰɯ˧-gi˧ | tʰi˧-tɕʰo˩, | ʐo˩ dzɯ˩-ho˥-kwɤ˩tɕɯ˩-lɑ˩ | tʰi˩˥, | li˧-hɯ˧ nɑ˧~nɑ˥, | mv̩˩sɯ˧njɤ˧-ɳɯ˥ | ʈʂʰɯ˧-qɑ˧ | tʰi˧-tɕʰo˩, |
crdo-NRU_F4_CARAVANS_CaravansS065.wav	"""ə˧mi˧! | ɳæ˧ɻ̍˩-se˩, | ɖʐv̩˧ le˧-ʝi˩-ʝi˩-ze˩! | dʑi˧ qæ˧ tʰɑ˩-ʝi˩-ze˩! | ʐwæ˧
			tɕɯ˩-hɯ˩-ɲi˩!"" | pi˧, | ə˧ʝi˧-ʂɯ˥ʝi˩! | ʈʂʰɯ˧ne˧-ʝi˥ | ʐwɤ˩-kv̩˩˥ ◊ -mæ˩! |"
crdo-NRU_F4_CARAVANS_CaravansS277.wav	"ɲi˧-kv̩˧˥ | tɕʰo˧~tɕʰo˥ bi˩, | ɖɯ˧-v̩˧-dʑo˧, | mv̩˩tsʰo˩ dɑ˥, | ɖɯ˧-v̩˧-dʑo˧, | si˧
			ʂe˩. | ɖɯ˧-v̩˧-dʑo˧, | dʑɯ˧ ʑi˧! | ɖɯ˧-v̩˧-dʑo˧, | hɑ˧ tɕɤ˩! |"
crdo-NRU_F4_CARAVANS_CaravansS085.wav	ho˧di˧-ni˧fv̩˥-pi˩, | ni˧fv̩˥-tʰv̩˩, | qʰɑ˧-ʂæ˧~ʂæ˧-hĩ˧ dʑo˧-kv̩˩-mæ˩! |
crdo-NRU_F4_FUNERAL_F4_FUNERAL_S098.wav	zo˩no˥, | no˧ | mv̩˩˥… | zo˧mv̩˥ | so˩-kv̩˩ dʑo˩˥, | ʐv̩˩-kv̩˩ dʑo˩˥ | pi˧, | mv̩˩ɖɯ˩˥ | <ɖɯ˧-v̩˧ ʝi˧> əəə… ɖɯ˧-ɲi˧… ʝi˧! | <mv̩˩-tɕi˥…> əəə… mv̩˩ɬi˥ | <ɖɯ˧-v̩˧>[ɖɯ˧-ɲi˧] ʝi˧! | mv̩˩tɕi˥, | <ɖɯ˧-v̩˧>[ɖɯ˧-ɲi˧] ʝi˧! |
crdo-NRU_F4_HOUSEBUILDING2_HOUSEBUILDING2_S200.wav	pʰv̩˧tɕæ˥ɻæ˩-ʈʂʰɯ˩, | v̩˩tsʰɤ˧˥ | ɖɯ˧-tɕʰi˩ ʝi˩-kv̩˩! |
crdo-NRU_F4_FUNERAL_F4_FUNERAL_S020.wav	mmm… pʰæ˧tɕi˥-ɳɯ˩ | gv̩˩-kv̩˩˥! |
crdo-NRU_F4_FUNERAL_F4_FUNERAL_S235.wav	ʈæ˧bɤ˧-ki˧, | ɖwæ˧˥ | tʰi˧-ki˧! |
crdo-NRU_Mariage_De_La_Soeur_V3_Sister3_S015.wav	kʰv̩˩mi˩-ɳɯ˥ | le˧-se˥-hɯ˩, | qo˩qɑ˩-ʁo˩ tʰv̩˩-hɯ˩˥, | dʑo˩ tʰi˩˥, | <əəə…>
crdo-NRU_F4_SEEDS_SeedsS039.wav	ʈʂʰɯ˧-qo˧-dʑo˧, | kʰɯ˧-mɤ˥-kv̩˩! |
crdo-NRU_F4_DOG2_Dog2S017.wav	"tʰi˩˥, | ʈʂʰɯ˧ne˧-ʝi˥ | tʰi˧-tɕɯ˧-hĩ˧-ʈʂʰɯ˥ ◊ -dʑo˩ | tʰi˩˥, | kʰv̩˩mi˩-ki˥: | ""ʁɑ˩mi˧! | ɖɯ˧-qæ˧~qæ˧-ɻ̍˥!"" | pi˧, | le˧-qæ˧~qæ˧ le˧-tsʰɯ˩ ◊ -dʑo˩ | tʰi˩˥, | zo˩no˥, əəə… | njæ˧sɯ˩kv̩˩, | hĩ˧ | zo˧mv̩˥ | le˧-dʑo˩, | ɖɯ˧-kʰv̩˥, | ɲi˧-kʰv̩˥, | so˩-kʰv̩˩˥, | tsʰe˩-kʰv̩˩˥, | tsʰe˩so˩-kʰv̩˩ gv̩˩˥ ◊ -dʑo˩ | tʰi˩˥, | wɤ˩˥ | ʈʰæ˧ | ɖɯ˧-ʂɯ˩ ki˩! | <pi˧-hĩ˧…> pi˧-dʑo˩ | tʰi˩˥, |"
crdo-NRU_F4_HOUSEBUILDING2_HOUSEBUILDING2_S003.wav	qæ˧do˧-sɯ˥ | le˧-dɑ˧˥; | ɑ˩ʁo˧ tɕɯ˧! | tʰi˩˥, | gv̩˩pʰæ˩˥ | le˧-dɑ˧-bi˥! | dʑɯ˩ʁo˩˥ | tʰi˧-tɕɯ˥! |
crdo-NRU_F4_FOOD_SHORTAGE2_FOOD_SHORTAGE2S055.wav	"ə˧dɑ˥-ɳɯ˩: | ""zo˧ | ɖɯ˧-v̩˧ tɕʰi˧-bi˧-tsæ˥-ɲi˩-ze˩! | <pæ˧˥hwɤ˧ mɤ˧-dʑo˧-ze˧, ə˩-gi˩! |> kʰv̩˧tɕʰi˧ mɤ˧-dʑo˧-ze˧! | zo˧ | ɖɯ˧-v̩˧ tɕʰi˧-tsæ˥-ɲi˩-ze˩!"" | pi˧-zo˩, | hɯ˧-ɲi˥-tsɯ˩ ◊ -mv̩˩, | wɤ˩˥! |"
crdo-NRU_AGRICULTURAL_ACTIVITIES_Agriculture_S042.wav	ɖɯ˧-kʰv̩˧˥ | ɖɯ˧-ʂɯ˩-hĩ˩ | ʈʂʰɯ˧, | ɖɯ˧-njɤ˧ | ʈʂʰɯ˧ne˧ ʝi˥-hĩ˩-lɑ˩ ɲi˩ wɤ˩! |
crdo-NRU_F4_HEALING_HealingS041.wav	"hɑ˧-ʈʂʰɯ˧ | dʑɤ˩˥ | mɤ˧-dʑo˧, | tʰi˩˥, | ho˧ ʈʰɯ˧-bi˧-pi˥-bi˩, | ɕi˧ʈʂʰwæ˧ mɤ˧-dʑo˧!
			|"
crdo-NRU_F4_TIGER2_Tiger2S091.wav	"tʰi˩˥, | qo˩qɑ˩˥ | ɖɯ˧-ɭɯ˧-qo˧ tʰv̩˧-dʑo˧, | tʰi˧-hĩ˧-zo˥! | ""ə˧mi˧! | njɤ˧-ə˧mɑ˧! | njɤ˧ | qʰɑ˩ne˩˥ | ɖɯ˧-zɯ˧ bv̩˩-ʝi˩?"" |"
crdo-NRU_F4_TIGER2_Tiger2S038.wav	"tʰi˩˥, | ""no˧zɯ˩… no˩zɯ˧-tɑ˧kɤ˥ | bi˧-tʰɑ˧-ʝi˥! | <ɖwæ… əəə…> se˧-ʁo˧-ʝi˥!"" | pi˧-tsɯ˩ ◊ -mv̩˩. |"
crdo-NRU_F4_FUNERAL_F4_FUNERAL_S218.wav	ɖɯ˧-v̩˧-ki˧-ɳɯ˩, | pɤ˩jɤ˧˥ | ʐv̩˩-ɭɯ˩ qʰæ˥-kv̩˩-mæ˩! | ɖɯ˧-ʁæ˧bæ˧! |
crdo-NRU_F4_CARAVANS_CaravansS001.wav	"ə˧ʝi˧-ʂɯ˥ʝi˩, ◊ ə˩-gi˩! | njɤ˧ | …zo˩no˥… | ə˧ʑi˧-bv̩˧ | zo˧ ɲi˥-ze˩-mæ˩, ◊ ə˩-gi˩!
			|"
crdo-NRU_Mariage_De_La_Soeur_V3_Sister3_S149.wav	ə˧si˧, | njɤ˧ | ə˧si˧, | <pɑ˩ʂɯ˧…> | pɑ˩ʂɯ˧tɕo˥-hĩ˩ | ɖɯ˧-v̩˧-ɳɯ˧ | <ʐwɤ˩-dʑɯ˩-kv̩˥ ◊ -mæ˩> [ʐwɤ˩-dʑɯ˩-mæ˥]! | ə˧ʝi˧-ʂɯ˥ʝi˩, | njɤ˧-ki˧! | æ˧ʂæ˧-dʑo˩, | ʈʂʰɯ˧ne˧ gv̩˧-kv̩˥! | ʈʂʰɯ˧ne˧ gv̩˧-kv̩˥! |
crdo-NRU_AGRICULTURAL_ACTIVITIES_Agriculture_S080.wav	ʈʂʰɯ˧ne˧-ʝi˥ | hĩ˧-ɳɯ˩ | le˧-<ʈʂɯ˩>[dɑ˩]-hĩ˩ ʈʂʰɯ˩-ʁo˩. |
crdo-NRU_F4_FOOD_SHORTAGE2_FOOD_SHORTAGE2S086.wav	tʰi˩˥, | gi˩˥ ◊ -dʑo˩, | õ˧ʈʂʰɯ˧-ɲi˧-ʑi˩, | hĩ˧-lɑ˩ | mɤ˧-tɕʰi˧! |
crdo-NRU_F4_RENAMING_RenamingS038.wav	"tʰi˩˥, | ɖɯ˧-kʰv̩˧-ɳɯ˥, | to˩pv̩˧ ɖɯ˧-kʰv̩˧˥ | lo˩dʑo˥ ki˩-kv̩˩-ze˩. | tʰv̩˧-gi˥
			ɖɯ˩-kʰv̩˩-dʑo˩, | lo˩dʑo˥ | ki˧-mɤ˧-kv̩˧-ze˥! |"
crdo-NRU_F4_MOUNTAINS_F4_MountainsS114.wav	ʈʂʰɯ˧-ɳɯ˧ | hɑ˧ tʰi˧-ki˧! | <dʑɯ˧ | tʰi˧-ki˧! | > ʈʂʰɯ˧ne˧-ʝi˥ | ʐɤ˧-kv̩˧-tsɯ˥ | mv̩˩! |
crdo-NRU_F4_MOUNTAINS_F4_MountainsS050.wav	mv̩˧ʈʰæ˧-ʈʂʰɯ˧, | ə˧tso˧-mɤ˧-ɲi˩ F | le˧-tv̩˧, | ʈʂʰɯ˧-ɳɯ˧, | ə˧tso˧-mɤ˧-ɲi˩, | gɤ˩tɕo˧ po˧-ʁo˧-ɲi˥-tsɯ˩ ◊ -mv̩˩!
crdo-NRU_F4_MOUNTAINS_F4_MountainsS121.wav	əəə… nɑ˩tsʰi˩˥, | tʰi˧-ʑi˥-kv̩˩-mæ˩!
crdo-NRU_F4_MUSHROOMS_MUSHROOMS_S079.wav	ʝi˧-kʰv̩˥-dʑo˩, | hĩ˧-qʰæ˧-po˩-ɳɯ˩ | tv̩˧-zo˥-kv̩˩ pi˩-zo˩, | qʰæ˧-po˩-ɳɯ˩ | tv̩˧-kv̩˥-tsɯ˩-mv̩˩! | mo˧-ʈʂʰɯ˥, | ʈʂʰæ˧ɣɯ˧-ʈʂʰɯ˧ mɤ˧-dʑo˧-zo˩! |
crdo-NRU_F4_DOG2_Dog2S115.wav	æ˧ʂæ˧, | ʈʂʰɯ˧…ni˧˥ | ʐwɤ˩-ɲi˥-tsɯ˩ ◊ -mv̩˩!
crdo-NRU_F4_HOUSEBUILDING2_HOUSEBUILDING2_S351.wav	bo˩bv̩˥ | ɖɯ˧-ɭɯ˧ di˩-kv̩˩-ze˩! | mmm… tʰi˩˥, | kʰi˧mi˧ ɖɯ˧-pɤ˩ di˩-kv̩˩-ze˩! | kʰi˧zo˧ ɖɯ˧-pɤ˩ di˩-kv̩˩-ze˩! |
crdo-NRU_F4_FOOD_SHORTAGE_FoodShortageS004.wav	"tʰi˩˥, | ə˧mi˧-ɳɯ˧: | ""ə˧mi˧! | ɖwæ˩-mɤ˧-zo˧! | ə˩-sɯ˧kv̩˥ | hɑ˧ ʐwɤ˩ | tʰi˩˥ | mv̩˩ tɕʰi˩-bi˩-zo˩-ho˥ F -di˩!"" | pi˧-kv̩˩-tsɯ˩ ◊ -mv̩˩. |"
crdo-NRU_F4_HOUSEBUILDING2_HOUSEBUILDING2_S043.wav	tʰi˩˥, | gæ˩pʰæ˧ ʑi˧ʁæ˧… -dʑo˩, | tso˧~tso˧ | ə˧tso˧-mɤ˧-ɲi˩, | tɕɯ˧-di˧˥! |
crdo-NRU_F4_MOUNTAINS_F4_MountainsS054.wav	"""hĩ˧ | ɖɯ˧-ʑi˩-hĩ˩-ʈʂʰɯ˩-dʑo˩, | so˩-ʈʂʰæ˩˥ | ʁæ˧-bi˧, | ɖɯ˧-ʈʂʰæ˧-qo˥, | ʁæ˧-mɤ˧-kv̩˧˥! | ĩ˧!"" |"
crdo-NRU_F4_FUNERAL_F4_FUNERAL_S220.wav	ʈʂʰɯ˧ne˧-ʝi˥ | le˧-qʰæ˧˥! |
crdo-NRU_F4_FOOD_SHORTAGE2_FOOD_SHORTAGE2S031.wav	"""æ˧ʂæ˧-tɑ˩mv̩˩ | dʑo˩-ɲi˥: 'mv̩˩ tɕʰi˩-bi˩-pi˥ | hɯ˧-dʑo˧, | di˩li˩-ʁo˩bv̩˥ tʰv̩˩-ze˩! | mv̩˩ tɕʰi˩ le˥-wo˩-tsʰɯ˩'-pi˩-kv̩˩!"" |"
crdo-NRU_F4_COMING_OF_AGE2_F4_ComingOfAge2S108.wav	hĩ˧ | ɖɯ˧-tɑ˧˥ F | dʑɤ˩tsʰo˧-jo˧-kv̩˧˥! |
crdo-NRU_F4_FUNERAL_F4_FUNERAL_S165.wav	tʰi˩˥, | <mv̩˧…> ə˧mi˧ | ɖɯ˧-v̩˧-lɑ˧ dʑo˧-ze˥! | <zo˧ | ɲi˧-kv̩˧˥…> zo˧ | ʐv̩˩-kv̩˩˥ F | le˧-ʂɯ˧-ze˧! |
crdo-NRU_F4_HOUSEBUILDING2_HOUSEBUILDING2_S034.wav	õ! ʑi˧qʰwɤ˧ | ɖɯ˧-ɭɯ˧-hĩ˧-ʈʂʰɯ˧-dʑo˩ | tʰi˩˥, | ə˧tso˧-mɤ˧-ɲi˩, | gv̩˩-tso˩-ɲi˥-ze˩! |
crdo-NRU_F4_MOUNTAINS_F4_MountainsS053.wav	"""hĩ˧-ʈʂʰɯ˧ | ɖɯ˧-zɯ˧ | dzɑ˧-mɤ˧-kv̩˩! | hĩ˧ | ɖɯ˧-v̩˧-hĩ˧-ʈʂʰɯ˥-dʑo˩, ◊ ə˩-gi˩!"" |"
crdo-NRU_F4_SEEDS_SeedsS021.wav	ʈʂʰɯ˧-qo˧ | ʈʂʰɯ˧ne˧-ʝi˥ | tʰi˧-ɲi˩ | le˧-po˧-tsʰɯ˧˥ ◊ -dʑo˩ | tʰi˩˥, | di˧qo˧ | mv̩˩zɯ˩˥ | tʰi˧-pʰo˧˥! |
crdo-NRU_F4_HOUSEBUILDING2_HOUSEBUILDING2_S132.wav	tʰi˩˥, | tɕæ˧ɻæ˩! | ə˧ʝi˧-ʂɯ˥ʝi˩-dʑo˩! |
crdo-NRU_Naissance_du_Lac_V3_Lake3_S073.wav	æ˧ʂæ˧ | ʈʂʰɯ˧ne˧-ʝi˥ | ʐwɤ˩-ɲi˥, -tsɯ˩ mv̩˩! |
crdo-NRU_F4_SEEDS_SeedsS063.wav	tʰi˩˥, | hĩ˧-ɳɯ˩, | le˧-li˧; | di˧qo˧-ɳɯ˧, | mɤ˧-ki˧ mɤ˧-tʰɑ˧˥ ◊ -ni˩-zo˩! |
crdo-NRU_F4_CARAVANS_CaravansS119.wav	ɖɯ˧-v̩˧-lɑ˧ bi˥, | pi˧-dʑo˩, | ʐv̩˩-kv̩˩ tɕɯ˥-kv̩˩-mæ˩! |
crdo-NRU_F4_HEALING_HealingS046.wav	wɤ˩˥ | njɤ˩ɭɯ˧ | ɖɯ˧-hɑ˩-ɻ̍˩. |
crdo-NRU_AGRICULTURAL_ACTIVITIES_Agriculture_S027.wav	tʰi˩˥, | ɖɯ˧-kʰv̩˧-hĩ˧-bv̩˧ | le˧-se˩-ɲi˩-ze˩ mæ˩! |
crdo-NRU_F4_MUSHROOMS_MUSHROOMS_S035.wav	tʰi˩˥, | ə˩ljɤ˩hæ̃˩ʂɯ˥-mo˩ pi˩, | ɖɯ˧-ʁo˩ dʑo˩kv̩˩! |
crdo-NRU_F4_CARAVANS_CaravansS039.wav	"ĩ˧! | sɯ˧pʰi˧-ki˧ ki˩! | tʰi˩˥, | sɯ˧pʰi˧-ɳɯ˧ | pv̩˩-kʰɯ˥-ɲi˩-mæ˩! | sɯ˧pʰi˧-ɳɯ˧ | ʐwæ˧
			tɕɯ˩-pv̩˩-kʰɯ˩! |"
crdo-NRU_F4_SEEDS_SeedsS010.wav	tʰi˩˥, | ni˧-ʈʂʰɯ˧-dʑo˩ | qʰɑ˩ne˩˥ | ki˧-dʑo˥ | tʰi˩˥, | ɖɯ˧-v̩˧-hĩ˧-ʈʂʰɯ˧-ɳɯ˩ | tʰi˩˥, | əəə… le˧-li˧~le˧-li˧-hɯ˧-dʑo˥ | ʈʂʰɯ˧, əəə… | mv̩˧ʁo˧-ɻ̍˥-dʑo˩, | ni˧ hæ̃˩! | ni˧ hæ̃˩-dʑo˩-tsɯ˩ ◊ -mv̩˩! |
crdo-NRU_F4_MOUNTAINS_F4_MountainsS015.wav	ʝi˧lv̩˧ hɯ˧˥ ◊ -dʑo˩ | tʰi˩˥, | dʑi˧mi˧-ʈʂʰɯ˧, | gv̩˧-wo˥ pi˩-kv̩˩-mæ˩, | njæ˧=ɻ̍˩-dʑo˩! | tʰi˩˥, | <ə˧zɯ˩-ɖɯ…>
crdo-NRU_F4_CARAVANS_CaravansS004.wav	"sɯ˧pʰi˧-bv̩˧ | ʐwæ˧ | ɖɯ˧-so˩ kv̩˩ tɕɯ˩, | ə˧ʝi˧-ʂɯ˥ʝi˩… | əəə… ɬɑ˧sɑ˧, | ʐwæ˧ tɕɯ˩.
			| əəə… ʐwæ˧ le˧-po˧˥, | ʐwæ˧ tɕɯ˩-bi˩. |"
crdo-NRU_F4_FOOD_SHORTAGE_FoodShortageS079.wav	əəə… sɑ˧ | tsʰi˩-hĩ˩˥, | tsʰi˩-hĩ˩˥! | ŋwɤ˧tsʰi˩-kʰɯ˩-ʈʰæ˩qʰwɤ˩-pi˩! | so˧tsʰi˧-kʰɯ˩-ʈʰæ˩qʰwɤ˩-pi˩! |
crdo-NRU_F4_HOUSEBUILDING2_HOUSEBUILDING2_S022.wav	ʂwæ˩gv̩˩˥, | gɤ˩qwɤ˥, | ʈʂʰɯ˧-dʑo˩, | ɖɯ˧-tɕʰo˩! | si˧tʰv̩˧ | ʈʂʰɯ˧-dʑo˩, | <mv̩˩tɕo˧> gɤ˩-tɕo˧-ɻ̍˩! | ɖɯ˧-tɕʰo˩… | əəə, si˧tʰv̩˧, | qwæ˧˥, | ɖɯ˧-tɕʰo˩ ɲi˩-ze˩ mæ˩! |
crdo-NRU_Mariage_De_La_Soeur_V3_Sister3_S013.wav	kʰv̩˩mi˩-ɳɯ˥ | tʰi˩˥, | tʰv̩˧ɲi˧-dʑo˩, | go˧mi˧ hĩ˧-ki˧-ki˩, | pi˧, | ɖɯ˧-di˩-qo˩ tʰv̩˩-dʑo˩ | tʰi˩˥, | kʰv̩˩mi˩-dʑo˥ | tʰi˩˥, |
crdo-NRU_F4_FUNERAL_F4_FUNERAL_S153.wav	gɯ˧-mɤ˧-gɯ˩, | mɤ˧-sɯ˥-ze˩-mæ˩! ◊ ə˩-gi˩! |
crdo-NRU_F4_DOG2_Dog2S051.wav	əəə… tʰi˩˥, | bo˩ qʰo˧-se˥-kwɤ˩tɕɯ˩-lɑ˩ | tʰi˩˥, | <hɑ˧ | le˧-dzɯ…> njæ˧sɯ˩kv̩˩ | le˧-dzɯ˧-se˥, | tʰi˩˥, | əəə… ʂæ˩ɻ̃˩-lɑ˥ | hɑ˧-lɑ˩ | wɤ˩˥ | hi˧lɤ˩ | <ɖɯ˧-po˩~po˩> [ɖɯ˧-tɕʰo˩qʰwɤ˩] tʰi˧-ki˩. |
crdo-NRU_F4_HOUSEBUILDING2_HOUSEBUILDING2_S128.wav	ə˧ʝi˧-ʂɯ˥ʝi˩-dʑo˩ | tʰi˩˥, | mmm… tɕɤ˧fv̩˩ F | mɤ˧-dʑo˧, ◊ ə˩-gi˩! | sɯ˧ljɤ˧tʰo˧ tʰv̩˧-ʁo˥ F | mɤ˧-dʑo˧-zo˩! |
crdo-NRU_F4_FUNERAL_F4_FUNERAL_S234.wav	ə˧tso˧-mɤ˧-ɲi˩, | ɑ˩ʁo˧… se˩-kv̩˥-tsɯ˩ ◊ -mv̩˩!
crdo-NRU_F4_HOUSEBUILDING2_HOUSEBUILDING2_S273.wav	ʈʂʰɯ˧-ɖɯ˧~ɖɯ˧ ʈʂʰɯ˧-ɖɯ˧~ɖɯ˧-zo˥! |
crdo-NRU_F4_FOOD_SHORTAGE_FoodShortageS027.wav	ɖɯ˧-ɭɯ˧-qo˧ tʰv̩˧-dʑo˥ | tʰi˩˥, | hwɤ˧tɕi˥ F | le˧-ɖʐɤ˧˥, | di˩li˩-ʁo˩bv̩˥ F | le˧-ɖʐɤ˧˥, | le˧-dzɯ˥! |
crdo-NRU_F4_FUNERAL_F4_FUNERAL_S169.wav	mi˩pi˧ ʝi˧-hɯ˧-zo˥… | əəə, zo˩no˥, | əəə… tʰo˩fv̩˩-qɑ˩ lɑ˥~lɑ˩-zo˩! | le˧-ʂɯ˧! |
crdo-NRU_Mariage_De_La_Soeur_V3_Sister3_S129.wav	hĩ˧ | ʁwɤ˧-qo˧ | qʰɑ˩jɤ˩ dʑo˩˥, | ɖʐv̩˧ | le˧-ʂv̩˧ | le˧-bi˩-kwɤ˩tɕɯ˩-lɑ˩, |
crdo-NRU_F4_MUSHROOMS_MUSHROOMS_S073.wav	əəə… zo˩no˥, | əəə… mmm… ʈʂʰɯ˧-ʁo˥ dʑɯ˩, | õ˧-tʰv̩˧! | əəə… ʂɯ˧-ɬi˧mi˧ mo˧ɖʐv̩˥ | ɖɯ˧-kʰwɤ˥ tʰi˩-kʰɯ˩! | ʐɯ˩-mo˧˥ | ɖɯ˧-kʰwɤ˥ tʰi˩-kʰɯ˩! | ɖɯ˧-tɑ˧˥ F | <le˧…> tʰi˧-kʰɯ˧˥! | zo˩no˥! |
crdo-NRU_F4_HOUSEBUILDING2_HOUSEBUILDING2_S331.wav	dʑɤ˩˥ | le˧-tsʰo˧, | dʑɤ˩˥ | le˧-tsʰo˧, | ʈʂʰɯ˧=ɻ˩ ɳɯ˩ | tʰi˩˥ | ʐɯ˧dzi˧-dʑo˥ | tʰi˩˥, | ʐɯ˧dzi˧-hĩ˧=bv̩˧ | ʈʂʰɯ˧-dʑo˩, | æ˧ʂæ˧-tɑ˩mv̩˩ ʈʂʰɯ˩-dʑo˩, | zo˩no˥, | əəə… dʑɤ˩tsʰo˧-hĩ˧ | ʈʂʰɯ˧-dʑo˩ | tʰi˩˥, | mmm… hĩ˧ ɳɯ˩ | ʐwɤ˩-dʑo˥ | tʰi˩˥, | hĩ˧-ɲi˩tʰo˩ ɖɯ˩-kv̩˩, | pi˧-zo˩! |
crdo-NRU_F4_FUNERAL_F4_FUNERAL_S257.wav	ə˧tso˧-mɤ˧-ɲi˩, | nɑ˩-ʈʂʰɯ˥, | tʰi˧-se˩-kʰɯ˩! |
crdo-NRU_F4_HOUSEBUILDING2_HOUSEBUILDING2_S259.wav	<ɖɯ˧-k… k…> kɤ˧mi˧ ʂwæ˧~ʂwæ˧-hĩ˧-qo˧, | ɖɯ˧-kɤ˩~ɖɯ˩-kɤ˩ | tʰi˧-tɕɯ˥! |
crdo-NRU_F4_FUNERAL_F4_FUNERAL_S135.wav	ʈæ˧bɤ˧ | le˧-ʈʂʰo˥, | le˧-ɬi˥-lɑ˩, | njæ˧sɯ˩kv̩˩ | wɤ˩˥ | hĩ˧ | <ʈæ˧… əəə…> dɑ˧pɤ˧-ɳɯ˧… | ʐɯ˧ hwɤ˩-kv̩˩-ze˩-mæ˩! |
crdo-NRU_F4_FOOD_SHORTAGE_FoodShortageS015.wav	le˧-se˥, | le˧-se˥, | le˧-se˥, | le˧-se˥, | le˧-se˥… | ʁwɤ˧ | ɖɯ˧-ɭɯ˧-qo˧ tʰv̩˧-dʑo˧ | tʰi˩˥, | hwɤ˧tɕi˥-ʈʂʰɯ˩ | qʰɑ˩jɤ˩ tʰi˩-di˥-tsɯ˩ ◊ -mv̩˩!
crdo-NRU_F4_COMING_OF_AGE2_F4_ComingOfAge2S097.wav	li˩˥, | ʝi˧-jɤ˧˥! | mmm… dze˧, | ə˧ʝi˧-ʂɯ˥ʝi˩-dʑo˩, | zo˩no˥… | ʈʂʰɯ˧ne˧-ʝi˥, | njæ˧-sɯ˩kv̩˩, | dze˧ | õ˧-bv̩˥-õ˩ | gv̩˩-hĩ˩˥, | qʰɑ˧dze˧-hɑ˧ hṽ˧, ə˩-gi˩! |
crdo-NRU_F4_HOUSEBUILDING2_HOUSEBUILDING2_S362.wav	ʈʂʰɯ˧ne˧-ʝi˥ | ʐwɤ˩-kv̩˩˥! | gɯ˩˥ | mɤ˧-gɯ˩, | mɤ˧-sɯ˥, ◊ ə˩-gi˩! |
crdo-NRU_F4_CARAVANS_CaravansS227.wav	"njɤ˧ | hĩ˧ | dʑɤ˩pi˧ dʑo˧˥ | pi˧-dʑo˩, | no˧ ki˧-ki˩! | õ! tʰi˩˥, | no˧ | hĩ˧
			ʈʂʰɯ˧-v̩˧, | no˧-ɳɯ˧-dʑo˥, | sɯ˧pʰi˧ ʝi˧-pv̩˥-kʰɯ˩! |"
crdo-NRU_F4_FUNERAL_F4_FUNERAL_S018.wav	ʁɑ˩ʂɯ˧ | njæ˧sɯ˩kv̩˩ | mi˩zɯ˩=ɻæ˥, | zo˩no˥, | zo˧-ɳɯ˩ | ʈʂʰæ˧~ʈʂʰæ˧-kv̩˩. |
crdo-NRU_F4_SEEDS_SeedsS062.wav	ʈʂʰɯ˧ | ʈʂʰwæ˧-kv̩˥-pʰæ˩-di˩ ◊ -mæ˩! |
crdo-NRU_F4_HOUSEBUILDING2_HOUSEBUILDING2_S039.wav	kʰi˧ | ʈʂʰɯ˧-qo˧ di˩ ◊ -dʑo˩ | tʰi˩˥, | gæ˩pʰæ˧-dʑo˥ | ʈʂʰɯ˧-qo˧ | le˧-hɯ˩. |
crdo-NRU_F4_HEALING_HealingS044.wav	ə! dʑɯ˧-ʈʂʰwæ˧ ho˧ pi˥-zo˩, | dʑɯ˧ɭɯ˧-bv̩˧ | hɑ˧! |
crdo-NRU_F4_CARAVANS_CaravansS014.wav	"ʐɤ˩ se˩ hɯ˩-hĩ˥, | pi˧-kv̩˩! | ʐwæ˧ tɕɯ˩-hĩ˩-dʑo˩, | ə˧ʝi˧-ʂɯ˥ʝi˩, | ʐɤ˩ se˩
			hɯ˩-hĩ˥, | pi˧-kv̩˩-mæ˩! |"
crdo-NRU_F4_DOG2_Dog2S031.wav	tʰi˩˥, | ʈʂʰɯ˧ne˧ ʝi˥-se˩-dʑo˩, | tʰi˩˥, | kʰv̩˩mi˩-ʈʂʰɯ˥-dʑo˩, | əəə… zo˩no˥… | tsʰe˩so˩-kʰv̩˩ ʝi˥! | njæ˧sɯ˩kv̩˩-dʑo˩, | qʰv̩˩tsʰi˧-kʰv̩˥ ʝi˩! |
crdo-NRU_F4_HEALING_HealingS024.wav	"njɤ˧-dʑo˥ | ɖɯ˧-zɯ˧ | ɖɯ˧-ʈʂʰæ˧˥ | le˧-go˩-zo˩, | le˧-qʰwɤ˧ mɤ˧-tʰɑ˧-ɻ̍˥! | qʰɑ˩ne˩˥ |
			tso˧-ɲi˩?"" |"
crdo-NRU_F4_COMING_OF_AGE2_F4_ComingOfAge2S080.wav	ʂe˧ʐe˧-ʂe˧sɑ˥ | le˧-pɤ˥~pɤ˩! | əəə… ə˧mi˧-ɳɯ˧ tʰi˧-tɕʰo˩, | ɖɯ˧-tɑ˧˥ F ◊ -ki˩ | bi˧-kv̩˧-ze˥-mæ˩! |
crdo-NRU_F4_TIGER2_Tiger2S021.wav	"tʰi˩˥, | ə˧dɑ˥-ɳɯ˩: | ""ejo! mɤ˧-sɯ˥-dʑo˩, | ɖwæ˩-mɤ˧-zo˧!"" |"
crdo-NRU_F4_HOUSEBUILDING2_HOUSEBUILDING2_S137.wav	õõõ! hɑ˧ F | mɤ˧-dzɯ˧-sɯ˥, | pʰæ˧tɕi˥=ɻæ˩-dʑo˩, | ʐɯ˧-sɯ˥ | ʝi˩-qʰwɤ˩ ʈʰɯ˩˥! |
crdo-NRU_F4_ELDERS3_Elders3S021.wav	"sɯ˧pʰi˧-lo˧ ʝi˧, | sɯ˧pʰi˧-hɑ˩ dzɯ˩, | sɯ˧pʰi˧ ə˧tso˧ dʑo˧ | tʰi˩˥ | njɤ˧ ə˧ʑi˧…
			ʝi˧! |"
crdo-NRU_F4_FUNERAL_F4_FUNERAL_S170.wav	tʰi˩˥, | ə˧v̩˧˥ | so˩-kv̩˩˥ ◊ -dʑo˩, | əəə… ɑ˩ʁo˧ | <tʰ> ʂɯ˧! | njɤ˧ | do˩-mæ˩˥! |
crdo-NRU_F4_ELDERS3_Elders3S024.wav	ʈʂʰɯ˧ | ə˧tso˧ mv̩˧ʈʂæ˧˥? |
crdo-NRU_F4_MOUNTAINS_F4_MountainsS135.wav	qv̩˧ɻ̍˧ | <dʑɯ˩… dʑɯ˩…> dʑɯ˩-ʈʂʰɯ˩-ʈʰɤ˩˥ ◊ -dʑo˩, | ɖwæ˧˥ | dʑɤ˩ kv̩˧-tsɯ˥ | mv̩˩!
crdo-NRU_F4_TIGER2_Tiger2S129.wav	"ŋv̩˩˥, | ŋv̩˩˥ ◊ -dʑo˩ | tʰi˩˥, | ɖɯ˧-ɲi˧-ɻ̍˧-dʑo˩, | ə˧mi˧-ɳɯ˧, | ə˧tso˧, | ʁo˧tʰo˩ hĩ˩-tsʰɯ˩-ni˩! | ""njɤ˧ mv̩˩! | tʰɑ˧-ŋv̩˩!"" |"
crdo-NRU_F4_HOUSEBUILDING2_HOUSEBUILDING2_S015.wav	tʰi˧-tɕɯ˧-se˥ | tʰi˩˥, | ʑi˧mi˧-ʈʂʰɯ˧ | le˧-dɑ˧˥, | le˧-tʰv̩˧…-se˩-kwɤ˩tɕɯ˩-lɑ˩ | tʰi˩˥, | hæ̃˧kʰɤ˧ tʰi˥-lɑ˩! | əəə… ʐv̩˩ɭɯ˥ tʰi˩-kʰɯ˩! |
crdo-NRU_F4_ELDERS3_Elders3S054.wav	zo˧ | ʐv̩˩-kv̩˩˥, | <zo˩-kv̩˩˥>, hĩ˧=ɻæ˥ | tʰi˩˥, | le˧-hɤ˩! |
crdo-NRU_F4_HOUSEBUILDING2_HOUSEBUILDING2_S208.wav	əəə… <v…> wo˩-bv̩˥ | v̩˩tsʰɤ˧˥ | əəə… ʈʂʰɯ˧-dʑo˩ | tʰi˩˥ | wɤ˩˥ | gv̩˩-ɬi˩mi˩-qo˥, | ə˧ʝi˧-tsʰi˧ʝi˧-ne˧˥, | tʰi˧-di˩-kʰɯ˩ | mɤ˧-kv̩˧˥! |
crdo-NRU_F4_CARAVANS_CaravansS248.wav	"ĩ˧! | õ˧ʈʂʰɯ˧ne˧ ʝi˥-dʑo˩ | tʰi˩˥, | mv̩˧tsʰi˧-qo˩ tʰv̩˩-kwɤ˩tɕɯ˩-lɑ˩, | əəə… ʐwæ˧
			dʑo˧-hĩ˥=ɻæ˩, | dʑi˧ qæ˧ kʰɯ˩-kv̩˩-ze˩-pi˩-kv̩˩! | tso˧~tso˧ le˧-hwæ˧-le˧-po˧-jo˥! |"
crdo-NRU_F4_FOOD_SHORTAGE_FoodShortageS043.wav	mv̩˧ʈʂv̩˩-qo˩-ɳɯ˩, | mv̩˧dze˧ | ʈʂʰɯ˧-ʂæ˧~ʂæ˧-gv̩˧-ɲi˥-mæ˩! | tɕʰi˧ tʰi˧-di˥-ɲi˩-mæ˩! |
crdo-NRU_F4_SEEDS_SeedsS065.wav	tʰi˩˥, | ʈʰæ˧mi˧-ɳɯ˩, | ə˧ʝi˧-ʂɯ˥ʝi˩, | <nv̩˩ɭɯ˧…> nv̩˧hṽ˩, | ki˧-mɤ˧-kv̩˧-tsɯ˥ ◊ -mv̩˩! |
crdo-NRU_F4_MUSHROOMS_MUSHROOMS_S095.wav	"""qʰɑ˩ne˩-ʝi˥-tso˩-ɲi˩? | hĩ˧=ɻæ˥-dʑo˩, | hĩ˧ dʑo˧˥!"" | pi˧-ɲi˥-tsɯ˩-mv̩˩. |"
crdo-NRU_F4_MUSHROOMS_MUSHROOMS_S137.wav	æ˧ʂæ˧ | gwɤ˩˥, | ʈʂʰɯ˧ne˧-ʝi˥ | gwɤ˩-kv̩˥-mæ˩:
crdo-NRU_F4_FOOD_SHORTAGE_FoodShortageS014.wav	zo˧ tɕʰi˧-hɯ˧-dʑo˩ | tʰi˩˥, | ə˧mi˧ ɖɯ˧-v̩˧-ʈʂʰɯ˧-ɳɯ˩, | tʰi˩˥, | zo˧ | le˧-ʂv̩˧, | zo˧ tɕʰi˧-bi˧-pi˧, | zo˧ tɕʰi˧-hɯ˥-dʑo˩; |
crdo-NRU_Mariage_De_La_Soeur_V3_Sister3_S044.wav	tʰi˩˥, | ʂe˧ ʈʰæ˩-ho˩-ze˩, | ʂe˧ | ʈʂʰɯ˧ne˧-ʝi˥ | ʈʰæ˧~ʈʰæ˧˥, | ʐɯ˧ ʈʰɯ˩-ho˩-dʑo˩ | tʰi˩˥, | ʈʂʰɯ˧ ə˧mv̩˩-ɳɯ˩-dʑo˩, |
crdo-NRU_F4_DOG2_Dog2S054.wav	tʰi˩˥, | zo˩no˥, | əəə… kʰv̩˧ʂɯ˥-njɤ˩ʂɯ˩ ɲi˩-bi˩-bi˩, | mmm… ɑ˩ʁo˧… | hĩ˧ mo˥-hĩ˩-ki˩, | əəə… hɑ˧ | le˧-ki˧-se˩, | ʈʂʰo˧do˩ ʈʂʰo˩-pi˩, | gɤ˩˥ | le˧-ʈʂʰo˧-se˥-dʑo˩ | tʰi˩˥, | kʰv̩˩mi˩-ki˥-sɯ˩ | hɑ˧ | le˧-ʂo˧~ʂo˧ tʰi˧-ki˥! |
crdo-NRU_F4_DOG2_Dog2S016.wav	qæ˧~qæ˧ tsæ˥-ɲi˩! | pi˧-ɲi˥-tsɯ˩ ◊ -mv̩˩. |
crdo-NRU_F4_FOOD_SHORTAGE_FoodShortageS074.wav	tʰi˩˥, | kʰɯ˧ tsɤ˧-kv̩˧˥ ◊ -dʑo˩ | tʰi˩˥, | ɣɯ˧ dɑ˩! |
crdo-NRU_F4_FOOD_SHORTAGE2_FOOD_SHORTAGE2S047.wav	"""tʰi˩˥, | mv̩˩ tɕʰi˩ le˥-wo˩-tsʰɯ˩-ze˩!"" |"
crdo-NRU_F4_FOOD_SHORTAGE2_FOOD_SHORTAGE2S059.wav	"gɤ˩-ʑi˥-dʑo˩, | ""ooo! njɤ˧-zo˧ F tʰi˧-dzi˩, | tʰi˧-dzi˩!"" | pi˧-tsɯ˩ ◊ -mv̩˩, | ə˧dɑ˥-ɳɯ˩. |"
crdo-NRU_F4_FOOD_SHORTAGE_FoodShortageS101.wav	"""zo˩no˧-ni˩, | no˧sɯ˩kv̩˩, | “ʈʂʰɯ˧-kʰwɤ˧ | mɤ˧-ɲi˧-ze˧! | ʈʂʰɯ˧-kʰwɤ˧ ɲi˧-ze˧!” | pi˧-di˧˥, | mɤ˧-dʑo˧-ɲi˥-mæ˩, | ə˧ʝi˧-ʂɯ˥ʝi˩-dʑo˩!"" |"
crdo-NRU_F4_RENAMING_RenamingS009.wav	"tʰi˩˥, | ə˧ʑi˧-mo˥ | ʈʂʰɯ˧-jɤ˩-ɳɯ˩: | ""ə˧mi˧! | no˧=ɻ̍˩ | ə˧tso˧ kʰv̩˧-ɲi˥?"" | pi˧
			…-dʑo˩. | tʰi˩˥, | ""njɤ˧ | tsʰi˧ʝi˧-dʑo˩, | zo˧hṽ̩˥ | lɑ˧-kʰv̩˧-ɲi˥!"" | pi˧. |"
crdo-NRU_F4_COMING_OF_AGE2_F4_ComingOfAge2S072.wav	"""ə˧mi˧! | njɤ˧ | <mv…> ʐv̩˧mi˧ ʈʂʰɯ˧-ɭɯ˧-dʑo˩, | tsʰe˧ʝi˧-dʑo˩, | ɖɯ˧-kʰv̩˧ ɖɯ˧-ze˥! | mmm… dʑɤ˩-kʰɯ˥!"" |"
crdo-NRU_F4_HEALING_HealingS042.wav	dʑɯ˧-ʈʂʰwæ˧ pi˧-zo˥! | dʑɯ˧-ʈʂʰwæ˧ ho˧ pi˥-zo˩! |
crdo-NRU_F4_HEALING_HealingS045.wav	"dʑɯ˧ɭɯ˧-…hɑ˧-ʈʂʰɯ˧, | le˧-ti˩, | le˧-ti˩, | dʑɯ˧ʈʂʰwæ˧-ho˧-ʈʂʰɯ˧ | le˧-tɕɤ˧˥, |
			le˧-tɕɤ˧˥, | ʈʂʰɯ˧ne˧-ʝi˥ | ɖɯ˧-ʈʰɤ˥ tʰi˩-kʰɯ˩; |"
crdo-NRU_F4_CARAVANS_CaravansS239.wav	"ə˧ʝi˧-ʂɯ˥ʝi˩, | zo˩no˥, | hĩ˧=ɻæ˧-ni˧˥, | zo˩no˧-<ɳ>hĩ˧ ni˧˥ | lo˧pæ˧
			tsɤ˧-ɲi˥-ze˩-wɤ˩! | hɤ˩ ɲi˥-ho˩-mæ˩, ◊ ə˩-gi˩! |"
crdo-NRU_F4_FUNERAL_F4_FUNERAL_S053.wav	ʈʂʰv̩˧ tʰi˧-ki˧! | ʈʂʰv̩˧ dzɯ˧, | wɤ˩˥ | ʈʂʰv̩˧ tʰi˧-ki˧, | tʰi˧-pæ˩. |
crdo-NRU_F4_FOOD_SHORTAGE_FoodShortageS094.wav	njɤ˧ | ə˧si˧-ɳɯ˧ | ɖɯ˧-↑njɤ˧ | ʈʂʰɯ˧ne˧-ʝi˥ | ʐwɤ˩-kv̩˩˥! |
crdo-NRU_Mariage_De_La_Soeur_V3_Sister3_S146.wav	tʰi˩˥, | ə˧mɑ˧… | njɤ˧ | ə˧si˧-ɳɯ˧ | ʐwɤ˩-dʑɯ˩˥! | ə˧ʝi˧-ʂɯ˥ʝi˩! |
crdo-NRU_F4_CARAVANS_CaravansS137.wav	"bæ˧! | bæ˩-po˩-ɳɯ˥ | ʐwæ˧ | tʰi˧-tsɯ˧~tsɯ˧-kwɤ˩tɕɯ˩-zo˩, |
			gi˧dʑɯ˧-<-dʑo˧-qɑ˧>[qo˧mv̩˧], | fv! pi˧, | ɖɯ˧-tɕo˥ | kʰɯ˧˥ ◊ -dʑo˩, |"
crdo-NRU_F4_MUSHROOMS_MUSHROOMS_S017.wav	"""qv̩˧dzi˩-ʈʰæ˩qo˩ di˩-hĩ˩, | <dʑ…>ɖʐɤ˧ mɤ˧-ɖo˧! | mo˧kɤ˩-ʈʰæ˩qo˩ di˩-hĩ˩, | <dʑ…>ɖʐɤ˧ mɤ˧-ɖo˧!"" | pi˧-zo˩, | mo˧˥ ◊ -dʑo˩, | dʑɯ˩ʁo˩ di˥-hĩ˩-dʑo˩, | õ˧-ʈʂʰɯ˧ ɲi˧-bæ˧, | si˧dzi˩, | <ɲi˧-bæ˧… | > õ˧-ʈʂʰɯ˧ ɲi˧-bæ˧-ʈʰæ˧qo˥ di˩-hĩ˩-dʑo˩, | qʰɑ˧jɤ˧ tʰi˧-di˥-bi˩, | ɖʐɤ˧ mɤ˥-kv̩˩! |"
crdo-NRU_F4_CARAVANS_CaravansS124.wav	"tʰi˩˥, | ze˩-ɲi˧ | wɤ˩˥ | ""tsʰo˧qʰwɤ˩-dʑo˩, | ə˧zɯ˩, | lo˧ʂv̩˩ hɑ̃˩! | so˧ɲi˥-dʑo˩, |
			lo˧gv̩˩ tʰv̩˩! |"
crdo-NRU_F4_CARAVANS_CaravansS062.wav	"""ə˧mi˧! | ho˧di˧ hɯ˧-hĩ˧, | <le˧…> ʈʰæ˧qʰwɤ˧ le˧-po˧-ʝi˧-ʝi˧-ze˩!"" | pi˧. |"
crdo-NRU_F4_HOUSEBUILDING2_HOUSEBUILDING2_S241.wav	gɯ˩ ʝi˥-dʑo˩, | v̩˩tsʰɤ˧ pʰo˥, | le˧-kv̩˧-ɲi˥-ze˩! |
crdo-NRU_Mariage_De_La_Soeur_V3_Sister3_S034.wav	pʰv̩˧ɖɯ˧ ʝi˥-ho˩-ze˩-tsɯ˩ ◊ -mv̩˩!
crdo-NRU_F4_DOG2_Dog2S074.wav	le˧-mo˩, | njɤ˩ɭɯ˧-ʈʂʰɯ˧, | kʰv̩˧-ʈʂʰɯ˧, | ə˩qo˥-bi˩-kv̩˩-tsɯ˩ ◊ -mv̩˩, | njɤ˩ɭɯ˧-ʈʂʰɯ˧! | qo˧bɤ˧-dʑo˩! |
crdo-NRU_F4_FUNERAL_F4_FUNERAL_S110.wav	"""mv̩˩ɖɯ˩-ɳɯ˥ | tɕʰi˩tʰv̩˩-tso˥ ɲi˩-tsɯ˩!"" | pi˧, | ""bi˧-zo˧-ʝi˧!"" | pi˧. |"
crdo-NRU_AGRICULTURAL_ACTIVITIES_Agriculture_S062.wav	hĩ˧=ɻæ˧-ni˧˥, | ɖɯ˧-kʰv̩˧˥ | ɲi˧-ʂɯ˩ | mɤ˧-dʑo˧-ɲi˥ mæ˩, |
crdo-NRU_F4_FUNERAL_F4_FUNERAL_S215.wav	<ɖɯ˧-mɤ…> mɤ˧-ʈʂɤ˥~ʈʂɤ˩, | ɖɯ˧-v̩˧-ki˧-ɳɯ˩, | ɖɯ˧-ʈʂwɤ˧~ɖɯ˧-ʈʂwɤ˧! |
crdo-NRU_AGRICULTURAL_ACTIVITIES_Agriculture_S109.wav	tʰi˧-tɕɯ˧-zo˧-ɲi˥ mæ˩! | zo˩no˧-se˥, | ʈʂʰɯ˧=ɻæ˥ | gv̩˩-hĩ˩˥ | mɤ˧-dʑo˩-ze˩. |
crdo-NRU_F4_FUNERAL_F4_FUNERAL_S225.wav	njɤ˧-ɳɯ˧ | tʰi˧-tsʰɤ˧˥ ◊ -ni˩! | ʈʂʰɯ˧ F | njɤ˧-ki˩ | tʰi˧-tɕɯ˧-tsʰɯ˧˥! |
crdo-NRU_F4_DOG2_Dog2S109.wav	hĩ˧-ʈʂʰɯ˧-dʑo˩ | tʰi˩˥, | ɖɯ˧-pi˧˥ | bæ˧ ɲi˥-tsɯ˩ ◊ -mv̩˩!
crdo-NRU_Mariage_De_La_Soeur_V3_Sister3_S127.wav	«ʈʂo˧kʰɯ˩-dʑo˩, | hĩ˧ hwɤ˥!», | pi˧-kv̩˩-tsɯ˩ ◊ -mv̩˩, | ə˧ʝi˧-ʂɯ˥ʝi˩, | tʰi˩˥, | ʈʂo˧kʰɯ˩, | sɯ˧kʰɯ˩, | pi˧-hĩ˧ | dʑo˩-kv̩˩-tsɯ˥ ◊ -mv̩˩!
crdo-NRU_F4_CARAVANS_CaravansS144.wav	"o! qʰɑ˩ hɑ̃˩-ɖʐɯ˩-ze˥, | ʈʂʰɯ˧-qo˧-pi˧ | tʰi˩˥, | ʈʂʰɯ˧ | ɖɯ˧-so˩ hɑ̃˩ | le˧-mɤ˧-tsʰɯ˩,
			| pi˧-dʑo˩, |"
crdo-NRU_F4_HEALING_HealingS029.wav	"ɖɯ˧-pi˧˥ | mɤ˧-dʑɤ˩, | tʰi˩˥, | əəə… əəə… dɑ˧pɤ˧ <qʰɑ˩ne˩…> dɑ˧pɤ˧ qʰɑ˧ɲi˧~qʰɑ˩ɲi˩ | ʝi˧-zo˧-ho˩"", | pi˧-zo˩, |"
crdo-NRU_F4_FOOD_SHORTAGE2_FOOD_SHORTAGE2S079.wav	"""əəə… “hwɤ˧tɕi˥-ʁo˩bv̩˩ tʰv̩˩-dʑo˩, | zo˧ tɕʰi˧-le˥-wo˩-tsʰɯ˩. | di˩li˩-ʁo˩bv̩˥ tʰv̩˩-dʑo˩, | mi˩ tɕʰi˩-le˥-wo˩-tsʰɯ˩”, | pi˧-kv̩˩."" |"
crdo-NRU_F4_ELDERS3_Elders3S052.wav	tʰi˩˥, | njæ˧sɯ˩kv̩˩, | ə˧ʝi˧-ʂɯ˥ʝi˩, | hĩ˧-qɑ˩ | ɖʐwæ˧~ɖʐwæ˥ | mɤ˧-kv̩˧˥! |
crdo-NRU_F4_SEEDS_SeedsS020.wav	le˧-kʰv̩˥, | ʈʂʰɯ˧-qo˧ ɲi˩-ɲi˩-tsɯ˩ ◊ -mv̩˩, | ə˧ʝi˧-ʂɯ˥ʝi˩. | ʈʂʰɯ˧-qo˧! |
crdo-NRU_F4_ELDERS3_Elders3S003.wav	"ə˧lɑ˧-ʁwɤ˧ | pi˧, | le˧-tsʰɯ˩-se˩-dʑo˩ | tʰi˩˥, | njɤ˧ | ə˧ʑi˧-ʈʂʰɯ˥-dʑo˩, ◊ ə˩-gi˩!
			|"
crdo-NRU_F4_FOOD_SHORTAGE2_FOOD_SHORTAGE2S056.wav	hɯ˧, | hɯ˧-dʑo˧, | ə˧dɑ˥-lɑ˩ | zo˧ | ɲi˧-kv̩˧˥ | tɕʰo˧~tɕʰo˧-ɻ̍˩! | hɯ˧-dʑo˧! | əəə…
crdo-NRU_F4_HOUSEBUILDING2_HOUSEBUILDING2_S116.wav	tʰi˩˥, | gɯ˩˥ | mɤ˧-gɯ˩ | mɤ˧-sɯ˥, ◊ ə˩-gi˩! | ʈʂʰɯ˧ne˧ ʝi˥ | le˧-pi˥ pi˩, | dʑɯ˧ | zo˩no˧, | õ˧-bv̩˥-õ˩ | ɬi˩di˩-di˩-mi˩<-qo˩> ʈʂʰɯ˩-qo˩ dʑo˩, | dʑɯ˧ | ɖɯ˧-pi˧˥, əəə … | hɑ˧ | dzɯ˧-kv̩˩-hĩ˩ dʑɯ˩ ɲi˩-ze˩! |
crdo-NRU_F4_FUNERAL_F4_FUNERAL_S196.wav	ʈʂʰɯ˧ne˧-ʝi˥, | ʈæ˧bɤ˧ ɲi˧tsi˧-kv̩˧˥ | ʁɑ˧ʂe˥ ɲi˩! |
crdo-NRU_F4_HOUSEBUILDING2_HOUSEBUILDING2_S323.wav	'hĩ˧ | ʈʂʰɯ˧-dʑo˩, | qʰɑ˧tv̩˧ qʰɑ˧bæ˧ gv̩˧ ɳɯ˧, | hĩ˧ ɖɯ˧-v̩˧ lɑ˧ ɲi˥!' | pi˧. |
crdo-NRU_F4_TIGER2_Tiger2S093.wav	"""njɤ˧ | qʰɑ˩ne˩ ʝi˥-kʰɯ˩-bi˩?"""
crdo-NRU_F4_MUSHROOMS_MUSHROOMS_S107.wav	mɤ˧-sɯ˥! |
crdo-NRU_F4_MUSHROOMS_MUSHROOMS_S071.wav	æ̃˧tsɯ˥-kʰɯ˩ʈʂɤ˩-mo˩ | ɖɯ˧-kʰwɤ˥ tʰi˩-kʰɯ˩! |
crdo-NRU_F4_HOUSEBUILDING2_HOUSEBUILDING2_S285.wav	kʰv̩˧ʂɯ˥-dʑo˩, ɖæ˩lɑ˧so˧!
crdo-NRU_Naissance_du_Lac_V3_Lake3_S031.wav	wɤ˩˥ | tsʰi˧ɲi˧ | le˧-hæ̃˧˥ | le˧-dzɯ˥! | wɤ˩˥ | so˧ɲi˥ | tʰi˧-di˩! |
crdo-NRU_F4_HOUSEBUILDING2_HOUSEBUILDING2_S050.wav	õ˧-ʈʂʰɯ˧ne˧-ʝi˥-kv̩˩ mæ˩! |
crdo-NRU_Mariage_De_La_Soeur_V3_Sister3_S008.wav	dʑɯ˩ʁo˩˥ | kʰv̩˧ʂæ˧ hɯ˧˥! | tʰi˩˥ | dʑɯ˩ʁo˩˥ | tʰi˧-dzi˩… | tʰi˧-dzi˩-dʑo˩! | ɖɯ˧-so˩ kʰv̩˩ | le˧-mɤ˧-tsʰɯ˩-tsɯ˩ ◊ -mv̩˩. |
crdo-NRU_Mariage_De_La_Soeur_V3_Sister3_S030.wav	hĩ˧bæ˧-dʑo˩, | ɖɯ˧-tɑ˧˥ | tsʰɯ˩˥, | tʰi˧-dzi˩-kʰɯ˩; |
crdo-NRU_F4_HEALING_HealingS021.wav	"əəə… ʈʂʰɯ˧ne˧-ʝi˥ | le˧-ʁɑ˥ʂe˩-dʑo˩ | tʰi˩˥, | hĩ˧ ʈʂʰɯ˧-ʑi˧=ɻ̍˥-dʑo˩, |
			le˧-qʰwɤ˧-ze˧-tsɯ˧˥ ◊ -mv̩˩!"
crdo-NRU_F4_HOUSEBUILDING2_HOUSEBUILDING2_S096.wav	wɤ˩˥ | ʈʂʰɯ˧-ʁo˥-qo˩ tɕʰɯ˩. | tʰi˧-tsʰi˧˥ ◊ -tɕɯ˩ !
crdo-NRU_F4_HOUSEBUILDING2_HOUSEBUILDING2_S267.wav	hɑ˧-ʈʂʰɯ˧, | õ˧=bv̩˥ õ˩ | ɖɯ˧-qʰwɤ˧~ɖɯ˥-qʰwɤ˩-ʈʂʰɯ˩ | ʂo˩˥, ◊ ə˩-gi˩! |
crdo-NRU_F4_HOUSEBUILDING2_HOUSEBUILDING2_S216.wav	ə˧ʝi˧-tsʰi˧ʝi˧ ne˧-ʝi˥ zo˩, | ʂɯ˧-hĩ˥ | v̩˩tsʰɤ˧˥ | mɤ˧-dʑo˧-ɲi˥! |
crdo-NRU_F4_MOUNTAINS_F4_MountainsS021.wav	tʰv̩˧ne˧-ʝi˥ | ʝi˧lv̩˧-ɲi˥-tsɯ˩ ◊ -mv̩˩! | ʝi˧lv̩˧ bi˧-ho˥-dʑo˩ | tʰi˩˥, | ə˧tso˧-mɤ˧-ɲi˩ | dʑo˧! |
crdo-NRU_F4_HOUSEBUILDING2_HOUSEBUILDING2_S295.wav	ĩ˧! | õ˧ʈʂʰɯ˧ne˧-ʝi˥-kwɤ˩tɕɯ˩-lɑ˩ | tʰi˩˥, | õ˧tʰv̩˧ so˩-dʑo˩ | tʰi˩˥, | mv̩˩si˧-njɤ˧˥ | njɤ˧lɑ˥ | gɤ˩-ʈi˥, | qwɤ˧ɭɯ˧-ʁo˧ | tʰi˩˥ | bo˩ʈʂʰæ˥ | le˧-hæ̃˧ tʰi˥-tɕɯ˩! |
crdo-NRU_F5_HINAMI_F5_SONG_HINAMIS005.wav	tʰi˧-dʑo˧, | tʰi˧-wɤ˥~wɤ˩ mɤ˩-kv̩˩! | tʰi˧-ʂe˧, | tʰi˧-kʰɤ˧ɕjɤ˧-lɑ˩ ɲi˩! | ə˧hɑ˧-bɑ˩lɑ˩ | mɤ˧-dɑ˩-mi˩-jɤ!
crdo-NRU_F4_TIGER2_Tiger2S085.wav	lɑ˧ | qʰɑ˩ne˩˥ | bæ˧˥! | <ə˧mi˧-lɑ˧ | mv̩˩˥, | əəə…> mv̩˩˥ | ʈʂʰɯ˧ne˧-ʝi˥ | bæ˧-ɲi˥-pi˩-tsɯ˩ ◊ -mv̩˩!
crdo-NRU_F4_MUSHROOMS_MUSHROOMS_S098.wav	ɖɯ˧-kʰv̩˧-ɳɯ˥, | ɖɯ˧-ɭɯ˧ dʑo˩! | ɖɯ˧-kʰv̩˧-ɳɯ˥, | ɖɯ˧-ɭɯ˧ dʑo˩! | ɖɯ˧-kʰv̩˧-ɳɯ˥, | ɖɯ˧-ɭɯ˧ dʑo˩! | zo˧mv̩˥-ʈʂʰɯ˩! |
crdo-NRU_F4_FOOD_SHORTAGE_FoodShortageS041.wav	tʰi˩˥, | mv̩˧dze˧ | le˧-kʰv̩˧-le˧-po˧-tsʰɯ˧˥! | mmm… mv̩˧dze˧ | le˧-lɑ˧˥! |
crdo-NRU_F4_CARAVANS_CaravansS045.wav	"tʰi˩˥, | ə˧mi˧ | li˩-ʈʰɯ˩-di˩ mɤ˩-dʑo˩˥! | tʰi˩˥, | ə˧mi˧ | le˧-ʂɯ˧-ɲi˥-ze˩-mæ˩! |
			tʰi˩˥, | li˩˥ ◊ -dʑo˩ | le˧-dʑo˧-ɲi˥-ze˩-wɤ˩! |"
crdo-NRU_F4_ELDERS3_Elders3S045.wav	"""no˧sɯ˩kv̩˩-dʑo˩, | ʈʂʰɯ˧ne˧-ʝi˥ | ʝi˧-mɤ˧-ɖo˧! | hĩ˧-ʈʂʰɯ˧, | dʑɤ˩-hĩ˧ so˥-zo˩-kv̩˩! |
			dzɑ˧-hĩ˧, | ʝi˧-mɤ˧-ɖo˧!"" |"
crdo-NRU_F4_HOUSEBUILDING2_HOUSEBUILDING2_S036.wav	əəə… ɑ˩ʁo˥ | tʰi˩˥, | əəə… mv̩˩pʰæ˧-pi˧ | ɖɯ˧-ʁo˩ dʑo˩-ɲi˩-ze˩. | gæ˩pʰæ˧-pi˧ | ɖɯ˧-ʁo˩ dʑo˩-ɲi˩-ze˩! |
crdo-NRU_Naissance_du_Lac_V3_Lake3_S002.wav	ə˧mɑ˧ | do˧ F -mɤ˧-dʑɯ˧, ◊ ə˩-gi˩!
crdo-NRU_F4_ELDERS3_Elders3S038.wav	"""lɑ˧tʰɑ˧mi˧=ɻ̍˧-pi˥, | lɑ˧tʰɑ˧mi˧=ɻ̍˥ | hĩ˧ dʑɯ˩ | ʐwæ˩-ze˥!"" | pi˧. | ə˧ʝi˧-ʂɯ˥ʝi˩,
			| ʈʂʰɯ˧ne˧-ʝi˥ | ʐwɤ˩-kv̩˩˥ ◊ -mæ˩!"
crdo-NRU_F5_HINAMI_F5_SONG_HINAMIS009.wav	ʁo˧-ʂwæ˧ | ʂwæ˧bæ˩, | tʰi˧-bæ˩-ze˩-lɑ, | di˩-dʑɤ˥ bæ˩bæ˩ bæ˩-jɤ-ni˩-jɤ, jɤ! | 
crdo-NRU_F4_FUNERAL_F4_FUNERAL_S099.wav	õ˧ zo˧mv̩˥ | qʰɑ˩kv̩˩ dʑo˩-ɻ̍˥-dʑo˩, | ɖɯ˧-v̩˧~ɖɯ˧-v̩˧ F | ʝi˧-kv̩˩-ze˩-mæ˩! |
crdo-NRU_F4_MUSHROOMS_MUSHROOMS_S105.wav	zo˩no˧-dʑo˥, | ə˧tso˧~ə˧tso˥ F | ɖwæ˧˥ | pʰv̩˧ɖɯ˧-hĩ˥ ɲi˩-ze˩-tsɯ˩! | ə˧ʝi˧-ʂɯ˥ʝi˩, | mo˧˥, | zo˩no˥ | pʰv̩˧ɖɯ˧ hĩ˥, | ʈʰææ̃˧… | dzɯ˧-mɤ˧-kv̩˩-wɤ˩! |
crdo-NRU_F4_FUNERAL_F4_FUNERAL_S066.wav	əəə… nɑ˩-ʈʂʰɯ˥, | zo˩no˧ <ɲi…>, hĩ˧ | <ɑ˩ʁ…> njæ˧sɯ˩kv̩˩ | ɑ˩ʁo˧ tsʰɯ˩-dʑo˩, ◊ ə˩-gi˩! |
crdo-NRU_F4_FUNERAL_F4_FUNERAL_S261.wav	æ˧ʂæ˧-ʈʂʰɯ˧, | ɖɯ˩lo˧ | ʈʂʰɯ˧ne˧-ʝi˥ | dʑo˧-ɲi˥-mæ˩! |
crdo-NRU_F4_CARAVANS_CaravansS024.wav	no˧ | ə˧mɑ˧-bv̩˧ | sjæ˧pʰjɛ˧ | no˧ | ɖɯ˧-pʰæ˧ lɑ˥-ɲi˩-mæ˩, ◊ ə˩-gi˩! |
crdo-NRU_F4_MOUNTAINS_F4_MountainsS048.wav	ʈʂʰɯ˧ | ɲi˧-kʰɯ˩ | gɤ˩tɕo˧ | ɖɯ˧-tso˩, | ɖɯ˧-tso˩, | ɖɯ˧-tso˩-ɳɯ˩ | gɤ˩tɕo˧ po˧˥, |
crdo-NRU_F4_FUNERAL_F4_FUNERAL_S255.wav	nɑ˩-ʈʂʰɯ˧, | hĩ˧ ʂɯ˧-ʈʂʰɯ˧-dʑo˩, | ɖwæ˧˥ | pʰv̩˧-ɖɯ˧-kv̩˥! |
crdo-NRU_F4_COMING_OF_AGE2_F4_ComingOfAge2S106.wav	wɤ˩˥ | ʐɯ˧ tʰi˧-ki˧! | jɤ˧ tʰi˧-ki˧! | le˧-bi˩; | le˧-tɑ˩hwɤ˩ | le˧-bi˩! |
crdo-NRU_Mariage_De_La_Soeur_V3_Sister3_S117.wav	"""mv̩˧mi˧ ʈʂʰwɤ˩-mɤ˩-ɖɯ˩; | kʰv̩˧nɑ˥ ʐo˩-mɤ˩-ɖɯ˩"" | pi˧; | æ˧ʂæ˧-tɑ˩mv̩˩-dʑo˩, | ʈʂʰɯ˧ne˧-ʝi˥ | ɖɯ˧-kʰwɤ˧ dʑo˧-ɲi˥-mæ˩! |"
crdo-NRU_F4_MUSHROOMS_MUSHROOMS_S114.wav	bæ˩bæ˩˥, | <ʈʂʰɯ˧…> pʰv̩˩tɕæ˩ɻæ˥-zo˩, | ʈʂʰɯ˧-ɖɯ˧~ɖɯ˧-hĩ˧ bæ˥-kv̩˩-hĩ˩ tʰv̩˩-ʁo˩! |
crdo-NRU_F4_ELDERS3_Elders3S015.wav	"ə˧si˧ ɲi˩-ze˩-dʑo˩ | tʰi˩˥, | zo˩no˥, | njɤ˧ | ə˧ʑi˧-ʈʂʰɯ˥ | le˧-ʂe˧-po˧-hɯ˥!
			|"
crdo-NRU_F4_HEALING_HealingS098.wav	dzɯ˩nɑ˩mi˩-ʁo˥ | mɤ˧-bi˧! | əəə… ɖæ˩mi˧-qo˧ dzi˩! õ! | tʰi˩˥, | əəə… |
crdo-NRU_F4_HOUSEBUILDING2_HOUSEBUILDING2_S229.wav	ʐo˩ dzɯ˩-se˥, | ɖɯ˧-v̩˧ | ɬi˧ʈv̩˥ qwæ˩-bi˩. | mv̩˩kʰv̩˧˥, | əəə… <ʝi˧-k…> zo˩no˧, | hæ˧-ʐwɤ˩ | tv̩˧tsʰɯ˧ | ɖɯ˧-ɭɯ˧-qo˧-ɳɯ˧-dʑo˥ | ɬi˧ʈv̩˥ qwæ˩-bi˩-dʑo˩, | qʰv̩˧-ɭɯ˥-qo˩ tʰv̩˩-ɳɯ˩ | <nnn… le˧…> ɑ˩ʁo˧ | le˧-jo˩! | nn… əəə…
crdo-NRU_F4_MUSHROOMS_MUSHROOMS_S047.wav	ʈʂʰɯ˧ne˧-ʝi˥ | ɖɯ˧… ɖɯ˧-pʰæ˧-qo˥, | ʈʂʰɯ˧ne˧-ʝi˥ | ɖɯ˧-ʈv̩˩, | ɖɯ˧-ʈv̩˩, | ɖɯ˧-ʈv̩˩, | ɖɯ˧-ʈv̩˩ | gɤ˩-ʑi˥-dʑo˩, | ʈʂʰɯ˧ne˧-ʝi˥ | ɖɯ˧-pʰæ˧ ɖʐɤ˥, | ɖɯ˧-kʰɤ˧ ɖɯ˥-kv̩˩! |
crdo-NRU_F4_FUNERAL_F4_FUNERAL_S168.wav	zo˩no˥, | li˩sɯ˩mo˩-qo˥… | li˩læ˩˥… | lo˧gv̩˩ | li˩sɯ˩mo˩-qo˥ dʑo˩-ɲi˩! |
crdo-NRU_F4_SEEDS_SeedsS052.wav	ə˩kʰɯ˩-bv̩˥ | ɻæ˩˥! | ə˩kʰɯ˩ pi˥-kv̩˩-mæ˩! | æ̃! | wo˩-ɻæ˥ | pi˧. | wo˩-ɻæ˥-ʈʂʰɯ˩ | le˧-ʂe˧-le˧-po˧-tsʰɯ˧˥! | dze˧ʈʂʰɤ˧ ʝi˧ tʰi˧-kʰɯ˧˥! |
crdo-NRU_F4_HEALING_HealingS103.wav	əəə… ʈʰæ˧ɻæ˩ so˩-hĩ˩, | ɲi˧-kv̩˧˥ | so˩-kv̩˩ tʰi˥-kʰɯ˩. |
crdo-NRU_F4_MUSHROOMS_MUSHROOMS_S151.wav	əəə… dzi˧dzi˧-mo˧˥ | pi˧-zo˩, | zo˩no˥, | ʈʂʰɯ˧-dʑo˩, | ʈʂʰæ˧ɣɯ˧ tsɤ˧-kv̩˩, | pi˧-zo˩; |
crdo-NRU_F4_MOUNTAINS_F4_MountainsS075.wav	"""əəə… zo˩no˥, | hĩ˧-ʈʂʰɯ˧, | no˧sɯ˩kv̩˩ | dʑɤ˩˥… | zo˩no˥, | hɤ˩ʈʂɤ˩ mɤ˩-ɖo˩˥!"" |"
crdo-NRU_F4_MOUNTAINS_F4_MountainsS008.wav	əəə… qv̩˧ɻ̍˧-ʁo˧qʰwɤ˥ dzi˩ F | hĩ˧-ʈʂʰɯ˧ | ɖwæ˧˥ | hɤ˩ʈʂɤ˩-bi˩˥, | <hĩ˧ mɤ˧-tɕʰo˧-hĩ˥ | mɤ˧-dʑo˩-ɲi˩, | pi˧-ɲi˥-mæ˩! | əəə…> hĩ˧-bi˥ | mɤ˧-wɤ˩-hĩ˩ | mɤ˧-dʑo˩-ɲi˩, pi˩-ɲi˩-mæ˩!
crdo-NRU_F4_FOOD_SHORTAGE_FoodShortageS108.wav	ə˧ʝi˧-tsʰi˧ʝi˧-dʑo˩, | no˧sɯ˩kv̩˩, | ɖɯ˧-ɲi˥ F | dzɑ˩qʰwɤ˩˥ | ɲi˧-dzi˧ ki˩. |
crdo-NRU_F4_FOOD_SHORTAGE_FoodShortageS047.wav	tʰi˧-tɕɤ˧˥! | le˧-so˩~so˩ | tʰi˩˥, | le˧-tɕɤ˧˥! | mv̩˧dze˧-qwæ˩ʈʂwæ˩-hɑ˩, | pi˧-kv̩˩! |
crdo-NRU_F4_RENAMING_RenamingS011.wav	ə˧ʝi˧-ʂɯ˥ʝi˩, | dzo˧! | hĩ˧-se˧-di˧˥, | dzo˧! |
crdo-NRU_F4_COMING_OF_AGE2_F4_ComingOfAge2S066.wav	əəə… tʰi˩˥, | le˧-bi˩-dʑo˩ | <ʈʂʰ… ʈʂʰ…> õ˧tʰv̩˧-ʑi˥-ki˩ bi˩-kv̩˩-ze˩-mæ˩! | tʰv̩˧-ʑi˥-ki˩ | tʰi˩˥ | pɤ˩jɤ˧-qo˥ho˩ pɤ˩~pɤ˩! |
crdo-NRU_Naissance_du_Lac_V3_Lake3_S021.wav	tʰi˩˥, | ɖɯ˧-ɲi˥-dʑo˩, | hɯ˧-ɲi˥-tsɯ˩ ◊ -mv̩˩. | ɑ˩ʁo˧-hĩ˧-ɳɯ˩! |
crdo-NRU_F4_FOOD_SHORTAGE_FoodShortageS008.wav	<ə˧mi˧…> ə˧mi˧-lɑ˧ | mv̩˩-lɑ˥ | le˧-tɕʰo˥~tɕʰo˩ hɯ˩ ◊ -dʑo˩, | ʐɤ˩mi˩-qo˥ | <ʈʂʰɯ˧-qo˧> [tʰv̩˧qo˧]! | tʰi˩˥, | di˩li˩-ʁo˩bv̩˥ ʈʂʰɯ˩, | ʈʂʰɯ˧-qo˧ li˧, | ɖɯ˧-pʰæ˧ tʰi˧-di˥-tsɯ˩ ◊ -mv̩˩! | ʈʂʰɯ˧-qo˧ li˧, | ɖɯ˧-pʰæ˧ tʰi˧-di˥-tsɯ˩ ◊ -mv̩˩!
crdo-NRU_F4_ELDERS3_Elders3S009.wav	"ə˧lɑ˧-ʁwɤ˧ dzi˩, | njæ˧sɯ˩kv̩˩ | tʰi˩˥, | əəə… njɤ˧ | ə˧ʑi˧-ʈʂʰɯ˥-dʑo˩ | tʰi˩˥, |
			mmm… lɑ˧tʰɑ˧di˧-ɳɯ˥ | le˧-tsʰɯ˩. |"
crdo-NRU_F4_HOUSEBUILDING2_HOUSEBUILDING2_S118.wav	hĩ˧=ɻæ˧ mv̩˧di˧-qo˥-dʑo˩ | tʰi˩˥, | le˧-tsʰi˧, | dʑɯ˩-ʈʂʰɯ˥-dʑo˩, | ʂe˧ mɤ˧-dzɯ˥ | tʰɑ˧-ɲi˥ tsɯ˩-mv̩˩! |
crdo-NRU_F4_COMING_OF_AGE2_F4_ComingOfAge2S010.wav	dʑi˧hṽ˧ le˧-hwæ˧! | mmm… mv̩˩zo˩ ɲi˥ F | pi˧-dʑo˩, | ə˧ʝi˧-ʂɯ˥ʝi˩, | əəə… ʈʰæ˧qʰwɤ˧ ɲi˧-ɭɯ˧ hwæ˥-kv̩˩-ze˩-mæ˩! |
crdo-NRU_F4_FOOD_SHORTAGE_FoodShortageS003.wav	"hɑ˧ ʐwɤ˩, | hɑ˧ ʐwɤ˩-dʑo˩ | tʰi˩˥, | ""ə˧mi˧! | ə˩-sɯ˧kv̩˥ | hɑ˧ ʐwɤ˩, | qʰɑ˩ne˩ ʝi˥-bi˩?"" | pi˧-dʑo˩, |"
crdo-NRU_F4_MUSHROOMS_MUSHROOMS_S077.wav	tʰi˩˥, | ə˧ʝi˧-ʂɯ˥ʝi˩-dʑo˩, | ʈʂʰæ˧ɣɯ˧ F | mɤ˧-dʑo˧! | mo˧-ɳɯ˥ | le˧-dv̩˩-dʑo˩! |
crdo-NRU_F4_DOG2_Dog2S092.wav	ɖʐv̩˧nɑ˥mi˩ | ʈʂʰɯ˧-dʑo˩, | ʁɑ˩ʂɯ˧, | ɖɯ˧-pi˧˥ | tʰi˧-ɲi˥-ho˩-mæ˩! |
crdo-NRU_Mariage_De_La_Soeur_V3_Sister3_S133.wav	"ʈʂʰɯ˧-ʑi˥ | to˩mi˩-ki˥, | <ɑ˩ʁo˧-kʰi˧ | tʰi˧-hĩ˧˥ ◊ -kwɤ˩tɕɯ˩,> [ɑ˩ʁo˧
			kʰi˧-qo˩ tʰv̩˩ | ], «æ˧hi˩hi˩! | sɯ˧kʰɯ˩ | ə˧v̩˧˥ | le˧-ʝi˩-ze˩!» | pi˧-kwɤ˩tɕɯ˩-lɑ˩,
			|"
crdo-NRU_F4_HOUSEBUILDING2_HOUSEBUILDING2_S201.wav	tʰi˩˥, | ɬi˩bi˩-lɑ˥ | ʂæ˩ɻ̃˩ tɕɤ˥-kv̩˩-ze˩! |
crdo-NRU_Mariage_De_La_Soeur_V3_Sister3_S041.wav	ʐɯ˧ pʰv̩˧˥ ◊ -dʑo˩ | tʰi˩˥, kɤ˧kɤ˩, | əəə… ɖɯ˩-hĩ˩ ʈʂʰɯ˥-tɕi˩-ki˩, | wɤ˩˥ | ʐɯ˧ ɖɯ˧-qʰwɤ˧˥; | ɖɯ˧-qʰwɤ˧˥, | ɖɯ˧-qʰwɤ˧˥, | ɖɯ˧-qʰwɤ˧˥, | ɖɯ˧-qʰwɤ˧-ɳɯ˥ | ɖɯ˧-pʰv̩˧˥, | wɤ˩˥ | ʈʂʰɯ˧ ə˧mv̩˩-ki˩ | ʐɯ˧ ɖɯ˧-qʰwɤ˧ tʰi˥-pʰv̩˩-tsɯ˩ ◊ -mv̩˩. |
crdo-NRU_F4_MOUNTAINS_F4_MountainsS028.wav	əəə… tʰi˩˥, | <pv… æ˩˥ | ɖɯ˧-ʁ…> ʈʂʰɯ˧ne˧-ʝi˥, | si˧! | si˧-qæ˧do˧ | ʈʂʰɯ˧-bv̩˧-mi˧ ɖɯ˧-ɭɯ˧-hĩ˧-ʈʂʰɯ˧, ◊ ə˩-gi˩! |
crdo-NRU_F4_MOUNTAINS_F4_MountainsS107.wav	mv̩˩-lo˥ʝi˩ ɲi˩-pi˩-hĩ˩-tʰv̩˩-v̩˩! | tʰv̩˧ dzi˧-hĩ˥ tʰv̩˩-qo˩-dʑo˩ | tʰi˩˥, | ə˧ʝi˧-ʂɯ˥ʝi˩, | dʑɤ˩˥ | ɖɯ˩-ɲi˥-mæ˩! |
crdo-NRU_F4_MUSHROOMS_MUSHROOMS_S074.wav	"tʰi˧-kʰɯ˧˥, | tʰi˧-tɕɤ˧˥ ◊ -dʑo˩ | tʰi˩˥, | ʈʂʰɯ˧-qo˧, | <mo˧˥, | əəə…> kv̩˧ | tʰi˧-kʰɯ˧˥, | tʰi˧-tɕɤ˧˥ ◊ -kwɤ˩tɕɯ˩-lɑ˩, | kv̩˧-ɳɯ˩, | <ʂɯ˩-hṽ…> ʈʂʰɯ˧ | næ˩-qʰæ˥ʈʂʰe˩ mɤ˩-gv̩˩-pi˩, | ""wɤ˩˥ | ʈʂʰɯ˧-ɲi˧ | mo˧˥ | dʑɤ˩-ho˥! | ə˧-sɯ˩kv̩˩, | tɕɤ˧-tsɑ˥-ɲi˩!"" | pi˧. | tʰi˩˥, | le˧-tɕɤ˧˥, | le˧-dzɯ˥-dʑo˩, | hĩ˧ | dv̩˩-mɤ˩-kv̩˥-mv̩˩. |"
crdo-NRU_AGRICULTURAL_ACTIVITIES_Agriculture_S017.wav	le˧-ʐwæ˧-se˥ | tʰi˩˥, | əəə… dʑɯ˧ le˧-kʰɯ˧˥; |
crdo-NRU_Mariage_De_La_Soeur_V3_Sister3_S085.wav	"hɯ˧, | hɯ˧-dʑo˩ | tʰi˩˥, | ""ə˧mi˧! | õ˧ go˧mi˥-ʈʂʰɯ˩-dʑo˩, | ʈʂʰɯ˧ne˧-ʝi˥ | ɖɯ˧-ʑi˩-ki˩ tʰv̩˩-ɲi˩-ho˩! | <õ˧=ɻ̍˥> [wo˧=ɻ̍˩] | go˧mi˧ | õ˧ do˧˥, | mmm… zo˩no˥, | dzɑ˧-ʝi˧ | ʐwæ˩-ze˥!"" |"
crdo-NRU_F4_FUNERAL_F4_FUNERAL_S087.wav	<qo˩ho˧-qo˥… |> qo˩ho˧ po˥-jo˩-kv̩˩-mæ˩! qo˩ho˧-qo˥ | tʰi˧-kʰɯ˧˥! |
crdo-NRU_F4_HOUSEBUILDING2_HOUSEBUILDING2_S330.wav	tʰi˩˥, | dʑɤ˩tsʰo˧ bi˧-kv̩˧-ze˥ mæ˩! |
crdo-NRU_F4_FOOD_SHORTAGE_FoodShortageS032.wav	dzɯ˧-di˧˥ | dʑo˧-ze˧!
crdo-NRU_F4_FUNERAL_F4_FUNERAL_S096.wav	tʰi˩˥, | tsʰe˩qʰv̩˩<-hɑ̃˥>[-ɲi˩˥] | le˧-qæ˧-bi˧-ho˥, | pi˧-dʑo˩ | tʰi˩˥, | əəə… tsʰe˩ŋwɤ˩-ɲi˩-ɳɯ˥, | ʈæ˧bɤ˧ ʁɑ˧ʂe˩-kv̩˩-ze˩! |
crdo-NRU_F4_HOUSEBUILDING2_HOUSEBUILDING2_S028.wav	əəə… ʂwæ˩gv̩˩-ki˥-ɳɯ˩, | <mv̩˩tɕo˧ qwæ˧…> mv̩˩tɕo˧ gv̩˩ | le˧-po˧-bi˥, | tʰi˩˥, | si˧tʰv̩˧-ki˧ tʰv̩˧! |
crdo-NRU_F4_FOOD_SHORTAGE_FoodShortageS020.wav	tʰi˩˥, | hwɤ˧tɕi˥ | le˧-tɕɤ˧˥! | pɤ˩jɤ˧ gv̩˥-ɲi˩-tsɯ˩ ◊ -mv̩˩!
crdo-NRU_F4_FOOD_SHORTAGE_FoodShortageS071.wav	le˧-gv̩˩, | le˧-gv̩˩-se˩-dʑo˩ | tʰi˩˥, | no˧˥, | wɤ˩˥ | v̩˧-qo˩ | le˧-tɕɤ˧˥! | lwɤ˩ tʰi˥-kʰɯ˩ | tɕɤ˧-kv̩˥-mæ˩, | ə˧ʝi˧-ʂɯ˥ʝi˩! |
crdo-NRU_F4_COMING_OF_AGE2_F4_ComingOfAge2S035.wav	tʰv̩˧-v̩˧-ɳɯ˩, | ki˩-kv̩˩-ze˥-mæ˩! | ʈʰæ˧qʰwɤ˧ tʰi˧-sɯ˧-kʰɯ˧˥! |
crdo-NRU_F4_HOUSEBUILDING2_HOUSEBUILDING2_S235.wav	"tʰi˩˥, | hæ˧-bv̩˧ | v̩˩tsʰɤ˧ hwæ˥-dʑo˩, | ""hæ˧-bv̩˧ | v̩˩tsʰɤ˧˥, | hwæ˧ mɤ˧-ɖo˧, | qʰæ˧ tʰi˩-kʰɯ˩-ɲi˩!"" | pi˧-zo˩! |"
crdo-NRU_F4_HOUSEBUILDING2_HOUSEBUILDING2_S085.wav	hṽ̩˩-hĩ˩-qo˥ | lo˧qo˧ kwɤ˩! | lo˧qo˧-ɳɯ˧ | wɤ˩˥ | <gɤ˩tɕo˧ kwɤ˧˥!> [gɤ˩tɕo˧ gɤ˧˥!] | wɤ˩˥ | ko˧ ɖɯ˧-ɭɯ˧ ʈʰæ˧qo˩ kwɤ˩! |
crdo-NRU_F4_FOOD_SHORTAGE_FoodShortageS080.wav	õ˧ʈʂʰɯ˧ne˧-ʝi˥… | <tʰi˧-tɕ… əəə…> zo˩no˥, | ɲi˧-bæ˧ dʑo˧-kv̩˧˥ ◊ -mæ˩! |
crdo-NRU_F4_COMING_OF_AGE2_F4_ComingOfAge2S050.wav	tʰi˩˥, | tʰv̩˧-v̩˧-ki˧ | ɬo˧pv̩˥ | le˧-ti˩-se˩-dʑo˩ | tʰi˩˥, | gɤ˧lɑ˧-ʑi˩-qo˩ bi˩! |
crdo-NRU_F4_CARAVANS_CaravansS282.wav	"ʈʂʰɯ˧ | wɤ-ɕjɤ-ɕjɤ!! | pi˧-kwɤ˩tɕɯ˩-lɑ˩, | ʐwæ˧-ʈʂʰɯ˧ | õ˧-bv̩˥-õ˩
			le˩-jo˩-kv̩˩-mæ˩! |"
crdo-NRU_Mariage_De_La_Soeur_V3_Sister3_S093.wav	so˩ɲi˩-so˩hɑ̃˥ | qæ˧˥ ◊ -dʑo˩ | tʰi˩˥, | le˧-qæ˧˥, | mv̩˩-mɤ˩-tʰɑ˥! |
crdo-NRU_F4_FOOD_SHORTAGE_FoodShortageS073.wav	dʑɯ˧-qo˧-ɳɯ˧ | le˧-ʈʂʰæ˥, | le˧-ʈʂʰæ˥, | le˧-ʈʂʰæ˥, | le˧-ʈʂʰæ˥-dʑo˩ | tʰi˩˥, | pʰv̩˩-tɕæ˥ɻæ˩-gv̩˩<-ze˩>-kv̩˩-ze˩-mæ˩! | kʰɯ˧ tsɤ˧-kv̩˧-ze˥-mæ˩! |
crdo-NRU_F4_FOOD_SHORTAGE2_FOOD_SHORTAGE2S019.wav	<tʰv̩˧-ni˧ ʝi˥, | wɤ˩˥, | tʰi˩˥, | > tɕʰi˧-bi˧-pi˧-zo˥, | hɯ˧-ɲi˥-tsɯ˩ ◊ -mv̩˩!
crdo-NRU_F4_COMING_OF_AGE2_F4_ComingOfAge2S058.wav	ɬo˧pv̩˥ | le˧-ti˩-dʑo˩ | tʰi˩˥, | ɖɯ˧-tɑ˧˥… | ə˧mi˧, | ə˧mi˧-tɕi˩, | ə˧mi˧-ɖɯ˩, | mmm… ə˧v̩˧-ɖɯ˧˥, | ə˧v̩˧-tɕi˥, | ɖɯ˧-tɑ˧˥ F -ki˩ | ɬo˧pv̩˥ | le˧-ti˩, | tʰv̩˧-ɲi˧-dʑo˩ | tʰi˩˥, | tʰv̩˧-ki˧, | ŋv̩˧ | ɖɯ˧-tɑ˧˥ F | ki˧-kv̩˧-ze˥-mæ˩! |
crdo-NRU_Mariage_De_La_Soeur_V3_Sister3_S018.wav	go˧mi˧ | tʰi˧-ki˧-hĩ˧ ʈʂʰɯ˧-ʑi˥ | ɑ˩ʁo˧ hɯ˧-tsɯ˧˥ ◊ -mv̩˩. |
crdo-NRU_F5_HINAMI_F5_SONG_HINAMIS006.wav	ə˧ɖo˧, | wo˧=læ˩, le˧-tɕʰo˥~tɕʰo˩-lɑ˩, | se˧-lɑ˩ | mɤ˧-se˥ | mɤ˧-ɳv̩˧~ɳv̩˧! | se˧-lɑ˩ | mɤ˧-se˥ | mɤ˧-ɳv̩˧~ɳv̩˧, jɤ! |
crdo-NRU_Mariage_De_La_Soeur_V3_Sister3_S043.wav	gɤ˩-ʑi˥, | zo˩no˥, | «no˧ ʈʰɯ˩! | njɤ˧ ʈʰɯ˩!» | pi˧-zo˩, ◊ ə˩-gi˩! | ʈʰɯ˩-ho˩˥ ◊ -dʑo˩ | tʰi˩˥, | ʈʂʰɯ˧ ə˧mv̩˩-ɳɯ˩, | gɤ˩-ʑi˥-tsɯ˩ ◊ -mv̩˩!
crdo-NRU_F4_DOG2_Dog2S104.wav	tʰi˩˥, | no˩-tɑ˩kɤ˥, | kõ-tõ, kõ-tõ! pi˧, | ɖʐv̩˧ | dʑɤ˩pi˧ | dʑo˩-mɤ˩-kv̩˥! | di˧qo˧-gɤ˧! |
crdo-NRU_F4_CARAVANS_CaravansS040.wav	"ĩ˧! | sɯ˧pʰi˧-ɳɯ˧ | ʐwæ˧ tɕɯ˩-pv̩˩-kʰɯ˩! | tʰi˩˥, | gi˩˥ ◊ -dʑo˩, | sɯ˧pʰi˧-ʐwæ˧ |
			ɖɯ˧-ʈʂæ˧ tɕɯ˥! |"
crdo-NRU_F4_HOUSEBUILDING2_HOUSEBUILDING2_S054.wav	hĩ˧ | dʑɤ˩˥… | dʑɯ˩-ɳɯ˥, | tso˧qwɤ˧-qo˧-ɳɯ˧ | gv̩˩-kv̩˩-ze˥ mæ˩! | mv̩˩pʰæ˧-ɳɯ˧, | gv̩˩-kv̩˩-ze˥ mæ˩! |
crdo-NRU_F4_MOUNTAINS_F4_MountainsS012.wav	di˧qo˧ mɤ˧-dʑo˧-hĩ˧ F | ʈʂʰɯ˧ | dʑo˧!
crdo-NRU_F4_DOG2_Dog2S106.wav	õ˧ʈʂʰɯ˧-dʑo˩, | ə˧ʝi˧-ʂɯ˥ʝi˩, | ɖʐv̩˧nɑ˥mi˩-ʈʂʰɯ˩-dʑo˩, | zo˩no˥, | zɯ˧~zɯ˧ | ʂæ˧-hĩ˧ | dʑɤ˩-kʰwɤ˧ ɖɯ˧-ɲi˥-tsɯ˩ ◊ -mv̩˩!
crdo-NRU_F4_FOOD_SHORTAGE_FoodShortageS044.wav	tɕʰi˧-ʈʂʰɯ˧, | le˧-ti˩, | le˧-ti˩, | le˧-ti˩, | le˧-ti˩, | tʰi˩˥, | wɤ˩˥ | ʈʂʰɯ˧ne˧-ʝi˥ | le˧-pʰi˧! |
crdo-NRU_Naissance_du_Lac_V3_Lake3_S045.wav	bi˧bv̩˥ | le˧-tsʰɯ˩-ɲi˩-tsɯ˩ ◊ -mv̩˩!
crdo-NRU_F4_CARAVANS_CaravansS094.wav	"ə˧ʝi˧-ʂɯ˥ʝi˩, | ə˧mi˧=ɻæ˩-dʑo˩ | tʰi˩˥, | sɑ˧, | hæ̃˧qʰv̩˥-dʑo˩, | ʝi˧kʰv̩˥, | ʑi˧
			le˧-ŋv̩˩, le˧-ŋv̩˩, | tohõ! pi˧, | wɤ˩˥ | sɑ˧ le˧-ɲi˩, | le˧-ɲi˩, | wɤ˩˥ | ʈʂʰɯ˧ne˧-ʝi˥ |
			le˧-ɲi˩! |"
crdo-NRU_F4_MOUNTAINS_F4_MountainsS122.wav	"""nɑ˩tsʰi˩˥ | tɕʰɤ˧pɤ˧-mi˧, | qv̩˧ɻ̍˧-ʈʂʰæ˧nɑ˥!"" | pi˧. |"
crdo-NRU_Naissance_du_Lac_V3_Lake3_S038.wav	« ə˧-sɯ˩kv̩˩, | ʈʂʰɯ˧ | qʰɑ˩ne˩ gv̩˩˥ | se˩-kʰɯ˩-zo˩… | m, dʑi˧mi˧-po˩-ɳɯ˩ | ʈɤ˧-bi˧ », | pi˧-zo˥, |
crdo-NRU_F4_MOUNTAINS_F4_MountainsS131.wav	tʰv̩˧ | <ɖɯ˧-pʰo˧ ʝi˧-zo˥> [ɖɯ˧pʰo˧ le˧-tsʰɯ˧˥] | tʰi˩˥, | qv̩˧ɻ̍˧ kʰi˧, | ʐɤ˩mi˩ kʰi˥, | tʰv̩˧qo˧ | tʰi˧-ʈʰi˩-ɲi˩-tsɯ˩ ◊ -mv̩˩!
crdo-NRU_Naissance_du_Lac_V3_Lake3_S044.wav	dʑi˧mi˧ | gv̩˧-wo˥ po˩-ɳɯ˩ | le˧-ʈɤ˧ | le˧-ʈɤ˧ | le˧-ʈɤ˧ | le˧-ʈɤ˧-kwɤ˧tɕɯ˥-lɑ˩, | tʰi˩˥, |
crdo-NRU_F4_CARAVANS_CaravansS093.wav	"""ho˧di˧, pʰi˩ tɕʰɯ˩-jɤ˩; | ɬɑ˧sɑ˧, zo˧ tɕʰɯ˩-jɤ˩!"" -pi˩, | æ˧ʂæ˧-tɑ˩mv̩˩! |"
crdo-NRU_F4_MOUNTAINS_F4_MountainsS146.wav	ɲi˧tsi˧ŋwɤ˧-ɲi˧ | ɖɯ˧-ɲi˥! | so˧-ɬi˧mi˧, | əəə… tsʰe˩ŋwɤ˩-ɲi˥ | ɖɯ˧-ɲi˥! |
crdo-NRU_F4_FUNERAL_F4_FUNERAL_S015.wav	qʰɑ˩ne˩˥ | hĩ˧… | tsɯ˧-tso˧-ɲi˥! |
crdo-NRU_F4_SEEDS_SeedsS060.wav	õ˧ʈʂʰɯ˧ne˧-ʝi˥… | æ˧ʂæ˧-tɑ˩mv̩˩, | ʈʂʰɯ˧ne˧-ʝi˥ | dʑo˧-ɲi˥ ◊ -mæ˩! |
crdo-NRU_Mariage_De_La_Soeur_V3_Sister3_S111.wav	nɑ˩˥, | pi˧, | ɬi˧di˩-di˩mi˩-hĩ˩, | pi˧-hĩ˧-ʈʂʰɯ˧-dʑo˩, | tʰi˩˥, |
crdo-NRU_F4_FUNERAL_F4_FUNERAL_S004.wav	tʰi˩˥, | dzi˧~dzi˩ | fv̩˩bi˩˥, | pi˧-hĩ˧, | ʁwɤ˧-qo˧ pi˧-hĩ˧ | ʈʂʰɯ˧-dʑo˩ | tʰi˩˥, | tʰv̩˧-so˩-dʑo˩, | ʈʂʰɯ˧ | zo˧mv̩˥, | əəə… zo˧mv̩˥-ɳɯ˩, | zo˧-ɳɯ˩, | zo˧ dʑo˧-hĩ˥-dʑo˩, | zo˧-ɳɯ˩, | ɖɯ˧-ʑi˩~ɖɯ˩-ʑi˩, | ɑ˩ʁo˧ | ɬo˧pv̩˥ ti˩! |
crdo-NRU_F4_HOUSEBUILDING2_HOUSEBUILDING2_S305.wav	ə˧tso˧ po˧-tsʰɯ˧-ɻ̩˥, | gɤ˩qwɤ˥ | ʈʂʰɯ˧ne˧-ʝi˥ | tʰi˧-tɕɯ˥, | tʰi˧-tɕɯ˥, | tʰi˧-tɕɯ˥! |
crdo-NRU_F4_FUNERAL_F4_FUNERAL_S079.wav	zo˩no˥, | ə˧dɑ˧-ə˧mi˧=ɻæ˧-ɳɯ˥, | zo˧mv̩˥=ɻæ˩, | <m…> zo˩no˥, | mɤ˧-sɯ˧-hĩ˧-ki˧, | ʈʂʰɯ˧ne˧-ʝi˥ | ʐwɤ˩-kv̩˩˥ ◊ -mæ˩! |
crdo-NRU_F5_HINAMI_F5_SONG_HINAMIS003.wav	ə˧ɖo˧, | wo˧=læ˩, le˧-tɕʰo˥~tɕʰo˩-lɑ˩, | se˧-lɑ˩ | mɤ˧-se˥ | mɤ˧-ɳv̩˧~ɳv̩˧! |
crdo-NRU_F4_CARAVANS_CaravansS147.wav	"ʈʂʰɯ˧-gɤ˧ bæ˧˥ ◊ -ki˩, | tʰv̩˧-mv̩˧ bæ˧˥ ◊ -ki˩, | ə˧mi˧! | ʈʂʰɯ˧-qo˧… | gæ˧ɻæ˩-hĩ˩
			<ɖɯ…> ʝi˩kʰv̩˩-hɯ˩-tsɯ˩, | le˧-tsʰɯ˩-ə˩-hɯ˩?"" | pi˧, | wɤ˩˥ | le˧-bæ˧˥, |
			ə˧mi˧=ɻæ˩ | wɤ˩˥ | mv̩˩do˩-bi˩-zo˩-kv̩˥!"
crdo-NRU_F4_HEALING_HealingS097.wav	- dzɯ˩nɑ˩mi˩-ʁo˥ | mɤ˧-bi˧! |
crdo-NRU_F4_HOUSEBUILDING2_HOUSEBUILDING2_S178.wav	tʰi˩˥, | əəə… | dɑ˧-kv̩˥-ze˩! | tʰi˩˥, | ʑi˧mi˧ dɑ˧˥ | ɖɯ˧-ɲi˥-dʑo˩ | tʰi˩˥, | ʐɯ˩tsɯ˧ ʈʂɤ˧-bi˧-kv̩˧-ze˥! |
crdo-NRU_AGRICULTURAL_ACTIVITIES_Agriculture_S091.wav	tʰi˩˥, | bɑ˩lɑ˩˥ | le˧-ʐv̩˧˥, | mv̩˧-kv̩˧˥ | mæ˩! |
crdo-NRU_AGRICULTURAL_ACTIVITIES_Agriculture_S092.wav	nɑ˩-bv̩˧ | hɑ˧-dʑo˩, | ə˧ʝi˧-ʂɯ˥ʝi˩-dʑo˩, | əəə… <sɑ˧> [wo˩] ɲi˥-kv̩˩, -tsɯ˩ ◊ -mv̩˩!
crdo-NRU_F4_ELDERS3_Elders3S043.wav	njɤ˧ | ə˧ʑi˧˥ | le˧-ʂɯ˧, | njɤ˧ | ʈæ˧ʂɯ˧ ◊ -læ˧… | zo˩no˥, | njɤ˧ | ʈæ˧ʂɯ˧-ʈʂʰɯ˧ | kɤ˧ʈʂo˧ so˩-ɳɯ˩, | ə˧ʑi˧˥ | le˧-ʂɯ˧-ɲi˥! | kɤ˧ʈʂo˧ so˩-ɳɯ˩ | le˧-ʂɯ˧! | hõ˩tsʰi˧-lɑ˥ | qʰv̩˧-kʰv̩˥! |
crdo-NRU_F4_FUNERAL_F4_FUNERAL_S171.wav	do˩˥ ◊ -dʑo˩, | ə˧mi˧! | ʁwɤ˧-qo˧ | ɖɯ˧-tɑ˧˥ | le˧-ʁɑ˥ʂe˩; | bo˩ʈʂʰæ˧! | nɑ˩-ʈʂʰɯ˥-dʑo˩, | bo˩ʈʂʰæ˧-ʈʂʰɯ˩, ◊ ə˩-gi˩! | no˧ | ə˧mɑ˧-bv̩˧ | ə˩-do˩˥? |
crdo-NRU_F4_HEALING_HealingS037.wav	dʑɯ˩tsʰi˩-qo˥-mv̩˩, | ʈʂʰɻ! pi˧ | tʰi˧-kʰɯ˧˥! | dɑ˧pɤ˧ | tʰv̩˧-v̩˧-ɳɯ˩ | gɤ˩-ʈʂwɤ˧-kwɤ˧tɕɯ˥, |
crdo-NRU_F4_CARAVANS_CaravansS028.wav	əəə… ho˧di˧ hɯ˧-hĩ˧, | ʁo˧ni˥ hwæ˩-kʰɯ˩-bi˩! | pi˧. | əəə… se˧kʰɯ˩-ʁo˩ni˩! |
crdo-NRU_F4_CARAVANS_CaravansS071.wav	jɤ˧ŋɤ˧-dʑo˥ | tʰi˩˥, | zo˩qo˧ ɲi˩? | zo˩no˥ | ʐwɤ˩˥ ◊ -dʑo˩ | njɤ˧ F | mɤ˧-sɯ˥! |
crdo-NRU_F4_HOUSEBUILDING2_HOUSEBUILDING2_S339.wav	kɯ˧ʈʂʰwɤ˩ tʰi˩-ki˩. | ʐɯ˧ | tʰi˧-ki˧! | kwæ˧tsɯ˧ qʰæ˧! | si˧ʁo˧-si˧ɭɯ˧ dzɯ˧! |
crdo-NRU_AGRICULTURAL_ACTIVITIES_Agriculture_S035.wav	wɤ˩˥ | le˧-ʐwæ˩~ʐwæ˩-se˩, | wɤ˩˥ | dʑɯ˧ | le˧-kʰɯ˧˥! |
crdo-NRU_F4_FOOD_SHORTAGE_FoodShortageS009.wav	"""ə˧mi˧! | njɤ˧ mv̩˩! | ə˩zɯ˩˥, | <m…n…> no˧ | tɕʰi˧-mɤ˧-bi˧-ze˧! | ə˧mɑ˧-ɳɯ˧ | le˧-wo˧-le˧-ʂv̩˧-le˧-po˧-bi˥-ze˩!"" |"
crdo-NRU_F4_TIGER2_Tiger2S012.wav	"""mɤ˧-dɑ˩! | njɤ˧ zo˧! F | ə˩zɯ˩˥… | ʈʂʰɯ˧-dʑo˩, | æ˧ʂæ˧-tɑ˩mv̩˩-dʑo˩ | dʑo˧-ɲi˥-mæ˩!"" |"
crdo-NRU_AGRICULTURAL_ACTIVITIES_Agriculture_S102.wav	"""nɑ˩-hɑ˧-dʑo˩, | wo˩˥! | nɑ˩-dʑi˧-dʑo˩, | sɑ˧!"" | pi˧, | æ˧ʂæ˧-tɑ˩mv̩˩; | njæ˧-sɯ˩kv̩˩, | zo˩no˥, | le˧-ʂɯ˧-dʑo˥, | tʰv̩˧ mv̩˧-ʂɯ˧-kwɤ˧tɕɯ˥-lɑ˩, | sɑ˧ | mɤ˧-dʑo˧ | mɤ˧-tʰɑ˧-ɲi˥-wɤ˩! |"
crdo-NRU_F4_DOG2_Dog2S091.wav	le˧-ʑi˧ŋv̩˥-dʑo˩ | tʰi˩˥, | zɯ˧~zɯ˧ | tɕi˩-kʰwɤ˩-lɑ˥ ɖɯ˩-ɲi˩-kv̩˩-tsɯ˩ ◊ -mv̩˩!
crdo-NRU_F4_HOUSEBUILDING2_HOUSEBUILDING2_S253.wav	ə˧mi˧=ɻæ˩ ɳɯ˩, | ɑ˩ʁo˥ | 'ə˧mi˧ õ! | tsʰi˧ʝi˧-dʑo˩, | ʑi˧qʰwɤ˧ dɑ˧-tso˧ ɲi˥ õ!' | pi˧. |
crdo-NRU_F4_MUSHROOMS_MUSHROOMS_S101.wav	tʰi˩˥, | so˩˥ | ɖwæ˧˥ | so˩-kv̩˩-ɲi˥, | ʈʂʰɯ˧ | <mo˧…> mo˧ɖʐv̩˥-ʈʂʰɯ˩! |
crdo-NRU_F4_HEALING_HealingS001.wav	ə˧ʝi˧-ʂɯ˥ʝi˩-dʑo˩, ◊ ə˩-gi˩! | hĩ˧-ʈʂʰɯ˧ | ɖɯ˧-ʑi˩=ɻ̍˩-ʈʂʰɯ˩-dʑo˩, | hĩ˧-ʈʂʰɯ˧ | le˧-go˩, | le˧-go˩, | le˧-go˩, | <le˧…> le˧-go˩-dʑo˩, | tʰi˩˥, | kʰv̩˧tɕʰi˥ | mɤ˧-dʑo˧-ɲi˥-tsɯ˩ ◊ -mv̩˩!
crdo-NRU_F4_CARAVANS_CaravansS181.wav	kʰv̩˧mæ˧ | ɖɯ˧-tɑ˧˥ | le˧-ʈʂæ˧-po˥-hɯ˩-ɲi˩! |
crdo-NRU_F4_HOUSEBUILDING2_HOUSEBUILDING2_S127.wav	dʑɯ˩-dʑo˥ | tʰi˩˥, | gɤ˩-dzɤ˥-ɳɯ˩ | ə˧zɯ˩ | <æ…> ʁo˧dɑ˧ | ɖɯ˧-ʂɯ˩ ʐwɤ˩-dʑɯ˩. |
crdo-NRU_F4_CARAVANS_CaravansS234.wav	"ɖæ˩mi˧-sɯ˩pʰi˩-ki˩ ki˩-dʑo˩ | tʰi˩˥, | njɤ˧ | ə˧v̩˧-ɳɯ˥: | ""mɤ˧-bi˧-ze˧! | njɤ˧,
			əəə… | ɖæ˩mi˧-sɯ˩pʰi˩ | hĩ˧ F | ʝi˧-mɤ˧-bi˧!"""
crdo-NRU_F4_FUNERAL_F4_FUNERAL_S143.wav	tʰi˩˥, | əəə… ʂɯ˧-ɲi˧-ɳɯ˩, ɖɯ˧-ʂɯ˩, | ɖɯ˧-ʂɯ˩, | ɖɯ˧-ʂɯ˩-ɳɯ˩… | ʐv̩˧tsʰi˩-lɑ˩ | gv̩˧-hɑ̃˩! |
crdo-NRU_F4_ELDERS3_Elders3S062.wav	"""<lɑ˧tʰɑ˧mi˥> [lɑ˧tʰɑ˧mi˧=ɻ̍˥], | əəə…"" ə˧mi˧-pv̩˩ʈʰɯ˩ | pi˧-kv̩˩-mæ˩, | njɤ˧ | ə˧ʑi˧-ʈʂʰɯ˧-dʑo˩, |"
crdo-NRU_F4_HOUSEBUILDING2_HOUSEBUILDING2_S173.wav	"tʰi˩˥, | ""ə˧ʝi˥-dʑo˩, | dʑɯ˩nɑ˩mi˩-ʁo˩˥ | qæ˧do˧… tɕʰo˧-kʰi˥-ɲi˩!"" | pi˧-kv̩˩. |"
crdo-NRU_F4_CARAVANS_CaravansS265.wav	"""dʑi˧hṽ̩˥ | le˧-tɑ˧˥, | ə˧v̩˧-hĩ˥ | mv̩˧-di˩ dʑo˩-kv̩˩!"" |"
crdo-NRU_AGRICULTURAL_ACTIVITIES_Agriculture_S075.wav	ə˩kʰɯ˩-pi˥-zo˩, | ɬi˩bi˩ mɤ˩-ɲi˥-zo˩, | ʈʂʰɯ˧-hwɤ˧~hwɤ˧-hĩ˧ ʈʂʰɯ˧-ʁo˥! | dʑo˧-ɲi˥! |
crdo-NRU_F4_COMING_OF_AGE2_F4_ComingOfAge2S044.wav	tʰi˩˥, | ʁo˧dɑ˧ ʈʂʰɯ˧-qo˧-dʑo˧, | <ʂe˧bæ˧> [ŋv̩˩-ʂe˩bæ˥ | ] tʰi˧-hwæ˩-kʰɯ˩! | ə˧mi˧ tʰv̩˧-v̩˧-ɳɯ˩! |
crdo-NRU_F4_FUNERAL_F4_FUNERAL_S141.wav	tʰi˩˥, | le˧-ʂɯ˧-se˩, | le˧-qæ˧-se˥, | mmm… le˧-qæ˧-se˥ | ɖɯ˧-ɲi˥-dʑo˩ | tʰi˩˥, | əəə… õ˧tʰv̩˧-so˩-dʑo˩ | tʰi˩˥, | əəə… wɤ˩˥ | tʰv̩˧-ɲi˧ | ʈæ˧bɤ˧ | ɖɯ˧-ʂɯ˩ ʁɑ˩ʂe˩-se˩-kwɤ˩tɕɯ˩-lɑ˩ | tʰi˩˥, | ʂɯ˧-ɲi˧-ɳɯ˩, | ʈæ˧bɤ˧ | wɤ˩˥ | ɖɯ˧-ʂɯ˩ ʁɑ˩ʂe˩! |
crdo-NRU_F4_FUNERAL_F4_FUNERAL_S151.wav	ʈʂʰɯ˧ne˧-ʝi˥ | ʐwɤ˩-kv̩˩-tsɯ˥ | mv̩˩! |
crdo-NRU_F4_HOUSEBUILDING2_HOUSEBUILDING2_S300.wav	əəə… zo˩no˥, | jo˧lv̩˧ kv̩˧-pi˥! | jo˧lv̩˧ kv̩˧˥, | pi˧-dʑo˩, | zo˩no˥, | hæ˧ʐwɤ˩-pi˩, | tsʰɤ˩ʝi˩-ʈʂʰɯ˥ | ɖwæ˧˥ | le˧-dʑo˧-kv̩˧ pi˥-zo˩, ◊ ə˩-gi˩! |
crdo-NRU_AGRICULTURAL_ACTIVITIES_Agriculture_S074.wav	əəə… tʰi˩˥, | ə˧tso˧-mɤ˧-ɲi˩ | dʑo˧-ɲi˥ mæ˩! | ə˩kʰɯ˩˥… | ə˩kʰɯ˩-pi˥, | no˧ | ə˧-sɯ˥ ? |
crdo-NRU_F4_FUNERAL_F4_FUNERAL_S024.wav	ʈʂʰɯ˧-kʰwɤ˥-dʑo˩ | tʰi˩˥, | hĩ˧ | le˧-mo˩-kwɤ˩tɕɯ˩-lɑ˩, | hĩ˧ | le˧-ʂɯ˧-kwɤ˧tɕɯ˥-lɑ˩, | tʰi˩˥, | tʰv̩˧-qo˧-ɳɯ˧ | tʰi˧-ʑi˧-kʰɯ˥-zo˩, | ʈʂʰæ˧~ʈʂʰæ˧-kv̩˩-mæ˩! | tʰv̩˧-qo˧-ɳɯ˧ | le˧-ʈʂʰæ˧~ʈʂʰæ˧, | gɤ˧qo˥ ʑi˩-kʰɯ˩. |
crdo-NRU_F4_MUSHROOMS_MUSHROOMS_S104.wav	tʰi˩˥, | mo˧-ʈʂʰɯ˥-dʑo˩, | zo˩no˥, | dzɯ˧-tʰɑ˩-hĩ˩ dʑo˩, | mɤ˧-tʰɑ˧-hĩ˧ dʑo˧˥! | pʰv̩˧ɖɯ˧-hĩ˥ dʑo˩! | mɤ˧-pʰv̩˧ɖɯ˧-hĩ˥ dʑo˩! | zo˩no˥! |
crdo-NRU_Naissance_du_Lac_V3_Lake3_S064.wav	ɲi˧zo˧ ʈʂʰɯ˧ | ə˧ʝi˧-ʂɯ˥ʝi˩ | ɖwæ˧˥ | tʰi˧-dʑo˩ | tʰi˩˥, | ʈʂʰɯ˧-qo˧ | le˧-tsʰɯ˩-ɲi˩, -tsɯ˩ mv̩˩. |
crdo-NRU_F4_HOUSEBUILDING2_HOUSEBUILDING2_S212.wav	mmm! tʰi˩˥, | ʈʂʰɯ˧ne˧ ʝi˥ | tʰi˧-hwæ˩-kv̩˩ mæ˩, | ɑ˩ʁo˧! | ʈʂʰɯ˧ne˧ ʝi˥, | ɖɯ˧-ʝi˧ | ɖɯ˧-ʝi˧ | ɖɯ˧-ʝi˧ | ɖɯ˧-ʝi˧ | ɖɯ˧-ʝi˧ | ɖɯ˧-ʝi˧ | tʰi˧-hwæ˩! |
crdo-NRU_F4_MUSHROOMS_MUSHROOMS_S130.wav	mo˧-ʈʂʰɯ˧, | mv̩˧tsʰi˧ kv̩˩-hĩ˩, | dzɯ˧, | pi˧-dʑo˩, | hĩ˧ F, | <ʂɯ˧-mɤ˧-kv̩˧…> dv̩˧-mɤ˥-kv̩˩-tsɯ˩-mv̩˩! |
crdo-NRU_F4_FUNERAL_F4_FUNERAL_S126.wav	ʐɯ˧hwɤ˩ pi˩-hĩ˩-ʈʂʰɯ˩-dʑo˩! |
crdo-NRU_F4_HOUSEBUILDING2_HOUSEBUILDING2_S261.wav	tʰi˩˥ | wɤ˩˥ | dʑɯ˧-qo˧ | tʰi˧-ʈɯ˧˥! | tʰi˩˥ | ɖʐo˩ bi˩-kv̩˥-ze˩!
crdo-NRU_F4_CARAVANS_CaravansS195.wav	wɤ˩˥ | ʈʂʰɯ˧ne˧-ʝi˥ | ɖɯ˧-ʂɯ˩ gv̩˩! |
crdo-NRU_F4_MUSHROOMS_MUSHROOMS_S068.wav	kv̩˧ tʰi˩-kʰɯ˩! |
crdo-NRU_F4_TIGER2_Tiger2S067.wav	mæ˧qv̩˩ ɖwæ˩, | si˧dzi˩ qʰæ˩~qʰæ˩-kv̩˩-tsɯ˩ ◊ -mv̩˩!
crdo-NRU_F4_MUSHROOMS_MUSHROOMS_S091.wav	hĩ˧ | ʈʰææ̃˧ F | hĩ˧-ʈʂʰɯ˧, | tɕi˩-hĩ˩˥ | mɤ˧-dʑo˩-zo˩! |
crdo-NRU_F4_HEALING_HealingS013.wav	ɖɯ˧-v̩˧ | mɤ˧-go˩, | ɖɯ˧-v̩˧ go˩-dʑo˩; | ə˧mi˧! ə˧tse˧ ɲi˥-hɯ˩? |
crdo-NRU_F4_HOUSEBUILDING2_HOUSEBUILDING2_S102.wav	ʈʂʰɯ˧ne˧ ʝi˥ | tʰi˧-kwɤ˩! | tʰi˩˥, | ə˧ʝi˧-ʂɯ˥ʝi˩-dʑo˩, | ʈʂo˩bo˩˥ | dʑɤ˩˥ | ti˩-mɤ˩-kv̩˥ mæ˩! |
crdo-NRU_F4_HOUSEBUILDING2_HOUSEBUILDING2_S210.wav	ʈʂʰɯ˧ne˧ ʝi˥ | ɖɯ˧-kɤ˧~ɖɯ˥-kɤ˩ le˩-tsʰɤ˩, | hæ̃˧pɤ˧ tsʰɤ˩-ne˩-ʝi˩-zo˩! |
crdo-NRU_Mariage_De_La_Soeur_V3_Sister3_S145.wav	ɑ̃! æ˧ʂæ˧-dʑo˩ | ʈʂʰɯ˧ne˧-ʝi˥ | ʐwɤ˩-kv̩˩˥ ◊ -mv̩˩!
crdo-NRU_F4_FUNERAL_F4_FUNERAL_S114.wav	əəə… mv̩˩ɬi˥ | tʰv̩˧-v̩˧-dʑo˩ | tʰi˩˥, | əəə… <ʐo˩ tʰv̩˩˥! |> zo˧ɖɯ˥ F | ʈʂʰwɤ˩ tʰv̩˩-pi˥! | <æ˧ʂæ˧…> æ˧ʂæ˧! |
crdo-NRU_F4_HOUSEBUILDING2_HOUSEBUILDING2_S167.wav	"""qwæ˧ʁo˧ | ɖɯ˧-tɕɯ˧-ɻ˧-bi˥, | qʰɑ˩jɤ˩ pʰv̩˩˥!"" | pi˧-kv̩˩-tsɯ˩-mv̩˩, | ə˧ʝi˧-ʂɯ˥ʝi˩. |"
crdo-NRU_F4_HEALING_HealingS018.wav	"ʈæ˧bɤ˧ ʁɑ˧ʂe˩, | ʈæ˧bɤ˧ ʁɑ˧ʂe˩-dʑo˩ | tʰi˩˥, | gi˩˥, | gi˩˥, | tʰi˩˥ ◊ -dʑo˩… |
			le˧-qʰwɤ˧-tsɯ˥ | mv̩˩! | ʈʂʰɯ˧ ʑi˧=ɻ̍˥-dʑo˩! |"
crdo-NRU_F4_FUNERAL_F4_FUNERAL_S050.wav	hɑ˧ | so˧-tɕʰi˧! | mv̩˩sɯ˧njɤ˧-ʈʂʰɯ˥-dʑo˩, | nɑ˩-ʈʂʰɯ˥-dʑo˩, | li˩ tɕɤ˧-kv̩˥-mæ˩! |
crdo-NRU_F4_HOUSEBUILDING2_HOUSEBUILDING2_S002.wav	qæ˧do˧, | lv̩˧mi˧, | əəə… ŋwɤ˧pʰæ˧˥! | ə˧ʝi˧-ʂɯ˥ʝi˩-dʑo˩, | gv̩˩pʰæ˩ ɲi˥ mæ˩! | gv̩˩pʰæ˩-sɯ˥ | le˧-dɑ˧˥! |
crdo-NRU_F4_HEALING_HealingS105.wav	əəə… zo˩no˧-ɳɯ˧ | le˧-so˩, | əəə… ʈʰæ˧ɻæ˩ so˩-hĩ˩-ki˩ | tʰi˧-ki˧! |
crdo-NRU_F4_COMING_OF_AGE2_F4_ComingOfAge2S028.wav	"""ɔɔ!"" pi˧, | ""no˧ | tʰi˧-hĩ˧-hõ˥!"" | ""tɤ!"" pi˧, | ""no˧ | tʰi˧-hĩ˧-hõ˥!"" | pi˧-zo˩, | to˩mi˩-pi˥ | bɑ˩lɑ˩-sɯ˥ | tʰi˧-mv̩˧-kʰɯ˧˥! |"
crdo-NRU_F4_CARAVANS_CaravansS041.wav	"tʰi˩˥, | õ˧˥ | ɖɯ˧-pi˧ dʑo˥-kwɤ˩tɕɯ˩-lɑ˩, | õ˧˥ | dɑ˧ʝi˩ | le˧-hwæ˧! | ʐwæ˧ʁo˩ |
			le˧-hwæ˧! | wɤ˩˥, | õ˧-bv̩˥-õ˩ | le˧-tɕɯ˧˥! |"
crdo-NRU_F4_MOUNTAINS_F4_MountainsS163.wav	so˧-ɭɯ˧ | tʰi˧-gv̩˩-dʑo˩, | hɑ˧ | ʈʂʰɯ˧-qo˧ | ʈʂʰɯ˧ne˧-ʝi˥ | le˧-ʈʂʰɻ̍˧˥, | ɖɯ˧-ʈʂʰɻ̍˧ tʰi˥-tɕɯ˩; |
crdo-NRU_F4_HOUSEBUILDING2_HOUSEBUILDING2_S184.wav	tsʰe˩-ŋwɤ˩ ɲi˩˥ | dɑ˧-mɤ˧-ʁo˧ | pi˧-dʑo˩, | əəə… tsʰe˩-hõ˩-ɲi˩˥! |
crdo-NRU_F4_MUSHROOMS_MUSHROOMS_S085.wav	õ˧-bv̩˥-õ˩, | v̩˩tsʰɤ˧˥ | tʰæ˧ɻæ˧ <po˧> tɕɤ˥! |
crdo-NRU_F4_MOUNTAINS_F4_MountainsS129.wav	ʈʂʰæ˧˥, | dʑɯ˩ʁo˩ dʑo˩ kv̩˥-mæ˩, ◊ ə˩-gi˩! |
crdo-NRU_F4_SEEDS_SeedsS013.wav	ʈʂʰɯ˧-qo˧-ɳɯ˧, | ʈʂʰɯ˧-dʑo˩, | ʁo˧qʰwɤ˩ pv̩˩-hĩ˩, ʈʂɤ˩-ɲi˩-tsɯ˩ ◊ -mv̩˩!
crdo-NRU_F4_FUNERAL_F4_FUNERAL_S160.wav	njæ˧=ɻ̍˩, | zo˩no˥, | əəə… hĩ˧ ʂɯ˧, | njɤ˧ | le˧-sɯ˥ | ʈʂʰɯ˧-tɕo˧ tɑ˧-ɳɯ˥, | əəə… ʐv̩˩-kv̩˩ ʂɯ˩-ze˥-mæ˩! | ʐv̩˩-kv̩˩˥! | njɤ˧ | ə˧mi˧! | mmm… njɤ˧ | ə˧mi˧! | njɤ˧ | ə˧ʑi˧˥! | njɤ˧ | ə˧v̩˧˥ | so˩-kv̩˩˥! | ŋwɤ˩-kv̩˩˥! |
crdo-NRU_F4_COMING_OF_AGE2_F4_ComingOfAge2S068.wav	ɑ˩ʁo˧ | le˧-bi˩-kwɤ˩tɕɯ˩-lɑ˩, | ʈʂʰɯ˧-ʑi˧=ɻ̍˥ | gɤ˧lɑ˧-ʑi˩-di˩, | gɤ˧lɑ˧-ʑi˩-qo˩-sɯ˩ | ɬo˧pv̩˥ | le˧-ti˩! |
crdo-NRU_F4_HOUSEBUILDING2_HOUSEBUILDING2_S281.wav	õ˧ʈʂʰɯ˧ne˧-ʝi˥-kv̩˩ mæ˩! | tʰi˩˥, | ʈʂʰɯ˧ne˧-ʝi˥-se˩-dʑo˩ tʰi˩˥, | ʑi˧qʰwɤ˧ le˧-tʰv̩˧ | ɖɯ˧-ɲi˥-dʑo˩, | dʑɯ˧ | le˧-tɕɤ˧˥, | ɳɯ˩dʑɯ˥ | le˧-ɳæ˧˥, | mmm… ʈʂʰɯ˧ne˧-ʝi˥ | se˧-dʑo˩ | tʰi˩˥, | ʑi˧qʰwɤ˧ dɑ˧-kv̩˥-ze˩! |
crdo-NRU_F4_FOOD_SHORTAGE_FoodShortageS058.wav	ɑ˩ʁo˧ ʈʂʰɯ˧-qo˧ | ə˧tso˧ mɤ˧-ɲi˩, | mv̩˩di˩-qo˥-ʈʂʰɯ˩ | mɤ˧-dʑo˧-ɲi˥-ze˩-mæ˩! | bɑ˩lɑ˩˥ | mv̩˧di˩ mɤ˩-dʑo˩! | hɑ˧ | dzɯ˧-di˧ mɤ˧-dʑo˧˥! | dzɑ˩qʰwɤ˩˥ | ki˩-di˩ mɤ˩-dʑo˩˥! |
crdo-NRU_F4_HOUSEBUILDING2_HOUSEBUILDING2_S027.wav	si˧tʰv̩˧-ki˧ | tʰv̩˧-ɲi˥-ze˩ mæ˩! |
crdo-NRU_F4_CARAVANS_CaravansS251.wav	ʐwæ˧ tɕɯ˩-zo˩-ɳɯ˩ | le˧-hwæ˧ | le˧-po˧-tsʰɯ˧-hĩ˥-lɑ˩-ɲi˩-mæ˩! |
crdo-NRU_Mariage_De_La_Soeur_V3_Sister3_S138.wav	↑bõ! bõ! pi˧, | to˩mi˩ dɑ˥-dʑo˩ | tʰi˩˥, | «ʁɑ˧-ze˧!» | pi˧, | ɬo˧pv̩˥ ti˩-kv̩˩ | -tsɯ˧˥ ◊ -mv̩˩!
crdo-NRU_F4_ELDERS3_Elders3S049.wav	zo˩no˥, | tʰæ˧ɻæ˩ so˩-ɖʐɯ˩kʰɤ˩ tʰv̩˩, | pi˧-dʑo˩, | tʰæ˧ɻæ˩ so˩. |
crdo-NRU_Mariage_De_La_Soeur_V3_Sister3_S058.wav	pʰo˩˥ ◊ -dʑo˩ | tʰi˩˥, | ʈʂʰɯ˧ go˧mi˧-dʑo˥, | «õ˧ ə˧mv̩˥ ɲi˩-ze˩», | pi˧-zo˩, | tʰi˩˥, | <mmm…>
crdo-NRU_F4_TIGER2_Tiger2S008.wav	tʰi˩˥, | lɑ˧ ɖɯ˧-pʰo˧ do˧˥ ◊ -dʑo˩ | tʰi˩˥, | ɑ˩ʁo˧ le˧-hɯ˩-dʑo˩, |
crdo-NRU_AGRICULTURAL_ACTIVITIES_Agriculture_S041.wav	ɖɯ˧-kʰv̩˧˥ | ɖɯ˧-ʂɯ˩-lɑ˩ ɲi˩ wɤ˩! |
crdo-NRU_Mariage_De_La_Soeur_V3_Sister3_S148.wav	ə˧zɯ˩ | hĩ˧-ʈʂʰɯ˧ | tɕʰo˩-ʂɯ˧-tɕʰo˩, ◊ ə˩-gi˩! | ə˧tso˧ mɤ˧-ɲi˩ | gɯ˧-ʐwɤ˧-zo˧-kv̩˧˥ ◊ -mv̩˩!
crdo-NRU_F4_SEEDS_SeedsS055.wav	tʰi˩˥, | <wwo…> wo˩-ʈʂʰɯ˥-dʑo˩, | mɤ˧-dʑo˧ mɤ˧-tʰɑ˧-ɲi˥! | wo˩-ɻæ˥ | ʈʂʰɯ˧-dʑo˩! |
crdo-NRU_F4_MUSHROOMS_MUSHROOMS_S007.wav	tʰi˩˥, | mo˧-ʈʂʰɯ˧-dʑo˩, | ə˧ʝi˧-ʂɯ˥ʝi˩ | tʰi˩˥, | dʑɯ˩ʁo˩-ʈʂʰɯ˥-dʑo˩, | zo˩no˧ ʐwɤ˧˥, | pi˧-dʑo˩, | tsɑ˩tɕi˩-pi˥! | ə˧tso˧-mɤ˧-ɲi˩, | <ʈʂwɑ˧~ʈʂwɑ˧-lɑ˧~lɑ˧-hĩ˥>[ʈʂwɑ˧~ʈʂwɑ˧-nɑ˧nɑ˧-hĩ˥] | mo˧-ʈʂʰɯ˧, | ɖɯ˧-tɑ˧˥ | tʰi˧-ɖʐɤ˧˥ ◊ -dʑo˩-mæ˩, ◊ ə˩-gi˩! |
crdo-NRU_F4_FOOD_SHORTAGE2_FOOD_SHORTAGE2S088.wav	əəə… di˩li˩-ʁo˩bv̩˥ dzɯ˩. | hwɤ˧tɕi˥-ʁo˩bv̩˩ dzɯ˩! |
crdo-NRU_F4_MOUNTAINS_F4_MountainsS088.wav	tʰi˩˥, | bæ˩dʑɯ˧ | ɖɯ˧-tɑ˧˥ | le˧-lɑ˧-tʰi˥-tɕɯ˩-kv̩˩-ze˩-mæ˩! |
crdo-NRU_F4_MUSHROOMS_MUSHROOMS_S075.wav	"ɖɯ˧-ʂɯ˩~ɖɯ˩-ʂɯ˩, | ʝi˧-kʰv̩˥~ʝi˩-kʰv̩˩-dʑo˩, | kv̩˧ | næ˩qʰæ˥ʈʂʰe˩ gv̩˩-bi˩, | ""dzɯ˧! | ɖwæ˩-mɤ˧-zo˧! | ə˧-sɯ˩kv̩˩, | dzɯ˧ F !"" | pi˧-dʑo˩ | tʰi˩˥, | mo˧-ɳɯ˥ | le˧-dv̩˩-zo˩! |"
crdo-NRU_F4_MUSHROOMS_MUSHROOMS_S002.wav	zo˩no˥, | mo˧-ʈʂʰɯ˧-dʑo˩, | qʰv̩˧-ɬi˧mi˧-kʰɤ˧ʂɯ˧ | tʰv̩˧-kv̩˧-ze˥-mæ˩! |
crdo-NRU_F4_MOUNTAINS_F4_MountainsS109.wav	hĩ˧-ʈʂʰɯ˧ | tʰi˩˥, | hɤ˩-hĩ˩=ɻæ˥ | ʈʂʰɯ˧=ɻæ˥ | tʰi˧-dzi˩-ɲi˩-ʝi˩-mæ˩, ◊ ə˩-gi˩! |
crdo-NRU_F4_MOUNTAINS_F4_MountainsS052.wav	"""ə˧mi˧! | qv̩˧ɻ̍˧-ʁo˧qʰwɤ˥ dzi˩-hĩ˩ | ʈʂʰɯ˧-ʑi˧=ɻ̍˥-dʑo˩, | tʰi˩˥, | əəə… æ˧bv̩˧-ʂe˧bv̩˥ tso˩-ɲi˩-tsɯ˩-zo˩, | ʝi˧qv̩˥=ɻ̍˩-ɳɯ˩ | ə˧sɯ˩kv̩˩-ki˩ wɤ˩-tsʰɯ˩-hĩ˩-ʈʂʰɯ˩, | """
crdo-NRU_F4_FUNERAL_F4_FUNERAL_S254.wav	li˩ tʰi˥-kʰɯ˩, | jɤ˧ tʰi˧-kʰɯ˧˥! | ʂe˧pʰæ˩ tʰi˩-kʰɯ˩! | ʈʂʰɯ˧ne˧-ʝi˥ | <le˧-po˧-jo˥-kv̩˩> [le˧-po˧-bi˥-kv̩˩]!
crdo-NRU_F4_TIGER2_Tiger2S072.wav	kʰi˧ | tʰi˧-tv̩˧˥ ◊ -dʑo˩, | lɑ˧-ɳɯ˧ | zɯ.bv-zɯ.bv! pi˧, | mi˧-le˧-tsʰɯ˧-ɲi˥-tsɯ˩ ◊ -mv̩˩. |
crdo-NRU_F4_MOUNTAINS_F4_MountainsS126.wav	dʑɯ˩-ʈʂʰɯ˥, | ɕjɤ, ɕjɤ, ɕjɤ, ɕjɤ, ɕjɤ pi˧ | ɖɯ˧-ʈʰɤ˧ le˧-pɤ˥-dʑo˩ | tʰi˩˥, | ʐɤ˩mi˩-ʈʂʰɯ˥ | ʈʂʰɯ˧ne˧-ʝi˥ | ɖɯ˧-kʰɯ˩ tʰi˩-di˩-kv̩˩ ◊ -mv̩˩. |
crdo-NRU_F4_FOOD_SHORTAGE_FoodShortageS062.wav	mmm, sɑ˧! |
crdo-NRU_F4_FUNERAL_F4_FUNERAL_S118.wav	"""hĩ˧-qɑ˩ | ɖɯ˧-qɑ˧-ɻ̍˧! | njɤ˧=ɻ̍˩ | ə˧mi˧ | le˧-pv̩˩-tso˩-ɲi˩-ze˩!"" | pi˧. |"
crdo-NRU_F4_CARAVANS_CaravansS059.wav	ʂe˧ʈʂe˩-ʈʂʰɯ˩, | pʰv̩˩tɕæ˩ɻæ˥-zo˩, | ʈʂʰɯ˧ne˧-ʝi˥ | ɖɯ˧-kʰwɤ˥~ɖɯ˩-kʰwɤ˩ dʑo˩-kv̩˩-mæ˩, | <ɖɯ…> qʰɑ˧-ʂæ˧~ʂæ˧-zo˥! | ɖɯ˧-tsʰi˥~ɖɯ˩-tsʰi˩! | õ!
crdo-NRU_F4_DOG2_Dog2S087.wav	õ˧ʈʂʰɯ˧-lɑ˩ dʑo˩! | kʰv̩˩mi˩-ʈʂʰɯ˥, | gi˩˥, | ɖɯ˧-pi˧˥ | zɯ˧ ʂæ˧! | njɤ˧-ɳɯ˧ tʰi˧-li˧! |
crdo-NRU_F4_MOUNTAINS_F4_MountainsS139.wav	ʈʂʰɯ˧ne˧-ʝi˥ | ʐɤ˩mi˩˥ | ɖɯ˧-kʰɯ˩-qo˩! | ʁwɤ˧-qo˧-ɳɯ˧ le˧-tsʰɯ˩-zo˩, | æ˩ʈv̩˥-qo˩-ɳɯ˩! |
crdo-NRU_F4_FOOD_SHORTAGE2_FOOD_SHORTAGE2S060.wav	"""ə˧tse˧-bi˧? | ə˧dɑ˥ | no˧ | ə˧tse˧-bi˧? | ə˧tse˥ | <tʰ…> tʰi˧-dzi˩ pi˩?"" | pi˧-dʑo˩, | ""tʰi˧-dzi˩! | tʰi˧-dzi˩! | ə˧zɯ˩, | ɖɯ˧-dzi˩ | -sɯ˩-ɻ̍˩-bi˩˥!"" | pi˧-tsɯ˩ ◊ -mv̩˩. |"
crdo-NRU_F4_CARAVANS_CaravansS118.wav	"mmm… hĩ˧ | ɲi˧-kv̩˧-bi˧, | pi˧-kv̩˩, | lɑ˧do˧ | ɖɯ˧-v̩˧, | tsʰo˧pæ˧ | ɖɯ˧-v̩˧! |
			pi˧. | tsʰe˩-kv̩˩ tɕɯ˥-kv̩˩-mæ˩! |"
crdo-NRU_F4_FOOD_SHORTAGE2_FOOD_SHORTAGE2S024.wav	"""ə˩zɯ˩˥, | no˧ tɕʰi˧-mɤ˧-bi˧-ze˧! | æ˧ʂæ˧-tɑ˩mv̩˩ | dʑo˩-ɲi˥:"" |"
crdo-NRU_F4_FUNERAL_F4_FUNERAL_S120.wav	ʁwɤ˧qo˧-dʑo˥ | tʰi˩˥, | le˧-qɑ˧~qɑ˩. |
crdo-NRU_F4_MOUNTAINS_F4_MountainsS162.wav	hĩ˧=ɻæ˥ | le˧<-jo˩>[bi˩]-ho˩ | ɖɯ˧-ɲi˥ | tʰi˩˥, | ʐo˩˥ | le˧-gv̩˩ | le˧-dzɯ˧-se˥-dʑo˩, | qwɤ˧ɭɯ˧-ʁo˧ | ʈʂʰɯ˧-qo˧… | qwɤ˧ɭɯ˧ | ʈʂʰɯ˧ne˧-ʝi˥ | so˧-ɭɯ˧ | tʰi˧-di˩-ɲi˩-mæ˩! |
crdo-NRU_F4_CARAVANS_CaravansS268.wav	"no˧ | zo˩no˥ | sɑ˧ ɲi˥-kv̩˩-mɤ˩-ho˩, | zo˧mv̩˥-dʑo˩! | zo˩no˥, | njæ˧sɯ˩kv̩˩, | nɑ˩
			ɲi˥-pi˩-bi˩-bi˩! |"
crdo-NRU_F4_HOUSEBUILDING2_HOUSEBUILDING2_S063.wav	tʰi˩˥, | ʑi˧mi˧… | le˧-gv̩˧~gv̩˥ | le˧-tʰv̩˧, | tʰi˩˥, | hĩ˧ | tʰi˧-dzi˩-tʰɑ˩-ɲi˩-ze˩! |
crdo-NRU_F4_CARAVANS_CaravansS056.wav	"əəə… <li…> ""si˧kʰɯ˧ ʈʰɯ˧-se˥-gɤ˩-dʑo˩, | mɤ˧-ɲi˧-ze˧!"" | pi˧-ɲi˥-tsɯ˩-mæ˩. |
			ə˧mi˧ le˧-ʂɯ˧, | tʰi˧-kwɤ˩-kʰɯ˩!"" | pi˧. |"
crdo-NRU_F4_SEEDS_SeedsS058.wav	wo˩˥! | nɑ˩-dʑi˧-dʑo˩, | sɑ˧! | pi˧. |
crdo-NRU_F4_HOUSEBUILDING2_HOUSEBUILDING2_S007.wav	tʰi˩˥, | gv̩˩pʰæ˩-ʈʂʰɯ˥, | ɖɯ˧-↑ɲi˥-ɳɯ˩ | ɑ˩ʁo˧ le˧-tʰv̩˧-zo˧-kv̩˧˥ ◊ -ɲi˩! |
crdo-NRU_F4_CARAVANS_CaravansS139.wav	"əəə… tɕɯ˧-lɑ˥, əəə… | zo˩no˥, | tso˧~tso˧ | õ˧-bv̩˥-õ˩ | tʰi˧-tsɯ˥! | ʈʂʰɯ˧ne˧-ʝi˥ |
			ɖɯ˧-tɕo˥ | kʰɯ˧˥; |"
crdo-NRU_F4_MUSHROOMS_MUSHROOMS_S167.wav	tʰi˩˥, | mo˧-bv̩˥ | ʈʂʰɯ˧ ɲi˥-ze˩-mæ˩!
crdo-NRU_F4_ELDERS3_Elders3S056.wav	əəə… tʰi˩˥, | zo˧ | ɖɯ˧-tɑ˧˥ | le˧-ʂɯ˧-ze˧, | mɤ˧-dʑo˩-ze˩! |
crdo-NRU_F4_CARAVANS_CaravansS222.wav	le˧-tɕɯ˧˥, | mv̩˧ɭɯ˩… | mv̩˧ɭɯ˩ | kv̩˧tsʰɑ˥ | hĩ˧ ʝi˧-hɯ˧! |
crdo-NRU_F4_FOOD_SHORTAGE_FoodShortageS100.wav	"""zo˩no˥, | tʰv̩˧-lɑ˩ ɲi˩! | no˧sɯ˩kv̩˩, | ŋæ˧ʝi˩ | ʐwæ˩˥!"" | pi˧-kv̩˩ ◊ -mæ˩. |"
crdo-NRU_F4_FOOD_SHORTAGE2_FOOD_SHORTAGE2S022.wav	gɤ˩-tɕo˧ li˧, | di˩li˩-ʁo˩bv̩˥ tsɤ˩! | mv̩˩-tɕo˧ li˧, | di˩li˩-ʁo˩bv̩˥ tsɤ˩-tsɯ˩ ◊ -mv̩˩!
crdo-NRU_F4_HOUSEBUILDING2_HOUSEBUILDING2_S272.wav	ə˧˥-dʑo˩, | mɤ˧-v̩˧-zo˥, ◊ ə˩-gi˩! | ə˧˥-dʑo˩, | mɤ˧-v̩˧-zo˥! | si˧… si˧-ɳɯ˩ | le˧-gv̩˩, | næ˩-qʰæ˥ʈʂʰe˩-zo˩! |
crdo-NRU_Mariage_De_La_Soeur_V3_Sister3_S088.wav	di˧qo˧-tsʰɯ˩-dʑo˩, | dʑɯ˩ʁo˩˥ | -↑hṽ̩˧nɑ˩-ni˩gv̩˩ ɲi˩-ze˩ mæ˩! |
crdo-NRU_F4_MOUNTAINS_F4_MountainsS144.wav	ə˧ʝi˧-ʂɯ˥ʝi˩-dʑo˩ | tʰi˩˥, | zo˧mv̩˥-ʈʂʰɯ˩ | ʐwɤ˩-hõ˩˥, | ʐwɤ˩-mɤ˩-hĩ˩-hĩ˥-ʈʂʰɯ˩-dʑo˩, | æ˧ʂæ˧ gwɤ˩-bi˩-zo˩-kv̩˩-mæ˩! |
crdo-NRU_F4_COMING_OF_AGE2_F4_ComingOfAge2S093.wav	le˧-ʑi˩, | wɤ˩˥ | tʰv̩˧-pv̩˧pv̩˥-qo˩ | tʰi˧-kʰɯ˧˥! |
crdo-NRU_F4_FUNERAL_F4_FUNERAL_S069.wav	ɖɯ˧-qʰwɤ˧ tʰi˥-ki˩-kv̩˩-mæ˩! |
crdo-NRU_F4_SEEDS_SeedsS064.wav	di˧qo˧-ɳɯ˧, | gɤ˩-tɕo˧ hɯ˧-hĩ˧ | ɖɯ˧-v̩˧-ɳɯ˧, | tʰi˩˥, | nɑ˧~nɑ˥ | le˧-kʰv̩˥ | le˧-po˧-tsʰɯ˧˥ ◊ -kwɤ˩tɕɯ˩-lɑ˩ | tʰi˩˥, | le˧-dʑo˧-ɲi˥-kv̩˩-tsɯ˩ ◊ -mv̩˩! |
crdo-NRU_F4_HEALING_HealingS031.wav	dɑ˧pɤ˧ | le˧-ʁɑ˧ʂe˩ | le˧-po˧-tsʰɯ˧˥, | dɑ˧pɤ˧-ɳɯ˧ | tʰi˩˥, |
crdo-NRU_F4_FOOD_SHORTAGE2_FOOD_SHORTAGE2S018.wav	"""njɤ˧-ɳɯ˧ | tɕʰo˩-bi˩-tsæ˥-ɲi˩! | ɖwæ˩-mɤ˧-zo˧!"" | pi˧-tsɯ˩ ◊ -mv̩˩. |"
crdo-NRU_Mariage_De_La_Soeur_V3_Sister3_S061.wav	tʰi˩˥, | nɑ˩-ʐwɤ˥-pi˩-dʑo˩, | ʈʂʰɯ˧ ʝi˧lo˧ mɤ˧-↑dʑɤ˩ ɲi˩-ze˩ mæ˩! |
crdo-NRU_F4_TIGER2_Tiger2S131.wav	"""no˧ | õ˧-bv̩˥-õ˩ | zo˧ ʐɤ˧-tso˧-ɲi˥, | mv̩˩ ʐɤ˩-tso˥-ɲi˩!"" |"
crdo-NRU_F4_CARAVANS_CaravansS063.wav	"hĩ˧=ɻæ˥, | tʰi˩˥ | mi˩zɯ˩=ɻæ˥, | zo˩no˥, | ʐwæ˧ tɕɯ˩-hɯ˩-hĩ˩, | zo˩no˥, | pʰæ˧tɕi˥ |
			ɖʐv̩˧ ɲi˩-pi˩, | ɖʐv̩˧ ʈʂʰɯ˧-v̩˧-ɳɯ˩ | le˧-po˧-jo˥-kv̩˩-ze˩-mæ˩! |"
crdo-NRU_Mariage_De_La_Soeur_V3_Sister3_S144.wav	tʰi˩˥, | ni˧mi˧ | hĩ˧-ki˧-ki˩, | pi˧-dʑo˩, | sɯ˧kʰɯ˩ bi˩-zo˩-kv̩˩ <b>-mæ˩! |
crdo-NRU_Naissance_du_Lac_V3_Lake3_S026.wav	qo˧lo˩ hɯ˩-tsɯ˩ mv̩˩, | æ˩qʰv̩˧-qo˧! | æ˩qʰv̩˧ pi˧ | ɖɯ˧-ɭɯ˧ ɲi˩ mæ˩. |
crdo-NRU_F4_TIGER2_Tiger2S117.wav	"""no˧˥ | tʰv̩˧-se˩-gɤ˩ | no˧ | ə˧mi˧-ɳɯ˧ | tʰi˧-ʁo˥ʐv̩˩-dʑo˩-ʝi˩!"" |"
crdo-NRU_F4_HEALING_HealingS074.wav	jo˧do˧-mv̩˩ | tʰi˧-pv̩˩, | le˧-qʰwɤ˧-ʝi˧-ze˧, | pi˧! |
crdo-NRU_F4_CARAVANS_CaravansS247.wav	"mv̩˧ʐe˧-qo˥, | ə˧mi˧=ɻæ˩-dʑo˩, | le˧-tsʰɯ˩-pi˩, | ʐwæ˧-zɯ˧ kʰv̩˧! | ʐwæ˧-hɑ˧ ʂe˩!
			|"
crdo-NRU_F4_HOUSEBUILDING2_HOUSEBUILDING2_S269.wav	qʰwɤ˧zo˥ | ɖɯ˧-ɭɯ˧! | qʰwɤ˧pɤ˥ | ɖɯ˧-ɭɯ˧! | v̩˩dʑɯ˩-kʰɯ˥-di˩ | ɖɯ˧-ɭɯ˧! | hɑ˧ kʰɯ˩-di˩ | ɖɯ˧-ɭɯ˧! |
crdo-NRU_F4_CARAVANS_CaravansS166.wav	"ɬi˧di˩-di˩mi˩, | qʰæ˧tɕʰi˧-hĩ˧ | <ɖɯ˧…> ʐwæ˧ | ɖɯ˧-pæ˥; | njæ˧sɯ˩kv̩˩, |
			ə˧lɑ˧-ʁwɤ˧-hĩ˧ | ɖɯ˧-pæ˥! | gæ˧ɻæ˩-hĩ˩ | ɖɯ˧-pæ˥! | lɑ˧ŋwɤ˧-hĩ˧ | ɖɯ˧-pæ˥! | õ! əəə…
			ʈʂo˧ʂɯ˧-hĩ˧ | ɖɯ˧-pæ˥! |"
crdo-NRU_Mariage_De_La_Soeur_V3_Sister3_S054.wav	le˧-↑bæ˧˥ | tsʰɯ˩-zo˥, | ɖɯ˧-li˧-ɻ̍˩-dʑo˩ | tʰi˩˥, | ə˧mv̩˧˥ ◊ -dʑo˩, | go˧mi˧ | ↑le˧-do˩-kwɤ˩tɕɯ˩-lɑ˩, | gɤ˩-↑ʈi˧-ze˩-tsɯ˩ ◊ -mv̩˩. |
crdo-NRU_Mariage_De_La_Soeur_V3_Sister3_S109.wav	so˩ɲi˩˥; | so˩hɑ̃˩˥; | ʈʂʰɯ˧ | le˧-qæ˧˥ | tʰi˧-kwɤ˩-dʑo˩ | tʰi˩˥, | mv̩˩-mɤ˩-tʰɑ˥-tsɯ˩ ◊ -mv̩˩!
crdo-NRU_Mariage_De_La_Soeur_V3_Sister3_S051.wav	"""ə˧mi˧! | ə˧ʝi˧-ʂɯ˥ʝi˩, | ʈʂʰɯ˧ go˧mi˧-ʈʂʰɯ˧ <ə˧mv̩˩-go…> | ə˧mv̩˧˥ | ɖɯ˧-v̩˧ dʑo˩-ɲi˩-tsɯ˩… | dʑɯ˩nɑ˩mi˩-ʁo˩ dzi˩˥, | ɖɯ˧-so˩ kʰv̩˩ gv̩˩-ze˩, |"
crdo-NRU_F4_CARAVANS_CaravansS051.wav	"""ə˧mi˧! | õ˧˥ | ə˧mi˧ | mɤ˧-dʑo˧-ze˧! | zo˩no˥, | dzɯ˧-di˧˥ | ə˧tso˧-mɤ˧-ɲi˩ | dʑo˧!""
			| pi˧, | ʈʂʰɯ˧ne˧-ʝi˥ | gwɤ˩-ɲi˥-mæ˩! |"
crdo-NRU_F4_HOUSEBUILDING2_HOUSEBUILDING2_S213.wav	tʰi˧-hwæ˩-dʑo˩ | tʰi˩˥, | ɖɯ˧-kʰɤ˧~ɖɯ˥-kʰɤ˩ | le˧-pv̩˧-kwɤ˧tɕɯ˥-lɑ˩ | tʰi˧-tɕɯ˥-dʑo˩ | tʰi˩˥, | dʑɯ˩ʁo˩ bi˩-bi˩˥, | v̩˩tsʰɤ˧-tæ˧pv̩˥-ʈʂʰɯ˩, | <ɖɯ˧-… n… əəə…> ʈʂʰɯ˧ne˧ ʝi˥ | ɖɯ˧-kɤ˧ ʂæ˥~ʂæ˩! | tʰi˧-kʰɯ˧˥! |
crdo-NRU_F4_CARAVANS_CaravansS070.wav	ho˧di˧, | ə˧ʝi˧-ʂɯ˥ʝi˩, | ho˧di˧-dʑo˧, | tsʰe˧ tɕɯ˩-hɯ˩-ɲi˩-mæ˩, ◊ ə˩-gi˩! |
crdo-NRU_F4_CARAVANS_CaravansS074.wav	ʈʂʰɯ˧ne˧-ʝi˥ | le˧-tɕɯ˧˥, | ʐwæ˧ | tʰo˩lo˥, | ɻ̍˩ɻ̍˧lo˩ | le˧-di˧˥, |
crdo-NRU_F4_FOOD_SHORTAGE_FoodShortageS078.wav	tʰi˩˥ | wɤ˩˥ | əəə… sɑ˧-bv̩˧ | ʈʰæ˧qʰwɤ˥ | pi˧ | ɖɯ˧-ʁo˩ dʑo˩-kv̩˩! |
crdo-NRU_F4_HOUSEBUILDING2_HOUSEBUILDING2_S358.wav	si˧dzi˩, | ʈʰææ̃˧ | ↑dʑɤ˩-hĩ˧ tʰi˧-di˥-hĩ˩ qo˩ mæ˩-zo˩-kv̩˩. | dʑɤ˩pi˧ tʰi˧-di˥-hĩ˩ qo˩ mæ˩, | pi˧-dʑo˩, | ʈʂʰɯ˧ | ə˧tso˧ mɤ˧-ɲi˩ | dʑɤ˩pi˧ dʑo˧-kv̩˩ pi˩-kv̩˩! |
crdo-NRU_F4_FUNERAL_F4_FUNERAL_S012.wav	le˧-ʈʂʰo˧-se˩-kwɤ˩tɕɯ˩-lɑ˩ | tʰi˩˥, | əəə… hĩ˧-ʈʂʰɯ˧ | əəə… le˧-gv̩˧~gv̩˥! |
crdo-NRU_F4_MUSHROOMS_MUSHROOMS_S069.wav	mo˧˥ | le˧-ʂe˧ le˧-po˧-tsʰɯ˧-hĩ˧ ɖɯ˧-ʁwɤ˧ tʰi˧-ʁwɤ˧! | ɖɯ˧-bæ˧-qo˧-ɳɯ˧, | ɖɯ˧-kʰwɤ˥~ɖɯ˩-kʰwɤ˩ ʑi˩, | tʰi˧-ɕjɤ˧˥! |
crdo-NRU_F4_CARAVANS_CaravansS230.wav	"tʰi˩˥, | mv̩˧ɭɯ˩-sɯ˩pʰi˩ | ɖɯ˧-ʈʂæ˧ ʝi˥-kʰɯ˩-dʑo˩, | ə˧ʝi˧-ʂɯ˥ʝi˩ | tʰi˩˥, | mmm…
			mv̩˩zo˩=ɻæ˥, ◊ ə˩-gi˩! |"
crdo-NRU_F4_DOG2_Dog2S097.wav	æ˧ʂæ˧, | ʈʂʰɯ˧ne˧-ʝi˥ | ʐwɤ˩-ɲi˥-tsɯ˩ ◊ -mv̩˩!
crdo-NRU_F4_FUNERAL_F4_FUNERAL_S184.wav	zo˩no˥, | ʈæ˧bɤ˧-ʈʂʰɯ˧, | zo˩no˥, | njæ˧sɯ˩kv̩˩, | hĩ˧ ɖɯ˧-v̩˧ ʂɯ˧ | pi˧, | ni˧tsi˧-kv̩˧˥, | tsʰe˩ŋwɤ˩-kv̩˥, | tsʰe˩hõ˩-kv̩˥, | əəə… tsʰe˩-kv̩˩˥, | ʂɯ˧-kv̩˧˥… |
crdo-NRU_F4_TIGER2_Tiger2S010.wav	"""<õ˧-bv̩˥-õ˩…> [õ˧-so˥-ɳɯ˩, | õ˧ ɖwæ˥!] | õ˧-ɬi˧qʰv̩˧-ɳɯ˩, | õ˧-so˥-ɳɯ˩, | õ˧ gɤ˥!"" | pi˧-tsɯ˩ ◊ -mv̩˩. õ˧˥ | hhh… hhh… hhhɑ̃! pi˧-hĩ˧-tʰv̩˧-ɳɯ˩, | õ˧˥ | le˧-ɖwæ˩, | le˧-ʂɯ˧-ho˧-ze˩! | pi˧-tsɯ˩ ◊ -mv̩˩. |"
crdo-NRU_F4_FUNERAL_F4_FUNERAL_S223.wav	njɤ˧-ɳɯ˧-dʑo˥, | njɤ˧-ɳɯ˧ | le˧-qʰæ˧-ɲi˥-ze˩-mæ˩, ◊ ə˩-gi˩! |
crdo-NRU_F4_MOUNTAINS_F4_MountainsS076.wav	"""hĩ˧-ʈʂʰɯ˧, | qv̩˧ɻ̍˧-ʁo˧qʰwɤ˥ dzi˩-hĩ˩, | le˧-wo˧ | mv̩˧ʈʰæ˧-ʈæ˧qo˧ | hĩ˧-bi˥ wɤ˩-zo˩-kv̩˩!"" | pi˧. |"
crdo-NRU_F4_FOOD_SHORTAGE2_FOOD_SHORTAGE2S020.wav	hɯ˧, | hɯ˧, | le˧-se˥, | ɖɯ˧-di˩-ɻ̍˩-qo˩ tʰv̩˩-dʑo˩, | ʁwɤ˧ | ɖɯ˧-ɭɯ˧ ɖæ˩-ze˩-tsɯ˩ | mv̩˩!
crdo-NRU_F4_FOOD_SHORTAGE_FoodShortageS048.wav	mv̩˧dze˧-qwæ˩ʈʂwæ˩-hɑ˩, | le˧-dzɯ˥-tʰɑ˩-ze˩! |
crdo-NRU_F4_CARAVANS_CaravansS003.wav	"ʈʂʰɯ˧ | ə˧ʝi˧-ʂɯ˥ʝi˩ | <ʐ… əəə…> ʐwæ˧ tɕɯ˩! | ʐwæ˧ tɕɯ˩! | sɯ˧pʰi˧-bv̩˧ | ʐwæ˧
			tɕɯ˩-kv̩˩-mæ˩, | ə˧ʝi˧-ʂɯ˥ʝi˩! |"
crdo-NRU_Mariage_De_La_Soeur_V3_Sister3_S083.wav	tʰi˩˥, | go˧mi˧ | ʈʂʰɯ˧-pʰo˩-bi˩ <ʈv̩˩>[ʈʂʰv̩˩]-bi˩-ze˩, | tʰi˧-ʂɯ˧-tsɯ˥ | mv̩˩!
crdo-NRU_F4_ELDERS3_Elders3S058.wav	ʈʂʰɯ˧ | ɬi˧di˩ dzi˩! |
crdo-NRU_F4_FUNERAL_F4_FUNERAL_S085.wav	ə˧zɯ˩, | ɖʐv̩˧ dʑo˩! | qʰwɤ˩ɖɯ˩˥ | v̩˩dze˩ dʑo˩˥ | pi˧, | wɤ˩˥ | ʈʂʰɯ˧-tɕi˩ | le˧-tɑ˧˥ | jo˩-kv̩˥-mæ˩! |
crdo-NRU_F4_RENAMING_RenamingS003.wav	no˧=ɻ̍˩, | tʰv̩˧-ɲi˧, | zo˧mv̩˥ | ɖɯ˧-pi˧˥ | ↑ŋv̩˩˥ | pi˧-dʑo˩, |
crdo-NRU_F4_CARAVANS_CaravansS260.wav	ə˧ʝi˧-ʂɯ˥ʝi˩, | hæ˧-ʈʂʰɯ˧-dʑo˩, | ʈʂʰwæ˧˥ | v̩˧lɑ˩-ʝi˩-ɲi˩-ho˩, ◊ ə˩-gi˩! | hæ˧-di˩ kʰi˩ ◊ -dʑo˩, | tso˧~tso˧… | ʐwæ˧ le˧-ʑi˩, | ʈʂʰɯ˧-qo˧ tʰi˧-ʈæ˩! | əəə… zo˩no˥, | tso˧~tso˧… | ɖɯ˧-tɑ˧˥ ◊ -qo˩, | le˧-gwɤ˩~gwɤ˩-ɻ̍˩, | əəə… zo˩no˥… |
crdo-NRU_F4_CARAVANS_CaravansS121.wav	"ʈʂʰɯ˧ne˧-ʝi˥ | tʰi˩˥, | lɑ˧do˧… lɑ˧do˧ ɲi˥-kv̩˩, | tsʰo˧pæ˧ ɲi˥-kv̩˩, | ʈʂʰɯ˧ne˧-ʝi˥ |
			le˧-tɕʰo˥~tɕʰo˩ bi˩-dʑo˩ | tʰi˩˥, |"
crdo-NRU_F4_HEALING_HealingS038.wav	əəə… ʈʂʰɯ˧ne˧-ʝi˥ | gɤ˩-dɑ˧˥, | mv̩˩-dɑ˧˥, | gɤ˩-dɑ˧˥, | mv̩˩-dɑ˧˥, | ʈʂʰɯ˧ne˧-ʝi˥ | ʈʂʰɯ˧-dʑo˧ | tʰi˩˥, |, wɤ˩˥, | ɖɯ˧-so˩ ʂɯ˩ ʝi˩-tsɯ˩ ◊ -mv̩˩!
crdo-NRU_F4_MOUNTAINS_F4_MountainsS119.wav	ə˧si˧… | njɤ˧sɯ˩kv̩˩-bv̩˩ | ə˧si˧-bv̩˧ | ə˧ʑi˧˥ | tʰv̩˧-ʈʂʰæ˩-dʑo˩, | do˩-kv̩˩-pʰæ˥-di˩! | ə˧ʝi˧-ʂɯ˥ʝi˩! |
crdo-NRU_F4_FUNERAL_F4_FUNERAL_S112.wav	mv̩˩tɕi˥-dʑo˩ | tʰi˩˥, | <bæ˧dʑɯ˩ ʈʂʰv̩˩> [bæ˧qʰæ˧ ʈʂʰv̩˧] | pi˧, | mv̩˩si˧njɤ˧˥ | le˧-qæ˧-hĩ˧-bv̩˧ | ʈʂʰv̩˧ | tʰv̩˧-kʰwɤ˥-dʑo˩, | ɖɯ˧-pi˧˥ | ʐo˩-kv̩˩-tsɯ˥-mæ˩! |
crdo-NRU_F4_MUSHROOMS_MUSHROOMS_S094.wav	"""ə˧mi˧! | njɤ˧=ɻ̍˩ | mv̩˩-gɤ˧ | gɤ˩-hĩ˧ | mɤ˧-dʑo˩! | ə˧tse˧-ʝi˧-ɲi˥-hɯ˩~hɯ˩? | ʁɑ˩mi˧!"" | wɤ˩˥, |"
crdo-NRU_F4_COMING_OF_AGE2_F4_ComingOfAge2S101.wav	hĩ˧ tsʰɯ˧˥, | hɑ˧ | le˧-dzɯ˥, | ɖʐe˧-ki˧, | le˧-hɯ˩-ze˩! |
crdo-NRU_F4_COMING_OF_AGE2_F4_ComingOfAge2S011.wav	<ɲi˧-dzi˩~ɲi˩-dzi˩, | pi˧! | > [ɲi˧-dzi˩~ɲi˩-dzi˩ hwæ˩-ze˩-mæ˩! | ] zo˩no˥, | ə˧dɑ˧ ʈʂʰɯ˧-ʑi˧=ɻ̍˧, ɖɯ˧-dzi˥! | ə˧mi˧ ʈʂʰɯ˧-ʑi˧=ɻ̍˧, ɖɯ˧-dzi˥! | mmm!
crdo-NRU_F4_MUSHROOMS_MUSHROOMS_S124.wav	ʈʂʰɯ˧ | le˧-ɖʐɤ˧ le˥-po˩bi˩, | ʈʂʰɯ˧-dʑo˩ | hĩ˧ dv̩˥-mɤ˩-kv̩˩! | ɖwæ˩ mɤ˧-zo˧ pi˧-zo˥, | dzɯ˧-kv̩˩-mæ˩! |
crdo-NRU_F4_RENAMING_RenamingS033.wav	ʈʂʰɯ˧-v̩˧-ki˧, | tʰi˩˥, | ə˧dɑ˧ ʈʂɤ˧-ɲi˥-ze˩-mæ˩! |
crdo-NRU_F4_DOG2_Dog2S095.wav	tʰi˩˥, | <ɖʐv̩˧…> ɖʐv̩˧nɑ˥mi˩-gi˩ɳɯ˩, | tʰi˩˥ | no˧˥, | kʰv̩˩mi˩ ʈʂʰwæ˩-ɲi˥-tsɯ˩ ◊ -mv̩˩!
crdo-NRU_Mariage_De_La_Soeur_V3_Sister3_S056.wav	«dzɯ˧-gɤ˥ | dzɯ˧-mɤ˧-gɤ˩, <əəə…> | kʰv̩˩mi˩˥ | no˧ dzɯ˧-hõ˧! | ʈʰɯ˩-gɤ˩ ʈʰɯ˩-mɤ˩-lv̩˥, | ʈʂe˧nɑ˥ | no˩ ʈʰɯ˩-hõ˩˥!», | pi˧-zo˩, |
crdo-NRU_F4_TIGER2_Tiger2S054.wav	nɑ˩dzi˧-kwɤ˩tɕɯ˩-lɑ˩ | tʰi˩˥, | bv̩˩hwɤ˩-qo˥ tʰv̩˩-tsɯ˩ ◊ -mv̩˩!
crdo-NRU_F4_FUNERAL_F4_FUNERAL_S074.wav	hɑ˧ | ɖɯ˧-qʰwɤ˧ qwæ˥-dʑo˩, | [ɲi˧-ʂɯ˩ qwæ˩!] | tɕi˩-hĩ˩˥ | ɖɯ˧-kʰwɤ˥! | ɖɯ˩-hĩ˩˥ | ɖɯ˧-kʰwɤ˥ qwæ˩, | tʰi˧-kʰɯ˧˥! |
crdo-NRU_F4_TIGER2_Tiger2S019.wav	"tʰi˩˥, | zo˧-ɳɯ˩: | ""ə˧dɑ˥! | no˧ | le˧-ʂɯ˧-se˥, | njæ˧sɯ˩kv̩˩ | hɑ˧ F | dzɯ˧ mɤ˧-ʝi˧! | qʰɑ˩ne˩ ʝi˥-bi˩?"" |"
crdo-NRU_Mariage_De_La_Soeur_V3_Sister3_S005.wav	zo˩no˥, | mv̩˩zɯ˩-ni˥mi˩-bv̩˩ | <tɕɛ˩> [ʐwɤ˩] ɲi˥-tsɯ˩ ◊ -mv̩˩!
crdo-NRU_F4_HOUSEBUILDING2_HOUSEBUILDING2_S318.wav	no˧=bv̩˩ ʐwɤ˩! | njɤ˧=bv̩˩ ʐwɤ˩ | ʈʂʰɯ˧ne˧-ʝi˥ | ʐwɤ˩-kv̩˩˥ | mæ˩: |
crdo-NRU_F4_HOUSEBUILDING2_HOUSEBUILDING2_S198.wav	tʰi˧-tsi˧-dʑo˥ | tʰi˩˥, | so˧-ɬi˧mi˧ - ʐv̩˩-ɬi˩mi˩-qo˩-dʑo˩ | tʰi˩˥, | ʐv̩˩-ɬi˩mi˩-lɑ˥ | so˧-ɬi˧mi˧ | ɲi˧-ɬi˧mi˧-qo˧ | ʑi˧qʰwɤ˧ dɑ˧˥ | pi˧-dʑo˩ | ʈʂʰɯ˧, | ʈʂʰɯ˧ | tv̩˧qʰv̩˧ | gɤ˩-↑ʑi˥-dʑo˩, | ʈʂʰɯ˧ne˧ ʝi˥ | gɤ˩-↑ʑi˥-kv̩˩-ze˩ mæ˩! | ɬi˩bi˩-ʈʂʰɯ˥! |
crdo-NRU_F4_CARAVANS_CaravansS235.wav	"mmm… ""mv̩˧ɭɯ˩-sɯ˩pʰi˩ | hĩ˧ F | wɤ˩˥ | [ʝi˧-mɤ˧-bi˧! |] njɤ˧ | õ˧-bv̩˥-õ˩… |
			ʐwæ˧ tɕɯ˩-bi˩-ze˩!"" | tʰv̩˧ pi˧-zo˩, | ʐwæ˧ tɕɯ˩-ɲi˩-tsɯ˩ ◊ -mv̩˩!"
crdo-NRU_Naissance_du_Lac_V3_Lake3_S005.wav	go˩bo˥ lv̩˩-hɯ˩-dʑo˩, | ʐo˩˥ | le˧-po˧˥… | le˧-kʰɯ˩~kʰɯ˩ | tʰi˧-ki˧-dʑo˥, | ʐo˩˥ ◊ -dʑo˩ | tʰi˩˥, | njæ˧-sɯ˩kv̩˩ | ə˧ʝi˧-ʂɯ˥ʝi˩-dʑo˩, | tso˧kʰwɤ˧-qo˩ | kʰɯ˩~kʰɯ˩-ɲi˥ ◊ -mæ˩! |
crdo-NRU_F4_DOG2_Dog2S062.wav	hɑ˧-lɑ˩ | ʂe˧ dzɯ˧ | ɖɯ˧-kʰv̩˧˥ ◊ -dʑo˩ | tʰi˩˥, | ɖwæ˧˥ | hi˩ gi˩-mɤ˩-kv̩˥-tsɯ˩ ◊ -mv̩˩! |
crdo-NRU_F4_COMING_OF_AGE2_F4_ComingOfAge2S081.wav	tʰi˩˥, | le˧-bi˧-se˩-kwɤ˩tɕɯ˩-lɑ˩ | tʰi˩˥, | le˧-tsʰɯ˩! | le˧-tsʰɯ˩-dʑo˩ | tʰi˩˥, | kʰv̩˧ʂɯ˥! |
crdo-NRU_F4_CARAVANS_CaravansS204.wav	"ə˧ti˧-bɑ˧lɑ˥ | pi˧-zo˩, | bɑ˩lɑ˩˥, | hṽ̩… | ʂe˧ʈʂe˩ | ʈʂʰɯ˧-ʁo˥, ◊ ə˩-gi˩! |
			ɖɯ˧-tsʰi˥~ɖɯ˩-tsʰi˩, | ɖɯ˧-tsʰi˥~ɖɯ˩-tsʰi˩-hĩ˩-tʰv̩˩, | qʰɑ˩ne˩˥ |
			le˧-tɕɯ˧-le˥-po˩-jo˩-kv̩˩! |"
crdo-NRU_F4_FOOD_SHORTAGE_FoodShortageS063.wav	"""ɖwæ˩-mɤ˧-zo˧-ze˧! | <ə˧m…> ə˧mɑ˧-lɑ˧… | ə˧dɑ˥-ɳɯ˩, | əəə… sɑ˧ pʰo˩-bi˩!"" |"
crdo-NRU_F4_HOUSEBUILDING2_HOUSEBUILDING2_S138.wav	tʰi˩˥, | hɑ˧ dzɯ˧, | ʂe˧ dzɯ˧, | tʰi˩˥, | li˩ ʈʰɯ˩˥, | tʰi˩˥ | wɤ˩˥ | tʰv̩˧-qo˧ | tʰi˩˥, | ʈʂʰɯ˧-qo˧ | ɖɯ˧-ɲi˥ | le˧-se˩-ɲi˩-ze˩ mæ˩! |
crdo-NRU_F4_MOUNTAINS_F4_MountainsS169.wav	tv̩˩tv̩˩˥ | le˧-se˥ | le˧-bi˩, | pi˧-zo˩, | õ˧ʈʂʰɯ˧ne˧ ʝi˥-kv̩˩! |
crdo-NRU_F4_CARAVANS_CaravansS174.wav	tʰo˩lo˧ di˧-kʰɯ˥, | ɻ̍˩ɻ̍˧lo˩-di˩-kʰɯ˩! | sɯ˧pʰi˧-ʐwæ˧ | le˧-tɕɯ˧˥! |
crdo-NRU_F4_FUNERAL_F4_FUNERAL_S044.wav	tʰi˩˥, | dv̩˩pʰæ˧ tɕɯ˧-se˥-dʑo˩ | tʰi˩˥, | tv̩˧qʰv̩˧ | <tʰv̩˧-ɭɯ˧> [ɖɯ˧-ɭɯ˧] qwæ˧˥, | dv̩˩pʰæ˧ tʰv̩˧qo˧ tʰi˧-tɕɯ˥! |
crdo-NRU_Mariage_De_La_Soeur_V3_Sister3_S069.wav	tɕʰi˧sɯ˥-tsɯ˩ ◊ -mv̩˩! | tɕʰi˧sɯ˥-pi˩ | tʰi˩˥, | le˧-ŋv̩˩ | le˧-ŋv̩˩ | tʰi˧-ʂɯ˧-ɲi˥-ze˩-mæ˩, ◊ ə˩-gi˩! |
crdo-NRU_F4_MOUNTAINS_F4_MountainsS005.wav	mv̩˧ʈʰæ˧ | di˧qo˧-ɳɯ˧, | dʑɯ˩-ʈʂʰɯ˥, ◊ ə˩-gi˩! | ɖɯ˧-tso˩-ɳɯ˩, | gɤ˧bi˧! | gɤ˧bi˧-no˧˥, | ʈʂʰɯ˧ | qʰɑ˧-ʂwæ˧-gv̩˧ ɲi˥-mæ˩! |
crdo-NRU_F4_MUSHROOMS_MUSHROOMS_S109.wav	ə˧ʝi˧-ʂɯ˥ʝi˩-dʑo˩, | <dzɯ˧-kv̩˩-m…> tɕo˧˥ʂɯ˩, | æ̃˩ʂe˧li˥-mo˩-pi˩, | æ̃˧tsɯ˥kʰɯ˩ʈʂɤ˩-mo˩-pi˩, | ʂe˩-mo˧-pi˥, | əəə… tʰo˧mo˩-pi˩, | õ! əəə… ʐɯ˩mo˧-pi˥, | zo˩no˥, | mmm… ə˩ljɤ˩hæ̃˩ʂɯ˥-mo˩-pi˩, | zo˩no˥, | ʈʂʰɯ˧-lɑ˩ dzɯ˩-kv̩˩-mæ˩! |
crdo-NRU_F4_MUSHROOMS_MUSHROOMS_S097.wav	gɯ˩-ʝi˥, | ʈʂʰɯ˧-ʑi˧=ɻ̍˥-dʑo˩, | mi˩zɯ˩ tʰv̩˩-v̩˩-ɳɯ˥, | hĩ˧-ɳɯ˩ | tʰi˧-pʰv̩˩-tɕɯ˩-ɲi˩-tsɯ˩-mv̩˩! |
crdo-NRU_F4_FOOD_SHORTAGE2_FOOD_SHORTAGE2S087.wav	tʰi˩˥, | gi˩˥ ◊ -dʑo˩, | zo˧mv̩˥ F | le˧-hɤ˩. |
crdo-NRU_Naissance_du_Lac_V3_Lake3_S059.wav	ʝi˧kʰv̩˥-dʑo˩, | ʈʂʰɯ˧ne˧-ʝi˥ | le˧-tsɑ˧˥, | le˧-tsɑ˧˥, | le˧-tsɑ˧˥ ◊ -kwɤ˩tɕɯ˩, | le˧-lv̩˧˥, | ə˧mi˧ lɑ˧ | mv̩˩˥, | ɲi˧-kv̩˧ lv̩˥-ɲi˩-kv̩˩, -tsɯ˩ mv̩˩ |
crdo-NRU_F4_HOUSEBUILDING2_HOUSEBUILDING2_S302.wav	tʰi˩˥, | ʈæ˧bɤ˧-ɳɯ˧ | ɖæ˩-lɑ˧so˧ | le˧-qæ˧˥, | tʰv̩˧-so˩! |
crdo-NRU_Mariage_De_La_Soeur_V3_Sister3_S064.wav	ə˧mɑ˧! | nɑ˩-ʐwɤ˥ pi˩-wɤ˩, | hæ˧-ʐwɤ˩ <h…> | ʂæ˧ɕi˧-ɲi˥-ze˩ mæ˩! ◊ ə˩-gi˩! |
crdo-NRU_F4_MUSHROOMS_MUSHROOMS_S149.wav	so˧-ɬi˧mi˧ kʰɤ˧ʂɯ˧-dʑo˧, | wɤ˩˥, | mo˩kv̩˧ tʰv̩˧-kv̩˩-ze˩. | mo˩kv̩˥! |
crdo-NRU_F4_DOG2_Dog2S005.wav	zo˩no˥, | kʰv̩˩mi˩-ʈʂʰɯ˥, | ʂæ˧-tsɯ˧˥ ◊ -mv̩˩!
crdo-NRU_F4_FUNERAL_F4_FUNERAL_S210.wav	ə˧mv̩˧-go˧mi˥ | qʰɑ˩jɤ˩ dʑo˩˥, | hĩ˧-ɳɯ˩, | ɑ˩pʰo˩-hĩ˩-ɳɯ˥-dʑo˩, | <tɕʰi˩˥ | le…> tɕʰi˩tʰv̩˩-hĩ˥ | mɤ˧-ʈʂɤ˧! |
crdo-NRU_F4_HOUSEBUILDING2_HOUSEBUILDING2_S221.wav	ʂɯ˧-hĩ˥, | ʈʂʰɯ˧-kʰwɤ˥-lɑ˩ ɲi˩! |
crdo-NRU_F4_CARAVANS_CaravansS084.wav	"ʈʂʰɯ˧ne˧-ʝi˥ | le˧-tɕɯ˧-le˥-po˩-tsʰɯ˩! | tʰi˩˥, | əəə… ho˧di˧-ɳɯ˧ |
			le˧-tɕɯ˧-le˥-po˩-tsʰɯ˩ | tʰi˩˥, | ho˧di˧-ɕi˧ʈʂʰwæ˧-pi˧, | ə˧ʝi˧-ʂɯ˥ʝi˩! |"
crdo-NRU_F4_DOG2_Dog2S088.wav	go˩bo˥ | ɖɯ˧-tɑ˧˥, | kʰv̩˩mi˩˥ | ɖɯ˧-pi˧˥ | zɯ˧ ʂæ˧! |
crdo-NRU_AGRICULTURAL_ACTIVITIES_Agriculture_S056.wav	õ˧˥ | ɖɯ˧-kʰv̩˧-hĩ˥ | ʈʂʰɯ˧-lɑ˩ ɲi˩. |
crdo-NRU_F4_FOOD_SHORTAGE_FoodShortageS050.wav	"tʰi˩˥, | ʈʂʰɯ˧ne˧-ʝi˥ | ɖɯ˧-ʑi˩ | le˧-tsɤ˧… -kwɤ˧tɕɯ˥-lɑ˩ | tʰi˩˥, | ""ə˧sɯ˩kv̩˩, | tsʰi˧qʰæ˧˥ ◊ -dʑo˩, | mɤ˧-ɖwæ˩-ze˩!"" | pi˧, | ɖɯ˧-ʑi˩=ɻ̍˩-dʑo˩ | tʰi˩˥, | tsʰi˧qʰæ˧˥, | ə˧dɑ˥ F | le˧-fv̩˧! | ə˧mi˧ F | le˧-fv̩˧! | zo˧mv̩˥ F | le˧-fv̩˧! |"
crdo-NRU_F4_FUNERAL_F4_FUNERAL_S123.wav	ʐɯ˧ hwɤ˩-hĩ˩ | ʈʂʰɯ˧-dʑo˩ | tʰi˩˥, | ə˧tse˧ ʝi˧-zo˥ | ʐɯ˧ hwɤ˩-ɲi˩? | pi˧-hĩ˧ | ʈʂʰɯ˧-dʑo˩, |
crdo-NRU_F4_MUSHROOMS_MUSHROOMS_S055.wav	tʰi˩˥, | mo˧-ʈʂʰɯ˥, | <le˧-…> ʂɯ˧-ɬi˧mi˧, | mo˧ɖʐv̩˥-lɑ˩ | mo˧-ʈʂʰɯ˥ | le˧-ɖʐɤ˧-po˥-jo˩-dʑo˩! |
crdo-NRU_F4_FUNERAL_F4_FUNERAL_S025.wav	hĩ˧-ʈʂʰɯ˧-dʑo˩, | hĩ˧ mo˥-hĩ˩-ʈʂʰɯ˩, | nɑ˩-ʈʂʰɯ˥-dʑo˩, | gɤ˧qo˥ | pi˧-zo˩! |
crdo-NRU_AGRICULTURAL_ACTIVITIES_Agriculture_S034.wav	wɤ˩˥ | le˧-tv̩˧-se˩, | <wɤ˩˥ le˧… wɤ˩˥…> wɤ˩˥ | le˧-ʐwæ˩~ʐwæ˩! |
crdo-NRU_F4_ELDERS3_Elders3S011.wav	mmm… ə˧ʑi˧˥, | ɖɯ˩mɑ˧-ɬɑ˩tsʰo˩ pi˩-hĩ˩ ɖɯ˩-v̩˩ dʑo˩-ɲi˩-tsɯ˩ ◊ -mv̩˩!
crdo-NRU_F4_FUNERAL_F4_FUNERAL_S014.wav	əəə… zo˩no˥, | <gv… zo˩no˥, > gv̩˩-kv̩˩-hĩ˥-ʈʂʰɯ˩, | zo˩no˥, | hĩ˧ | ʁwɤ˧-qo˧-pʰæ˧tɕi˥-tʰv̩˩, | zo˩no˥, | sɯ˧-hĩ˧ | ɖɯ˧-v̩˧ dʑo˩-kv̩˩-mæ˩! |
crdo-NRU_F4_FOOD_SHORTAGE2_FOOD_SHORTAGE2S021.wav	mv̩˩si˧-njɤ˧˥, | njɤ˩-lɑ˥ | gɤ˩-ʈi˧ hɯ˩… | əəə… se˧-hɯ˩-dʑo˩ | tʰi˩˥, | <ʁwɤ˧ | ɖɯ˧-ɭɯ˧… |> qo˩qɑ˩˥ | ɖɯ˧-ɭɯ˧ ɖæ˩-dʑo˩, | tʰi˩˥, | qo˩qɑ˩-ʈʰæ˩qo˥ | tʰv̩˧-qo˧ tʰv̩˧-kwɤ˧tɕɯ˥-lɑ˥, | di˩li˩-ʁo˩bv̩˥-ʈʂʰɯ˩, | qʰɑ˩jɤ˩ tʰi˩-di˥-tsɯ˩ | mv̩˩!
crdo-NRU_F4_HOUSEBUILDING2_HOUSEBUILDING2_S148.wav	"""ə˧mi˧! | ə˧ɲi˥-lɑ˩ | ʂɯ˧ɲi˥-dʑo˩, | dʑɯ˧ | mɤ˧-ɖɯ˧-ɲi˥-wɤ˩! | tsʰi˧ɲi˧-dʑo˩, | æ̃˩ʂe˧-v̩˥dʑɯ˩ ʈʰɯ˩-kʰɯ˩-bi˩-ze˩!"" | pi˧-zo˩, | wɤ˩˥ | mmm… | æ̃˩ qʰo˧-kv̩˥ mæ˩! |"
crdo-NRU_F4_CARAVANS_CaravansS105.wav	hæ̃˩-bɑ˥lɑ˩-bɑ˩lɑ˩ le˩-po˩-jo˩-kv̩˩-mæ˩! |
crdo-NRU_Naissance_du_Lac_V3_Lake3_S032.wav	"ʈʂʰɯ˧ne˧-ʝi˥, -zo˩, | tʰi˩˥, | ɖɯ˧-njɤ˧ | ʈʂʰɯ˧ne˧-ʝi˥ | dʑo˩: | ""ə˧mi˧! | ə˧tso˧ ɲi˩-kv̩˩-hɯ˩ wɤ˩!"" |"
crdo-NRU_F4_TIGER2_Tiger2S135.wav	õ˧-bv̩˥-õ˩ | tʰi˩˥, | ə˧tso˧-mɤ˧-ɲi˩, | le˧-ʝi˥, | tʰv̩˧-tsɯ˧˥ ◊ -mv̩˩! |
crdo-NRU_F4_FOOD_SHORTAGE_FoodShortageS006.wav	"""kʰv̩˧tɕʰi˧ mɤ˧-dʑo˧-ze˧! | tʰi˩˥, | mv̩˩ tɕʰi˩-bi˩-zo˩-ho˥ F -di˩!"" | pi˧-zo˩ | tʰi˩˥, | hɯ˧-ɲi˥-tsɯ˩ ◊ -mv̩˩!"
crdo-NRU_Naissance_du_Lac_V3_Lake3_S058.wav	tʰi˩˥, | hi˩nɑ˧mi˧ tsɤ˧-kwɤ˩tɕɯ˩-lɑ˩, | hĩ˧-ʈʂʰɯ˧, | ʝi˧kʰv̩˥-dʑo˩, | dʑɯ˩-ʈʰæ˩qo˥ dʑo˩ hɯ˩-ɲi˩-ze˩, tsɯ˩ mv̩˩. |
crdo-NRU_F4_HEALING_HealingS032.wav	əəə… dʑɯ˩-tsʰi˧, | ɖɯ˧-v̩˧ | tʰi˧-tsi˥-tsɯ˩ ◊ -mv̩˩. |
crdo-NRU_F4_DOG2_Dog2S060.wav	"ʈʂʰɯ˧ne˧ ʝi˥-dʑo˩ | tʰi˩˥, | kʰv̩˩mi˩-ki˥ | əəə… ""tsʰi˧ʝi˧-dʑo˩, | hi˩ gi˩-ho˥-pʰæ˩-di˩! | dʑɯ˧ ʈʰɯ˧!"" | pi˧. |"
crdo-NRU_Mariage_De_La_Soeur_V3_Sister3_S135.wav	"to˩mi˩ dɑ˥-kv̩˩-tsɯ˩ ◊ -mv̩˩, | ʈʂʰɯ˧-qo˧ | ɖɯ˧-dɑ˧˥, | kʰi˧bɤ˧ | <sɯ˩>
			<ɖɯ˧-dɑ˧˥> | [ɖɯ˧-dɑ˧ tʰi˥-dɑ˩ | ]!"
crdo-NRU_F4_HOUSEBUILDING2_HOUSEBUILDING2_S186.wav	"""ə˧mi˧! | u=ɻ˩ | qʰɑ˧tɑ˧ <tɑ˧> dɑ˧-bi˥? | ze˩-kɯ˥-qo˩ tʰv̩˩-bi˩?"" | pi˧. |"
crdo-NRU_AGRICULTURAL_ACTIVITIES_Agriculture_S044.wav	gv̩˩ɬi˩mi˩˥ | tʰi˧-ɬi˧˥, | tsʰe˧ɬi˧mi˧ | tʰi˧-ɬi˧˥, | ʐe˧ʈæ˥ɬi˩ | tʰi˧-ɬi˧˥, |
crdo-NRU_F4_HOUSEBUILDING2_HOUSEBUILDING2_S333.wav	õ! tʰi˩˥, | tʰv̩˧-ɲi˧-dʑo˩, | ə˧tso˧ mɤ˧-ɲi˩ | hĩ˧ ʁɑ˧ʂe˥, | hĩ˧ | le˧-ʁɑ˥ʂe˩ | le˧-po˧-tsʰɯ˧˥, | dʑɤ˩˥ | le˧-tsʰo˧. |
crdo-NRU_F4_MOUNTAINS_F4_MountainsS068.wav	õ˧ʈʂʰɯ˧ne˧ ʝi˥-pi˩-zo˩, | njɤ˧… | ə˧ʝi˧-ʂɯ˥ʝi˩! | ə˧si˧-ɳɯ˧ | ʈʂʰɯ˧ne˧-ʝi˥ | ʐwɤ˩-kv̩˩˥ | mv̩˩! |
crdo-NRU_F4_HOUSEBUILDING2_HOUSEBUILDING2_S282.wav	ʑi˧qʰwɤ˧ | le˧-…dɑ˧˥, | le˧-tʰv̩˧-dʑo˥ | tʰi˩˥, | ʑi˧qʰwɤ˧-qo˧ | tʰi˧-dzi˩! |
crdo-NRU_Naissance_du_Lac_V3_Lake3_S034.wav	«ɲi˧zo˧ ʈʂʰɯ˧ | ɖɯ˧-mi˩ | tʰi˧-dʑo˩, | ʈʂʰɯ˧ ə˧tse˧-ɲi˥-hɯ˩!» | pi˧, -dʑo˩ | tʰi˩˥, |
crdo-NRU_F4_MUSHROOMS_MUSHROOMS_S133.wav	"""no˧ | ə˧tso˧ mo˧-ɲi˥?"" | pi˧, əəə… ""njɤ˧ | <ki˧mo˧, ə˧tsɯ˧, əəə… əəə…> ʈʂæ˧mo˧-kʰi˧tɕʰɯ˩mo˩!"" | pi˧-zo˩, | tʰv̩˧-ʁo˥ bv̩˩-dzɯ˩-ɲi˩-pi˩-zo˩, | le˧-dv̩˩-ɲi˩-kv̩˩-tsɯ˩-mv̩˩! |"
crdo-NRU_F4_TIGER2_Tiger2S060.wav	"""ə˧mi˧! | lɑ˧-ʈʂʰɯ˧ | hĩ˧ ʈʰæ˩-ho˩-pi˩, | mæ˧qv̩˩-sɯ˩ | ɖwæ˧-kv̩˥!"" | pi˧-tsɯ˩ ◊ -mv̩˩. |"
crdo-NRU_F4_FUNERAL_F4_FUNERAL_S107.wav	tʰi˩˥, | ʝi˧kʰv̩˥-dʑo˩, | <ŋv̩˧-ki˧…>, | ɖʐe˧ ki˧-kv̩˧˥! |
crdo-NRU_Naissance_du_Lac_V3_Lake3_S010.wav	li˩˥ | ɖɯ˧-qʰwɤ˧ tʰi˥-tɕɤ˩! |
crdo-NRU_F4_MUSHROOMS_MUSHROOMS_S023.wav	mmm… zo˩no˥, | əəə… tʰo˧-mo˩-ʈʂʰɯ˩, | ʈʂe˧-qo˩-ɳɯ˩ | gɤ˩-ʑi˥-ɲi˩! | dzɯ˧-tʰɑ˩!
crdo-NRU_F4_DOG2_Dog2S057.wav	"dʑɯ˧ ʈʰɯ˧-kwɤ˧tɕɯ˥-lɑ˩, | ""ə˧mi˧! | tsʰi˧ʝi˧-se˥…"" | dʑɯ˧ ʈʰɯ˧… | hi˧lɤ˩ | dʑɯ˩-sɯ˥ | ʈʰɯ˩˥, | hi˧ ɖɯ˧-ho˩ F -di˩!"" | pi˧-zo˩, | æ˧ʂæ˧ | ʈʂʰɯ˧ne˧-ʝi˥ | ʐwɤ˩-kv̩˩˥ ◊ -mæ˩!"
crdo-NRU_F4_TIGER2_Tiger2S045.wav	bv̩˩hwɤ˩-pi˥-zo˩ | tʰi˩˥, | <lo˧, əəə…> bv̩˩lv̩˩-hĩ˥-ɳɯ˩ | ʑi˧qʰwɤ˧ le˧-dɑ˧˥, | tʰi˧-dzi˩ | əəə… -dʑo˩! | bv̩˩lv̩˩-hĩ˥ | ʈʂʰɯ˧-dʑo˩ | tʰi˩˥, | əəə… mv̩˧ʐe˧-qo˥, | so˧ɬi˧-qʰv̩˧ɬi˥-dʑo˩, | mv̩˧ʈʰæ˧! | ɖɯ˧-pi˧˥ | mv̩˧ʈʰæ˧ ʂe˧~ʂe˧ | lv̩˩-ʝi˥-kv̩˩-mæ˩! | zɯ˧ tʰi˧-di˧! |
crdo-NRU_F4_HOUSEBUILDING2_HOUSEBUILDING2_S289.wav	kʰv̩˧˥ | le˧-ʈʂɤ˧-zo˩! |
crdo-NRU_F4_COMING_OF_AGE2_F4_ComingOfAge2S092.wav	"""te! | no˧ | ʐwæ˩-ze˥! | zɯ˧ ʂæ˧ hɑ̃˧-ʝi˧-kʰɯ˩, | ə˧-sɯ˥! | dʑɤ˩-kʰɯ˥! | ti˧mv̩˧bv̩˧ɻ̍˧ | dʑɤ˩-kʰɯ˥!"" | pi˧, | wɤ˩˥ | ɖʐe˧ | ɖɯ˧-kʰwɤ˥ tʰi˩-ki˩! |"
crdo-NRU_F4_FOOD_SHORTAGE2_FOOD_SHORTAGE2S046.wav	"""ʁwɤ˧ | ɖɯ˧-ɭɯ˧-ʈʰæ˧qo˩ tʰv̩˩-dʑo˩, | di˩li˩-ʁo˩bv̩˥ | qʰɑ˩jɤ˩ tʰi˩-di˥-zo˩, | ʁɑ˩mi˧!"" |"
crdo-NRU_F4_FOOD_SHORTAGE_FoodShortageS072.wav	lwɤ˩ tʰi˥-kʰɯ˩ | le˧-tɕɤ˧-se˥-dʑo˩ | tʰi˩˥, | dʑɯ˧-qo˧-ɳɯ˧ | le˧-ʈʂʰæ˧-bi˧! |
crdo-NRU_F4_MUSHROOMS_MUSHROOMS_S126.wav	ʈʂʰɯ˧-ʁo˥ | ʈʂʰɯ˧-dʑo˩, | <kʰv…> le˧-ɖʐɤ˧˥ | le˧-dzɯ˥-pi˩, | hĩ˧ | le˧-ʂɯ˧-ɲi˥-ze˩! |
crdo-NRU_F4_TIGER2_Tiger2S084.wav	lɑ˧… | lɑ˧-lɑ˧, | ə˧mi˧-gi˧˥, | pʰo˩-ɲi˥-pi˩-tsɯ˩ ◊ -mv̩˩! | lɑ˧-ɳɯ˧ | ə˧mi˧ | ʐɯ˩-ɳɯ˥ | ʐɯ˩-pi˥ | ʈɤ˧! | mv̩˩˥ | <pʰo˩… hõ… qʰɑ˩ne˩˥…>[qʰɑ˩ne˩˥ | pʰo˩-ɲi˥-pi˩-tsɯ˩ ◊ -mv̩˩!]
crdo-NRU_F4_FUNERAL_F4_FUNERAL_S231.wav	pɤ˩jɤ˧ ti˥ | -no˧˥, | so˩ɲi˩-ʐv̩˩ɲi˩ ti˥-zo˩-kv̩˩, | hĩ˧ ʂɯ˧-hĩ˧-tʰv̩˧! | nɑ˩ hĩ˧ ʂɯ˧-hĩ˧ ʈʂʰɯ˧! |
crdo-NRU_F4_CARAVANS_CaravansS242.wav	"lo˧pæ˧ le˧-tsɤ˧-se˩-dʑo˩, | tʰi˩˥, | ə˧ʝi˧-ʂɯ˥ʝi˩, | əəə… ho˧di˧! | əəə… ho˧di˧ |
			ɖæ˩mi˧-qo˧<-ɳ>… ɖæ˩mi˧-sɯ˩pʰi˩=ɻ̍˩-ɳɯ˩, | ""ho˧di˧ ɕi˧ʈʂʰwæ˧ tɕɯ˧-hõ˧!"" | pi˧, |
			ho˧di˧ ɕi˧ʈʂʰwæ˧ le˧-tɕɯ˧-le˥-po˩-tsʰɯ˩! |"
crdo-NRU_F4_FOOD_SHORTAGE_FoodShortageS090.wav	tʰi˩˥, | zo˩no˧-ni˩-zo˩, | ə˧tso˧~ə˧tso˥ v̩˩tsʰɤ˩, | po˧po˧tsʰɤ˧˥ | mɤ˧-dʑo˧! |
crdo-NRU_F4_HOUSEBUILDING2_HOUSEBUILDING2_S264.wav	ɳɯ˩dʑɯ˥ | ɖɯ˧-v̩˥ tʰi˩-tɕɤ˩! | v̩˩tsʰɤ˧-tæ˧pv̩˥ | ɖɯ˧-v̩˥ tʰi˩-tɕɤ˩! | ʈʂwæ˧ʈʂwæ˧-ɻ˥ | ɖɯ˧-v̩˥ tʰi˩-tɕɤ˩!
crdo-NRU_F4_ELDERS3_Elders3S048.wav	dʑɤ˩-hĩ˥, | zo˩qo˧ dʑo˩-ɻ̍˩-dʑo˩, | zo˩qo˧ <so… ʝ…> so˩-zo˩-kv̩˩! |
crdo-NRU_F4_TIGER2_Tiger2S033.wav	tʰv̩˧qo˧-ki˧ ◊ -dʑo˩ | tʰi˩˥, | mv̩˩˥ ◊ -dʑo˩ | tʰi˩˥, | ɖɯ˧-hɑ̃˧˥ ◊ -dʑo˩, | le˧-bi˩, | pi˧-tsɯ˩ ◊ -mv̩˩. |
crdo-NRU_F4_MUSHROOMS_MUSHROOMS_S125.wav	tʰi˩˥ | wɤ˩˥ | di˧qo˧-ʈʂʰɯ˧, | mo˧-ʈʂʰɯ˥, | di˧qo˧ | qʰɑ˩jɤ˩ di˥-kv̩˩! | qʰæ˧mo˩ pi˩-hĩ˩ ɖɯ˩-ʁo˩ di˩-kv̩˩! | qʰɑ˧dze˧-lv̩˧-qo˧-gɤ˧!
crdo-NRU_F4_HOUSEBUILDING2_HOUSEBUILDING2_S065.wav	ɖɯ˧-ɲi˥ | ʈʰææ̃˧ | ʈʂe˧ dɑ˥ ho˩-bi˩-bi˩, | <ə˧ʝi˧-tsʰi˧ʝi˧, | > ə˧ʝi˧-ʂɯ˥ʝi˩-dʑo˩, | ʈʂe˧ dɑ˥ lɑ˩ ho˩-ɲi˩ mæ˩! |
crdo-NRU_F4_FOOD_SHORTAGE_FoodShortageS105.wav	ɖɯ˧-dzi˧!
crdo-NRU_F4_FOOD_SHORTAGE2_FOOD_SHORTAGE2S058.wav	hwɤ˧tɕi˥-ʁo˩bv̩˩ | ʈʂʰɯ˧-dʑo˩ | tʰi˩˥, | hṽ˩-ɖʐæ˩ɻæ˥-zo˩ | ʈʂʰɯ˧ne˧-ʝi˥ | gɤ˩-ʑi˥-tsɯ˩ ◊ -mv̩˩. |
crdo-NRU_F4_CARAVANS_CaravansS097.wav	"""njɤ˧ | ʐwæ˧ tʰv̩˧-v̩˧ | no˧ | ɖɯ˧-tɕɯ˧-ɻ̍˥! | njɤ˧-pʰi˩ ʈʂʰɯ˩-kʰwɤ˩ | no˧ |
			ɖɯ˧-tɕʰi˧-qɑ˩-ɻ̍˩!"" | pi˧, | tʰi˧-hwɤ˩. |"
crdo-NRU_F4_FUNERAL_F4_FUNERAL_S002.wav	ʁwɤ˧-qo˧-ʈʂʰɯ˧ | tʰi˩˥, | hĩ˧-ʈʂʰɯ˧, | no˧=ɻ̍˩ | hĩ˧ mo˥-hĩ˩ | ɖɯ˧-v̩˧ ʂɯ˧-ze˧ | pi˧, | tʰi˩˥, | tsʰo˧qʰwɤ˩ | le˧-ʂɯ˧, | pi˧-dʑo˩ | tʰi˩˥, | mv̩˩sɯ˧-njɤ˧-ki˥, | <tsʰo˧qʰwɤ˩-dʑo˩ | tʰi˩˥,> | mmm… ʈæ˧bɤ˧ | le˧-ʁɑ˥-ʂe˩. |
crdo-NRU_F4_DOG2_Dog2S043.wav	hɑ˧ | ɖɯ˧-kʰwɤ˧ ʑi˧˥, | qwæ˩ʈʂæ˩-qo˥ | tʰi˧-kʰɯ˧˥! |
crdo-NRU_F4_FUNERAL_F4_FUNERAL_S127.wav	njɤ˧=ɻ̍˩ | ɑ˩ʁo˧ | qʰɑ˩ne˩ gv̩˩˥, | no˧-ki˧ | ʈʂʰɯ˧ne˧-ʝi˥ | <qʰwæ˧ pi˩…> qʰwæ˧ hwɤ˩-tsʰɯ˩-pi˩! |
crdo-NRU_F4_ELDERS3_Elders3S060.wav	njæ˧sɯ˩kv̩˩ | zo˧mv̩˥-lɑ˩ dʑo˩-ze˩! | ə˧mi˧ | ɖɯ˧-v̩˧-lɑ˧ dʑo˧-ze˥! |
crdo-NRU_AGRICULTURAL_ACTIVITIES_Agriculture_S052.wav	lo˧-ʝi˧-di˧˥ ◊ -dʑo˩, | ə˧ɲi˧-tsʰi˧ɲi˧, | lv̩˧-qo˧ | lo˧-ʝi˧-di˧˥ ◊ -dʑo˩ | mɤ˧-dʑo˧-ɲi˥-ze˩ mæ˩! |
crdo-NRU_F4_DOG2_Dog2S027.wav	mmm… hĩ˧-dʑo˩, | qʰv̩˩tsʰi˧-kʰv̩˥ ʝi˩-tsɯ˩ ◊ -mv̩˩! |
crdo-NRU_Naissance_du_Lac_V3_Lake3_S035.wav	ɑ˩ʁo˧ | le˧-hɯ˩-hĩ˩ | tʰv̩˧-v̩˧-ɳɯ˩, -dʑo˩ | tʰi˩˥, | li˧-hɯ˧-ɲi˥-tsɯ˩, | ʐwɤ˩-ɲi˥-tsɯ˩ ◊ -mv̩˩. |
crdo-NRU_F4_HEALING_HealingS085.wav	"tʰi˩˥, | dɑ˧pɤ˧-ʈʂʰɯ˧-dʑo˩, | wɤ˩˥, | si˧kʰɯ˧ɭɯ˧-bv̩˥ | ɖɯ˧-ʁo˩ dʑo˩-kv̩˩! | si˧kʰɯ˧!
			|"
crdo-NRU_F4_CARAVANS_CaravansS146.wav	"""ə˧mi˧! | njɤ˧-zo˧ le˧-mɤ˧-tsʰɯ˧˥"", | pi˧-zo˩, | ə˧mi˧ | ʁɑ˩ʂɯ˧ | <ɕi˧tjɤ˧
			kv̩˧-ɲi˥…> ʂv̩˧ɖv̩˧ tʰv̩˧-kv̩˩-ɲi˩-ze˩! |"
crdo-NRU_F4_MUSHROOMS_MUSHROOMS_S103.wav	<ʈʂʰɯ˧ne˧-ʝi˥…> æ˧ʂæ˧-qʰwɤ˧˥, | ʈʂʰɯ˧ne˧-ʝi˥ | dʑo˧-kv̩˥-mæ˩! |
crdo-NRU_F4_FUNERAL_F4_FUNERAL_S211.wav	ʈʂʰɯ˧ne˧-ʝi˥ | pɤ˩jɤ˧ qʰæ˥-kv̩˩-mæ˩! |
crdo-NRU_F4_HEALING_HealingS078.wav	ɖɯ˧-njɤ˧ ʈʂʰɯ˧ne˧ ʝi˥-kv̩˩! |
crdo-NRU_AGRICULTURAL_ACTIVITIES_Agriculture_S067.wav	v̩˩tsʰɤ˧˥, … | ə˧tso˧-mɤ˧-ɲi˩ | dʑo˧-ɲi˥! | tsʰo˧tsɯ˧, | kv̩˧! | tɑ˧˥sæ˧-ki˥-dʑo˩, | « kv̩˧ » | pi˧-kv̩˩ mæ˩! |
crdo-NRU_F4_HEALING_HealingS060.wav	"ʈʂʰɯ˧ | le˧-ʈʂʰo˧, | le˧-ʈʂʰo˧, | le˧-ʈʂʰo˧-dʑo˥, | õ˧-bv̩˥-õ˩ | hi˩mi˩-po˥-ɳɯ˩ |
			le˧-jɤ˧˥, | le˧-ʈʂʰo˧! |"
crdo-NRU_F4_FOOD_SHORTAGE2_FOOD_SHORTAGE2S078.wav	"""hwɤ˧tɕi˥-ʁo˩bv̩˩ tʰv̩˩, <æ˧ʂæ˧…> æ˧ʂæ˧-tɑ˩mv̩˩, | <ə˧… ə˧ʑi˧-m…-no˧…> ə˧ʑi˧-no˧-sɯ˧kv̩˥-ɳɯ˩ | ʐwɤ˩-kv̩˩˥ | mɤ˧-kv̩˧˥?"" |"
crdo-NRU_F4_FOOD_SHORTAGE_FoodShortageS070.wav	le˧-bo˧-se˩ | tʰi˩˥ | wɤ˩˥ | <l…> le˧-tɕɤ˧˥! | õ! tʰi˩˥, | sɑ˧pʰv̩˧˥ | ʈʂʰɯ˧ne˧-ʝi˥ | wɤ˩˥ | le˧-gv̩˩. |
crdo-NRU_F4_FOOD_SHORTAGE2_FOOD_SHORTAGE2S091.wav	õ˧ʈʂʰɯ˧ne˧-ʝi˥… | ɖɯ˧-kʰwɤ˧ dʑo˧-ɲi˥-tsɯ˩ ◊ -mv̩˩. |
crdo-NRU_F4_FOOD_SHORTAGE2_FOOD_SHORTAGE2S002.wav	tʰi˩˥, | kʰv̩˧qʰwɤ˧ tʰv̩˧˥ | tʰv̩˧-kʰv̩˩-dʑo˩ | tʰi˩˥, | zo˩no˥, | əəə… ɖwæ˧˥… | hĩ˧-ʈʂʰɯ˧, | hɑ˧-ʐwɤ˩-kv̩˩-tsɯ˩ ◊ -mv̩˩! |
crdo-NRU_F4_FUNERAL_F4_FUNERAL_S032.wav	mmm… tsʰe˧-ɲi˧-ɬi˩! | zo˩no˥! | ɬi˧-qo˧-ɳɯ˧ | le˧-ɬi˩. |
crdo-NRU_F4_MUSHROOMS_MUSHROOMS_S160.wav	ə˧ʝi˧-ʂɯ˥ʝi˩, | nɑ˩-ʈʂʰɯ˥-dʑo˩, | ɖɯ˧-pi˧˥ | bæ˩-ɲi˥-ho˩-ze˩-wɤ˩! |
crdo-NRU_F4_TIGER2_Tiger2S009.wav	"əəə… ""ə˧dɑ˧! | ə˧tse˧ ʝi˧-ɲi˥? | njɤ˧ | tsʰi˧-ɲi˧ | dʑɯ˩ʁo˩˥ | tʰv̩˧-qo˧ | lɑ˧ ɖɯ˧-pʰo˧ do˧-zo˥! | njɤ˧ | le˧-ɖwæ˩-zo˩, | le˧-pʰo˩, | le˧-pʰo˩, | le˧-pʰo˩-zo˩!"" |"
crdo-NRU_F4_DOG2_Dog2S002.wav	zo˩no˥… | hĩ˧mo˥=ɻæ˩-ɳɯ˩ | ʈʂʰɯ˧ne˧-ʝi˥ | ʐwɤ˩-kv̩˩-wɤ˥! |
crdo-NRU_F4_HOUSEBUILDING2_HOUSEBUILDING2_S204.wav	bo˩ʈʂʰæ˧-qo˩-dʑo˩ | tʰi˩˥, | wo˩-v̩˥tsʰɤ˩ tʰi˩-kʰɯ˩. |
crdo-NRU_F4_CARAVANS_CaravansS172.wav	õ˧ʈʂʰɯ˧ne˧-ʝi˥ | ʐwɤ˩-kv̩˩˥ ◊ -mæ˩!
crdo-NRU_F4_FUNERAL_F4_FUNERAL_S188.wav	ʈʂʰɯ˧ | go˧bɤ˩-bv̩˩ | ɖɯ˧-ɭɯ˧… | ʈæ˩tsʰo˥ | ɖɯ˧-ɭɯ˧… | hĩ˧ ɲi˥-pi˩-zo˩! | ɖɯ˧-ɭɯ˧ ɖɯ˧-kv̩˧-ze˥-mv̩˩! | pi˧-hĩ˧, | mv̩˧ʈʂæ˧-kv̩˥-tsɯ˩ ◊ -mv̩˩! | ʈæ˩tsʰo˥ | ɖɯ˧-ɭɯ˧ ɲi˩! | pi˧-zo˩. | ɖɯ˧-ʈæ˩tsʰo˩ ɲi˩-pi˩-kv̩˩-tsɯ˩ ◊ -mv̩˩!
crdo-NRU_F4_HOUSEBUILDING2_HOUSEBUILDING2_S169.wav	tʰi˩˥, | so˧ʝi˥-dʑo˩ | dɑ˧˥! |
crdo-NRU_F4_TIGER2_Tiger2S130.wav	"əəə… ""ʈʂʰæ˩~ʈʂʰæ˩˥ | kɤ˧wɤ˧-ljɤ˧ɳɯ˥, | ə˧mi˧ le˧-ʈʰæ˧˥, | ɖɯ˩lo˧ dʑo˧-ɲi˥-ʝi˩-ze˩!"" |"
crdo-NRU_F4_RENAMING_RenamingS040.wav	"ɖɯ˧-kʰv̩˧˥ ◊ -dʑo˩, | bɑ˩lɑ˩˥ | ɖɯ˧-kʰwɤ˥ ki˩. | ɖɯ˧-kʰv̩˧˥ ◊ -dʑo˩, | lo˩dʑo˥ |
			ɖɯ˧-kʰwɤ˥ ki˩. | õ˧ʈʂʰɯ˧ne˧ ʝi˥-kv̩˩, | ə˧ʝi˧-ʂɯ˥ʝi˩! |"
crdo-NRU_F4_MOUNTAINS_F4_MountainsS160.wav	tʰi˩˥, | ʈʂʰɯ˧ne˧ ʝi˥-se˩-dʑo˩ | tʰi˩˥, | æ˧ʂæ˧ gwɤ˩ | ɖɯ˧-ɲi˥-dʑo˩, | so˧ | le˧-qæ˧˥, | ə˧sɯ˩kv̩˩ | pɤ˧-ʈʂʰɯ˧ | le˧-lɑ˧˥, | po˧-bi˥, | æ˧ʂæ˧-ki˧ | tʰi˧-pʰæ˧˥, |
crdo-NRU_F4_CARAVANS_CaravansS088.wav	"tʰi˩˥, | æ˧ʂæ˧-tɑ˩mv̩˩… | æ˧ʂæ˧-tɑ˩mv̩˩ | ʈʂʰɯ˧ne˧-ʝi˥ | pi˧-kv̩˥-mæ˩: | ""ho˧ di˧, pʰi˩
			tɕʰɯ˩-jɤ˩; | ɬɑ˧sɑ˧, zo˧ tɕʰɯ˩-jɤ˩!"" -pi˩. |"
crdo-NRU_AGRICULTURAL_ACTIVITIES_Agriculture_S047.wav	le˧-ɬi˥! |
crdo-NRU_F4_COMING_OF_AGE2_F4_ComingOfAge2S025.wav	<hĩ˧…> ʈʂʰɯ˧-dzɤ˧ le˧-hɯ˧-hĩ˥<əəə…>-qo˩-ɳɯ˩ | ki˩-kʰɯ˩˥! |
crdo-NRU_F4_TIGER2_Tiger2S113.wav	"""<no˧… | ə˧zɯ˩…> | hĩ˧-ʈʂʰɯ˧-dʑo˩, | ə˧dɑ˧-ə˧mi˧, | no˧-sɯ˩kv̩˩ | zɯ˧ pv̩˩-mɤ˩-kv̩˩!"" |"
crdo-NRU_F4_FUNERAL_F4_FUNERAL_S227.wav	ʈʂʰɯ˧ne˧-ʝi˥ | qʰæ˧-kv̩˥-mæ˩! | ɖʐv̩˧ʐv̩˧-ɖʐv̩˧mi˧-dʑo˩. |
crdo-NRU_F4_FUNERAL_F4_FUNERAL_S046.wav	ɖɯ˧-sɑ˥ F | pv̩˩-tʰɑ˩-kʰɯ˥! | bv̩˧ɻ̍˧ | pv̩˩tʰɑ˩-kʰɯ˥! | õ˧ʈʂwɤ˧ | pv̩˩tʰɑ˩-kʰɯ˥! | hwɤ˧li˥ se˩-tʰɑ˩-kʰɯ˩! |
crdo-NRU_F4_TIGER2_Tiger2S146.wav	"""ə˧tso˧ ʝi˧-ɻ̍˩, | ə˧tso˧ ʝi˧-tʰv̩˧! | njɤ˧ | ə˧mɑ˧-ɳɯ˧ | ʁo˧ʐv̩˩ F -di˩!"" | pi˧-zo˩ | tʰi˩˥, |"
crdo-NRU_F4_CARAVANS_CaravansS223.wav	mv̩˧ɭɯ˩-lɑ˩ | ɖæ˩mi˧-sɯ˩pʰi˩-ʈʂʰɯ˩-dʑo˩, | tʰi˧-pʰæ˧~pʰæ˧ ɲi˥-ze˩-mæ˩! |
crdo-NRU_F4_HEALING_HealingS108.wav	zo˩no˥, | no˧sɯ˩kv̩˩-ni˩-gv̩˩, | ɖɯ˧-bæ˧-lɑ˧ ɲi˥! | ə˧tso˧ mɤ˧-ɲi˩! |
crdo-NRU_F4_FUNERAL_F4_FUNERAL_S019.wav	hæ˧-ni˩-zo˩, | əəə… mi˩zɯ˩-ʈʂʰɯ˥-dʑo˩, | mi˩zɯ˩-ɳɯ˥ | gv̩˧~gv̩˥ mɤ˩-kv̩˩! |
crdo-NRU_F4_CARAVANS_CaravansS276.wav	"õ˧ʈʂʰɯ˧ne˧-ʝi˥ | hĩ˧ ʝi˧! | əəə… ʐwæ˧ tɕɯ˩-zo˩ ʈʂʰɯ˩-dʑo˩, | dʑɯ˩nɑ˩mi˩-ʁo˩˥ |
			le˧-hɑ̃˧˥, | le˧-hɑ̃˧˥, | zo˩qo˧ tʰv̩˧-ɻ̍˧, | mv̩˩tsʰo˩˥ | le˧-dɑ˧˥, | si˧ le˧-gv̩˥, |
			ə˧so˧ tʰv̩˧-v̩˧ pi˧-ni˧˥, |"
crdo-NRU_F4_HOUSEBUILDING2_HOUSEBUILDING2_S001.wav	ʑi˧qʰwɤ˧-ʈʂʰɯ˧, | ə˧ʝi˧-ʂɯ˥ʝi˩-dʑo˩ | tʰi˩˥, | ʑi˧qʰwɤ˧… -ʈʂʰɯ˧, | ɖɯ˧-ɭɯ˧ tsʰi˧˥ | pi˧-dʑo˩, ◊ ə˩-gi˩! | tʰi˩˥, | əəə… ə˧tso˧ mɤ˧-ɲi˩, | le˧-ʂɯ˧~ʂɯ˧ tʰi˧-tɕɯ˥. |
crdo-NRU_F4_TIGER2_Tiger2S134.wav	ə˧mi˧ | le˧-mv̩˩-pʰæ˩-tɕɯ˩-kv̩˩-tsɯ˩ ◊ -mv̩˩! | ə˧mi˧-ɳɯ˧! |
crdo-NRU_F4_HOUSEBUILDING2_HOUSEBUILDING2_S209.wav	gv̩˩-ɬi˩mi˩-qo˥-ɳɯ˩, | le˧-hæ̃˩~hæ̃˩! | əəə… tæ˧pv̩˩ | le˧-gv̩˩! |
crdo-NRU_F4_FUNERAL_F4_FUNERAL_S061.wav	tʰi˩˥, | hĩ˧-ɳɯ˩ | mɤ˩mv̩˩ ʈʂv̩˥ jo˩-kv̩˩-mæ˩! | mɤ˩mv̩˩ ʈʂv̩˥-pi˩! |
crdo-NRU_F4_FOOD_SHORTAGE_FoodShortageS026.wav	tʰi˩˥, | ʈʂʰɯ˧ne˧-ʝi˥ | le˧-pi˧-se˥-dʑo˩ | tʰi˩˥, | gi˩˥, | gi˩˥, | gi˩˥, | le˧-se˥, | le˧-se˥, | le˧-se˥-dʑo˩ | tʰi˩˥, | dʑɯ˩nɑ˩mi˩˥ | ɖɯ˧-ɭɯ˧-qo˧ tʰv̩˧! |
crdo-NRU_F4_HOUSEBUILDING2_HOUSEBUILDING2_S154.wav	ə˧ʝi˧-ʂɯ˥ʝi˩-dʑo˩, | ʈʂʰɤ˧tsɯ˧-lɑ˧ | mɤ˧-dʑo˧! | hĩ˧-ɳɯ˩ | ↑ɖɯ˧-gɤ˧-ɳɯ˥, | ɑ˩ʁo˧ tʰv̩˧-ɲi˥! | gɯ˩-ʝi˥! |
crdo-NRU_F4_MUSHROOMS_MUSHROOMS_S065.wav	"tʰi˩˥, | ""ʈʂʰɯ˧-ɲi˧-dʑo˩, | kv̩˧ F | næ˩-qʰæ˥ʈʂʰe˩ gv̩˩-ze˩! | ə˧-sɯ˩kv̩˩, | tʰɑ˧-dzɯ˥-ze˩!"" | pi˧-zo˩. | dzɯ˧-mɤ˧-kv̩˩-ze˩-mæ˩! |"
crdo-NRU_F4_FUNERAL_F4_FUNERAL_S230.wav	tʰi˩˥, | hĩ˧ | ʂɯ˧-ze˧-pi˧, | pɤ˩jɤ˧˥ | le˧…-ti˩! |
crdo-NRU_F4_COMING_OF_AGE2_F4_ComingOfAge2S104.wav	tʰi˩˥, | ʈʰææ̃˧, | hæ̃˧qʰv̩˥, | dʑɤ˩tsʰo˧-kv̩˧-ze˥-mæ˩! |
crdo-NRU_F4_ELDERS3_Elders3S051.wav	"əəə… qɑ˧~qɑ˧-ɻ̍˥ | ɖɯ˧-tɑ˧˥ | le˧-ho˧~ho˥ | tʰi˧-dzi˩! | ə, pi˧-zo˩ | tʰi˩˥, |
			ʈʂʰɯ˧ne˧-ʝi˥ | ʐwɤ˩-kv̩˩˥ ◊ -mæ˩! |"
crdo-NRU_F4_SEEDS_SeedsS044.wav	tʰv̩˧ | ŋwɤ˩-bæ˩-hĩ˥ | ʈʂʰɯ˧-dʑo˩, | zo˩no˥, | dze˧ʈʂʰɤ˥ | pi˧-kv̩˩-mæ˩! |
crdo-NRU_F4_CARAVANS_CaravansS098.wav	"əəə… tʰi˩˥, | tʰi˧-hwɤ˩ | <le> [hɯ˧]-dʑo˥, | tʰi˩˥, | ʈʂʰɯ˧-v̩˧-ɳɯ˩, |
			le˧-tɕʰi˧-tʰv̩˧-dʑo˥ | tʰi˩˥, | wɤ˩˥, | ʈʂʰɯ˧sɯ˩kv̩˩-bv̩˩ | bɑ˩lɑ˩˥ | ʂe˧ʈʂe˩ hwæ˩ |
			le˧-po˧-jo˥-kv̩˩! |"
crdo-NRU_Mariage_De_La_Soeur_V3_Sister3_S089.wav	tʰi˩˥, | əəə… hĩ˧-ɳɯ˩-dʑo˩, | <n…> «õ˧ zo˧-ki˧ | dzɑ˧-ʝi˧-ze˩»-pi˩, | ə˧mv̩˧˥ ◊ -dʑo˩, | le˧-↑ʂæ˧ɕi˧-kʰɯ˩, | ʈʂʰɯ˧ne˧-ʝi˥ | hɯ˧-kwɤ˧tɕɯ˥-lɑ˩, | tʰi˩˥, | ə˧mv̩˧ | ʈʂʰɯ˧-v̩˥-dʑo˩, | tʰi˩˥, | <əəə…>
crdo-NRU_F4_HOUSEBUILDING2_HOUSEBUILDING2_S316.wav	no˧ | ɖɯ˧-kʰwɤ˧ ʐwɤ˥, | njɤ˧ | ɖɯ˧-kʰwɤ˧ ʐwɤ˥, | kɤ˧kɤ˩ | tʰi˧-dzi˩. |
crdo-NRU_F4_CARAVANS_CaravansS148.wav	zo˩no˧-ni˩, | no˧ | tjɤ˧hwɑ˧-lɑ˥-di˩ | mɤ˧-dʑo˧! |
crdo-NRU_AGRICULTURAL_ACTIVITIES_Agriculture_S060.wav	ɖɯ˧-kʰv̩˧˥ | ɖɯ˧-ʂɯ˩, | <ɖɯ˧-kʰv̩˧˥ | ɖɯ˧-ʂɯ˩-lɑ˩ | lo˧ ʝi˧ ɲi˩ mæ˩ | > [ɖɯ˧-kʰv̩˧˥ | ɖɯ˧-bæ˩-lɑ˩ tv̩˩ |]. |
crdo-NRU_F4_HOUSEBUILDING2_HOUSEBUILDING2_S185.wav	õõõ! ʈʂʰɯ˧-qo˧ dɑ˧˥ | pi˧-kwɤ˩tɕɯ˩-lɑ˩ | tʰi˩˥, |
crdo-NRU_F4_CARAVANS_CaravansS288.wav	õ˧tʰv̩˧ne˧ gv̩˧-ɲi˥-tsɯ˩! |
crdo-NRU_F4_FOOD_SHORTAGE2_FOOD_SHORTAGE2S050.wav	"""ɲi˧mi˧ qʰæ˧-ʂæ˧~ʂæ˧, | di˩li˩-ʁo˩bv̩˥ ɖʐɤ˩-bi˩-ze˩! | pi˧-zo˩ | tʰi˩˥, | mv̩˩˥ | mɤ˧-tɕʰi˧-ɲi˥-tsɯ˩ ◊ -mv̩˩!"""
crdo-NRU_F4_FOOD_SHORTAGE_FoodShortageS084.wav	"""nɑ˩-dʑi˥-dʑo˩, | <hɑ…> əəə… sɑ˧! | nɑ˩-hɑ˥-dʑo˩, | wo˩˥!"" | pi˧-dʑo˩ | tʰi˩˥, | ə˩kʰɯ˩˥! | ə˩kʰɯ˩-ʈʂʰɯ˥ | le˧-pʰo˧˥ ◊ -dʑo˩ | tʰi˩˥, |"
crdo-NRU_F4_FUNERAL_F4_FUNERAL_S047.wav	tʰi˩˥, | tʰv̩˧-ʁo˧dɑ˧-dʑo˩, | mɤ˩mv̩˩˥ | tʰi˧-ʈʂv̩˩. |
crdo-NRU_F4_HEALING_HealingS039.wav	"ɖɯ˧-so˩ ʂɯ˩ ʝi˩-dʑo˩, | ʈʂʰɯ˧-ʑi˧=ɻ̍˥, | ə˧mi˧ ʈʂʰɯ˧-jɤ˩-dʑo˩, | ʈʰææ̃˧ | ʈʂʰɯ˧ne˧-ʝi˥ |
			tʰi˧-ʑi˧˥, | gɯ˩˥ | mɤ˧-qʰwɤ˧, | dɑ˧pɤ˧-ʈʂʰɯ˧ | ʈʂʰo˧-hɯ˧-ʈʂʰo˧-ɻ̍˥, |
			ʈʂʰo˧-hɯ˧-ʈʂʰo˧-ɻ̍˥, | njɤ˩ɭɯ˧ | ʈʂʰɯ˧ne˧-ʝi˥ | ɖɯ˧-hɑ˩, | ɖɯ˧-hɑ˩, | ɖɯ˧-hɑ˩-ɻ̍˩, |
			ɖɯ˧-pi˧˥ | le˧-qʰwɤ˧-tsɯ˥ | mv̩˩. |"
crdo-NRU_F4_HOUSEBUILDING2_HOUSEBUILDING2_S306.wav	tʰi˩˥, | hĩ˧-ki˧ | hɑ˧ | le˧-dzɯ˥-kʰɯ˩! |
crdo-NRU_F4_FUNERAL_F4_FUNERAL_S164.wav	mv̩˧ | ɲi˩-kv̩˩˥, | zo˧ | ʐv̩˩-kv̩˩ ɲi˥-mæ˩! |
crdo-NRU_F4_MOUNTAINS_F4_MountainsS078.wav	<mmm… nɑ˩ts…> qv̩˧ɻ̍˧-ʈʂʰæ˧nɑ˥ pi˩-kv̩˩-mv̩˩! | nɑ˩tsʰi˩˥ | tɕʰɤ˧pɤ˧-mi˧ | pi˧-kv̩˩-mv̩˩!
crdo-NRU_AGRICULTURAL_ACTIVITIES_Agriculture_S093.wav	"""nɑ˩-dʑi˧-dʑo˩, | sɑ˧! | nɑ˩hɑ˧-dʑo˩, | wo˩"" pi˥-kv̩˩-tsɯ˩ mv̩˩! |"
crdo-NRU_F4_FOOD_SHORTAGE2_FOOD_SHORTAGE2S070.wav	"""ə˧tso˧-mɤ˧-ɲi˩, | hṽ˩-ɖʐæ˩ɻæ˥ | gv̩˧-ze˧-gɤ˧, | dzɯ˧-tʰɑ˧-ze˩!"" | pi˧-zo˩ | tʰi˩˥, | ʈʂʰɯ˧-ɲi˧-ʑi˩-dʑo˩, | ɲi˧-ʑi˩, | mv̩˩-lɑ˥ | mɤ˧-tɕʰi˧, | zo˧-lɑ˩ | mɤ˧-tɕʰi˧! |"
crdo-NRU_Mariage_De_La_Soeur_V3_Sister3_S066.wav	«njɤ˧ | ə˧mv̩˧˥ | ɖɯ˧-v̩˧-ki˥ | ʈʂʰɯ˧ne˧ ʝi˥ F | ʈʂʰɯ˧-dʑo˩, | tʰv̩˧-sɯ˩-kv̩˩ | ↑ɖɯ˩lo˧ | mɤ˧-sɯ˥-ze˩!» pi˩-ɲi˩-ze˩ wɤ˩; |
crdo-NRU_F4_DOG2_Dog2S083.wav	tʰv̩˧-mɤ˧-ɲi˥, | kʰv̩˩mi˩˥ | tsʰe˩qʰɑ˩-kʰv̩˩-hĩ˥ ◊ -dʑo˩, | mɤ˧-dʑo˩-ɲi˩-mæ˩, ◊ ə˩-gi˩! |
crdo-NRU_F4_HEALING_HealingS007.wav	kʰv̩˧tɕʰi˥ | mɤ˧-dʑo˧-ɲi˥-tsɯ˩ ◊ -mv̩˩, | le˧-ɻ̃˧-zo˥! |
crdo-NRU_Mariage_De_La_Soeur_V3_Sister3_S027.wav	«hɑ˧mi˥-hĩ˩ | tʰv̩˧-v̩˧ F | le˧-di˧˥, | mv̩˩tɕo˧ kwɤ˩, | kʰv̩˩mi˩˥ F | le˧-di˧˥ | mv̩˩tɕo˧ kwɤ˩, | ʈʂʰɯ˧-kʰv̩˥mi˩ ʈʂʰɯ˩-jɤ˩ | tsʰi˧ɲi˧ | ə˧tso˧ ʝi˧-ɲi˥!?», | pi˧-zo˩, | ʈʂʰɯ˧ne˧-ʝi˥ | ʐwɤ˩-ɲi˥-tsɯ˩ ◊ -mv̩˩. |
crdo-NRU_Naissance_du_Lac_V3_Lake3_S057.wav	gv̩˩pʰæ˩˥ | ɖɯ˧-pʰæ˧ po˥-ɳɯ˩, | tsɑ˧˥, | tsɑ˧˥, | tsɑ˧˥, | tsɑ˧˥ ◊ -kwɤ˩tɕɯ˩-lɑ˩, | <hi˩…> hi˩nɑ˧mi˧ | tsɤ˧-ɲi˥-kv̩˩-tsɯ˩ mv̩˩! |
crdo-NRU_F4_DOG2_Dog2S080.wav	le˧-mo˩, | le˧-mo˩, | njɤ˩ɭɯ˧ | ʈʂʰɯ˧ne˧ gv̩˧˥, | hĩ˧ li˩ F -mɤ˩-ʁo˩! |
crdo-NRU_F4_HOUSEBUILDING2_HOUSEBUILDING2_S082.wav	tʰi˩˥, | dʑɯ˩ʁo˩˥ | ʑi˧mi˧ ɖɯ˧-ɭɯ˧ dɑ˧-hĩ˧-ʈʂʰɯ˧, | ɖɯ˧-ɬi˧ ɲi˧-ɬi˧… | ə˧zɯ˩, | ə˧ʂɯ˧-ɲi˥ F | ɖɯ˧-ʂɯ˩ ʐwɤ˩ ɲi˩ mæ˩, ə˩-gi˩! |
crdo-NRU_AGRICULTURAL_ACTIVITIES_Agriculture_S031.wav	dʑɯ˧ | le˧-li˧-se˩, | wɤ˩˥ | ʝi˧ | <ɖ…> le˧-lv̩˩! |
crdo-NRU_F4_MUSHROOMS_MUSHROOMS_S147.wav	ʝi˧-kʰv̩˥ | tʰi˩˥, | dzɯ˧-tʰɑ˩-bi˩, | mo˧kɤ˩-ʈʰæ˩qo˩ di˩-hĩ˩, | <d… ɖʐɤ˧˥…> dzɯ˧-pi˩, | dv̩˩˥! |
crdo-NRU_F4_DOG2_Dog2S046.wav	ʁæ˧-mɤ˧-ʑi˧, | tʰi˧-kwɤ˩-mɤ˩-kv̩˩, | kʰv̩˩mi˩-ʈʂʰɯ˥-dʑo˩! |
crdo-NRU_Naissance_du_Lac_V3_Lake3_S011.wav	dzɯ˧-zo˧-kv̩˩ mæ˩! |
crdo-NRU_F4_MOUNTAINS_F4_MountainsS044.wav	mv̩˧ʈʰæ˧˥, | dʑɯ˩-ʈʂʰɯ˥, | dʑɯ˧qo˧ bæ˧˥ ◊ -dʑo˩, | njɤ˧ | gɤ˩-tso˧! | ĩ˧! | qo˧ɻ̍˧-ʁo˧qʰwɤ˥ tʰv̩˩-ɲi˩! |
crdo-NRU_F4_FUNERAL_F4_FUNERAL_S095.wav	tʰi˩˥, | tsʰe˩ŋwɤ˩-hɑ̃˥-ɳɯ˩, tʰi˩-tɕɯ˩! | ɑ˩ʁo˧ tv̩˧qʰv̩˧-qo˧ | tʰi˧-kʰɯ˧˥! |
crdo-NRU_F4_CARAVANS_CaravansS171.wav	"""o! le˧-ʝi˩-ze˩, | le˧-ʝi˩-ze˩! | o! tʰo˩lo˧-bv̩˧ | kɤ˩-tjɤ˧ljɤ˧ | tʰi˧-lɑ˧-ze˥!"" |
			pi˧. |"
crdo-NRU_F4_HEALING_HealingS082.wav	ɖɯ˧-njɤ˧ <| tʰi˩˥ |> dɑ˧pɤ˧ ʁɑ˧-ʂe˩! | <no˧…>
crdo-NRU_F4_COMING_OF_AGE2_F4_ComingOfAge2S022.wav	əəə… zo˧ ɲi˥-pi˩-dʑo˩, | əəə… zo˩no˥… | ɑ˩ʁo˥ | to˩mi˩˥ | ɲi˧-ɭɯ˧ di˩-ɲi˩-mæ˩! |
crdo-NRU_F4_HEALING_HealingS065.wav	"ə˧tso˧ go˩? | zo˩no˧-ɲi˩-pi˩, <we˩˥ ʈʰææ̃˧…> [hu˧mi˧ go˧˥] |
			-ɲi˩<-ə˩-di˩>-pʰæ˩-di˩-ze˩! |"
crdo-NRU_F4_HOUSEBUILDING2_HOUSEBUILDING2_S309.wav	"""le˧-ʂɯ˧-bi˧, | le˧-gɤ˩-ze˩, | ɖɯ˧-dzi˩=ɻ̩˩ bi˩, | qʰɑ˩jɤ˩ pʰv̩˩˥!"" |"
crdo-NRU_F4_SEEDS_SeedsS009.wav	tʰi˩˥, | gi˩˥, | gi˩˥… |  gi˩˥, | gi˩˥ ◊ -dʑo˩ | tʰi˩˥, | wɤ˩˥, | wɤ˩˥, | ɖɯ˧… | le˧-li˧, | le˧-li˧, | wɤ˩˥ | ɖɯ˧-bæ˧ mɤ˧-dʑo˧-hĩ˧, | ni˧ ki˩-ɲi˩<-s…>-kv̩˩-tsɯ˩ ◊ -mv̩˩!
crdo-NRU_Mariage_De_La_Soeur_V3_Sister3_S119.wav	njɤ˧ | ʈæ˧ʂɯ˧-go˧mi˧-ʈʂʰɯ˧, | hĩ˧-ki˧-ki˩ | le˧-ʂɯ˧, | pi˧, | tʰi˩˥, | ʈʂʰɯ˧-ʑi˥-ki˩, | zo˩no˥ | njæ˧-sɯ˩kv̩˩ | nɑ˩-ʈʂʰɯ˥-dʑo˩, | ɬi˧di˩-di˩mi˩ | nɑ˩-ʈʂʰɯ˥-dʑo˩, | tɕʰi˩tʰv̩˩˥ ◊ -ɲi˩, pi˧-zo˩, | bi˧-zo˧-kv̩˧˥ ◊ -mæ˩!
crdo-NRU_F4_HOUSEBUILDING2_HOUSEBUILDING2_S277.wav	si˧-ʁæ˧bæ˥, | ə˧ʝi˧-ʂɯ˥ʝi˩-dʑo˩, | næ˩-qʰæ˥ʈʂʰe˩-hĩ˩!
crdo-NRU_F4_MUSHROOMS_MUSHROOMS_S108.wav	mɤ˧-sɯ˥! | ə˧ʝi˧-tsʰi˧ʝi˧-dʑo˩ | tʰi˩˥, | ʈʂʰɯ˧ | ɖwæ˧˥ | pʰv̩˧ɖɯ˧ ɲi˥-tsɯ˩. |
crdo-NRU_F4_HOUSEBUILDING2_HOUSEBUILDING2_S297.wav	qwɤ˧ɭɯ˧-ʁo˧ | tʰi˧-ʂɻ̩˧-kʰɯ˥! |
crdo-NRU_F4_DOG2_Dog2S026.wav	"tʰi˩˥, | njɤ˧, əəə… -dʑo˥ | qʰv̩˩tsʰi˧-kʰv̩˥-hĩ˩-bv̩˩ | qæ˧~qæ˧ tsɤ˥-ɲi˩!"" | pi˧-zo˩ | tʰi˩˥, | kʰv̩˩mi˩˥ ◊ -dʑo˩ | tsʰe˩so˩-kʰv̩˩ ʝi˥! |"
crdo-NRU_F4_HOUSEBUILDING2_HOUSEBUILDING2_S245.wav	ə˧tso˧ mɤ˧-ɲi˩, | pv̩˧-hĩ˧ ʝi˧! |
crdo-NRU_F4_MOUNTAINS_F4_MountainsS083.wav	ŋwɤ˧hɑ̃˩ <hɤ˩… -qo˩…>[-ʁo˩to˩], | hĩ˧ hɯ˧-dʑo˩, ◊ ə˩-gi˩! | dʑɯ˩-nɑ˩mi˩ tʰv̩˩-ɭɯ˩-ʁo˩-to˥, | ŋwɤ˧hɑ̃˩ mv̩˩ʈʂæ˩-kv̩˩-mæ˩, | tʰv̩˧qo˧ hĩ˧ hɯ˧-dʑo˩, | æ˧ʝi˩ kʰɯ˩-dʑo˩ | tʰi˩˥, | æ˧ʝi˩ kʰɯ˩, | æ˧hi˩hi˩ | tʰææ˧ kʰɯ˥-dʑo˩, | <ɖʐv…> dzo˧ lɑ˩-kv̩˩-tsɯ˩ ◊ -mv̩˩! | di˧qo˧!
crdo-NRU_F4_MOUNTAINS_F4_MountainsS004.wav	tʰi˩˥, | əəə… di˧qo˧ mɤ˧-dʑo˧-hĩ˧ F | ʈʂʰɯ˧ | dʑo˧! | ə˧tso˧-mɤ˧-ɲi˩, | dʑo˧! |
crdo-NRU_F4_HOUSEBUILDING2_HOUSEBUILDING2_S004.wav	tʰi˩˥, | əəə… ʑi˧qʰwɤ˧-qæ˧do˧ | le˧-dɑ˧˥, | le˧-tʰv̩˧, əəə… -dʑo˥ | tʰi˩˥, | gv̩˩-pʰæ˩˥ | le˧… le˧-ʑi˩-bi˩. |
crdo-NRU_F4_HOUSEBUILDING2_HOUSEBUILDING2_S310.wav	"""zo˧mv̩˥-hɤ˩ pi˩-ze˩, gɤ˩-se˩, | ʈʂʰɯ˧-lɑ˩ ɲi˩ mæ˩"", | pi˧-kv̩˩ mæ˩, | ə˧ʝi˧-ʂɯ˥ʝi˩! |"
crdo-NRU_F4_CARAVANS_CaravansS162.wav	"tʰi˩˥, | gi˩˥, | gi˩-ɳɯ˥, | sɯ˧pʰi˧-ɳɯ˧, | hæ˧ qɑ˧˥ | ɖɯ˧-kʰwɤ˥~ɖɯ˩-kʰwɤ˩ sɯ˩~sɯ˩-dʑo˩
			| tʰi˩˥, | hæ˧ | ɖɯ˧-ɲi˧-ʑi˩ | <tʰi˧-…> tʰi˧-dzi˩-dʑo˩, | ʈʂʰɯ˧-ɲi˥-ʑi˩-ɳɯ˩ |
			kʰɤ˧ʂɯ˧, | ɖɯ˧-kʰwɤ˥~ɖɯ˩-kʰwɤ˩ tv̩˩-dʑo˩ | tʰi˩˥, | no˧=ɻ̍˩ ɖɯ˩-pʰv̩˩ tv̩˩, | njɤ˧=ɻ̍˩
			ɖɯ˩-pʰv̩˩ tv̩˩, | ʈʂʰɯ˧ne˧-ʝi˥ | tv̩˧-hĩ˧-lɑ˩-ɲi˩-ze˩-mæ˩! |"
crdo-NRU_F4_TIGER2_Tiger2S024.wav	əəə, tʰi˩˥… | ĩ˧!
crdo-NRU_F4_CARAVANS_CaravansS113.wav	ə˧ʝi˧-ʂɯ˥ʝi˩, | ə˧v̩˧-ɳɯ˥ | njæ˧sɯ˩kv̩˩-ki˩ | qʰɑ˩ne˩˥ | ki˧-kv̩˧˥ ◊ -mæ˩! |
crdo-NRU_Naissance_du_Lac_V3_Lake3_S016.wav	<mɤ˩ dʑo˥ | tʰi˩˥, | jɤw˧ ɲi˥-ze˩ mæ˩! ◊ ə˩-gi˩! | mɤ˧! | >
crdo-NRU_F4_FUNERAL_F4_FUNERAL_S056.wav	mmm, ə˧ʝi˧-ʂɯ˥ʝi˩-se˩, | zo˩no˥, | hɑ˧ ɖɯ˧-tɕʰi˩ dzɯ˩, | ɖɯ˧-ʂɯ˩ ŋv̩˩-zo˩-kv̩˩, | njæ˧sɯ˩kv̩˩, | nɑ˩-ʈʂʰɯ˥-dʑo˩! | õ˧˥ | ə˧mi˧ ʂɯ˧, | ə˧dɑ˧ ʂɯ˥-pi˩-dʑo˩! |
crdo-NRU_Mariage_De_La_Soeur_V3_Sister3_S100.wav	<əəə…> ʐæ˩sɯ˩˥ | ɖɯ˧-pʰæ˧ hæ̃˥ | tʰi˧-kwɤ˩. |
crdo-NRU_F4_FUNERAL_F4_FUNERAL_S052.wav	əəə… hɑ˧ | tʰi˧-pæ˩! | tʰi˧-dzɯ˥-kʰɯ˩! |
crdo-NRU_F4_CARAVANS_CaravansS082.wav	ʐɤ˩mi˩˥… | ə, tsʰe˩-hɑ̃˩-ɖʐɯ˩-bi˩˥, | tsʰe˩-hɑ̃˩-qo˥ | ʐɤ˩mi˩˥… | õ! ɑ˩pʰo˩ ʑi˥, | kv̩˧dʑɯ˧-ʈʰæ˧qo˥ ʑi˩! |
crdo-NRU_F4_HOUSEBUILDING2_HOUSEBUILDING2_S240.wav	mv̩˩di˩-qo˥-ʈʂʰɯ˩, | hĩ˧ li˩, | no˧ | ʈʂʰɯ˧-bæ˧ ʝi˧, | njɤ˧ | ʈʂʰɯ˧-bæ˧ ʝi˧-bi˧-ni˥-gv̩˩; | njɤ˧ | ʈʂʰɯ˧-bæ˧ ʝi˧, | no˧ | ʈʂʰɯ˧-bæ˧ ʝi˧-bi˧-ni˥-gv̩˩; | hĩ˧ li˩, | le˧-so˩ | le˧-kv̩˧˥! |
crdo-NRU_F4_FUNERAL_F4_FUNERAL_S026.wav	gɤ˧qo˥ F -ɳɯ˩ | ʂɯ˧-kʰɯ˧-zo˧-kv̩˩-mæ˩! | gɤ˧qo˥ F ʂɯ˩-kʰɯ˩! |
crdo-NRU_Naissance_du_Lac_V3_Lake3_S066.wav	tʰi˩˥, | dʑo˩-hĩ˩ ʈʂʰɯ˥, | ɲi˧zo˧ ʈʂʰɯ˧-mi˧-ɳɯ˥, | ʈʂʰɯ˧ne˧-ʝi˥ | le˧-tʰv̩˧-kwɤ˧tɕɯ˥-lɑ˩, |
crdo-NRU_F4_HOUSEBUILDING2_HOUSEBUILDING2_S243.wav	ʁo˧dɑ˧-dʑo˧, | nɑ˩-ʈʂʰɯ˥-dʑo˩, | ɖɯ˧-sɑ˥ | ʝi˧-mɤ˧-kv̩˩! | ɬi˧di˩-di˩mi˩-hĩ˩ ʈʂʰɯ˩-tɕi˩! |
crdo-NRU_F4_TIGER2_Tiger2S042.wav	tʰi˩˥, | kʰi˧˥! | tʰi˧-se˥, | tʰi˧-se˥, | tʰi˧-se˥ ◊ -dʑo˩, | ʐɤ˩mi˩-qo˥ | ɖɯ˧-hɑ̃˧ tʰi˥-hɑ̃˩-ɳɯ˩, | ɑ˩ʁo˧ tʰv̩˧-ɲi˥-tsɯ˩ ◊ -mv̩˩. |
crdo-NRU_F4_MOUNTAINS_F4_MountainsS080.wav	ʈʂʰɯ˧ | <so˧-ɭɯ˧-hĩ˧-ʈʂʰɯ˧-dʑo˩> [ʐv̩˩-ɭɯ˩-hĩ˥-ʈʂʰɯ˩-dʑo˩] | tʰi˩˥, | æ˧ʂæ˧-qʰwɤ˧-ʈʂʰɯ˥-dʑo˩, | dʑɯ˩-nɑ˩mi˩-bv̩˩˥, | æ˧ʂæ˧-qʰwɤ˧-ʈʂʰɯ˥, | ɖɯ˩-ʈʂɤ˩-kv̩˥-tsɯ˩ ◊ -mv̩˩!
crdo-NRU_F4_SEEDS_SeedsS033.wav	ʈæ˧bɤ˧ ʁɑ˧-ʂe˩-dʑo˩, | ki˧-mɤ˧-kv̩˧˥ ◊ -mæ˩!
crdo-NRU_F4_COMING_OF_AGE2_F4_ComingOfAge2S100.wav	tsʰi˧qʰæ˧˥ ◊ -dʑo˩, | ʈʰææ̃˧ | mɤ˧-tɑ˩hwɤ˩-ze˩! |
crdo-NRU_F4_FOOD_SHORTAGE2_FOOD_SHORTAGE2S044.wav	"""ʁɑ˩mi˧! | õ˧-bv̩˥-õ˩ | hɑ˧ | ɖɯ˧-ɭɯ˧ dʑo˧-bi˧, | õ˧-tɑ˧kɤ˥ | le˧-dzɯ˥-ze˩! | no˧=ɻ̍˩, | hĩ˧ dʑɯ˩-mɤ˩-dʑɯ˩? | qʰɑ˩ne˩ ʝi˥?"" | pi˧-dʑo˩ | tʰi˩˥, |"
crdo-NRU_F4_SEEDS_SeedsS018.wav	"""mv̩˩zɯ˩-ʈʂʰɯ˥-dʑo˩, | ki˧-mɤ˧-bi˧!"" | pi˧-dʑo˩ | tʰi˩˥, | <hm…> mv̩˧ʁo˧ hɯ˧-hĩ˧ | ɖɯ˧-v̩˧-ɳɯ˧-dʑo˥, | ""ə˧mi˧! | ʈʂʰɯ˧ | mɤ˧-ki˧-dʑo˧, | mɤ˧-tʰɑ˧˥! | ʈʂʰɯ˧-dʑo˩, | mv̩˩zɯ˩˥, | ɖwæ˧˥ | dʑɤ˩-ɲi˥!"" | pi˧-zo˩, ə˩-gi˩! |"
crdo-NRU_F4_SEEDS_SeedsS004.wav	ɻæ˩-ʈʂʰɯ˥, | ɖɯ˧-sɑ˥ F | mɤ˧-dʑo˧-dʑo˥ | tʰi˩˥, | mv̩˧ʁo˧-ɻ̍˥, | zo˩no˥, | hĩ˧ ɖɯ˧-v̩˧-ɳɯ˧ | ʈʂʰɯ˧-ɳɯ˩: |
crdo-NRU_F4_CARAVANS_CaravansS285.wav	"zo˩no˥, | ɑ˩ʁo˧-ʐwæ˧-ni˧˥, | ə˧zɯ˩ | no˧-ɳɯ˧ | ə˧zɯ˩ | ʐwæ˧ʁo˩ ʂe˩ kʰi˩-ni˩-zo˩, |
			ɖɯ˧dv̩˩~ɖɯ˩dv̩˩ | ɖwæ˧˥ | dʑo˩-ɲi˥-mæ˩! | ʈʂʰɯ˧ne˧-ʝi˥, | tʰi˩˥, | le˧-tɕɯ˩~tɕɯ˩, | bi˧, |
			hhh! ɑ˩ʁo˧, | tʰi˩˥, | ʐwæ˩mi˩˥, | ɖɯ˧-v̩˧-lɑ˧, | ɑ˩ʁo˧ dʑo˩-kv̩˩-ze˩! |"
crdo-NRU_F4_FUNERAL_F4_FUNERAL_S262.wav	tʰi˩˥, | əəə… ə˧dɑ˧-ə˧mi˧ | ʑi˧dv̩˧ le˧-ʝi˥ | ki˧-ɲi˥ | pi˧! |
crdo-NRU_F4_HOUSEBUILDING2_HOUSEBUILDING2_S075.wav	mmm… ʈʂʰɯ˧-bv̩˧ | pæ˩pʰæ˧˥ | tʰi˧-ʈʰæ˧-di˧˥! | pv̩˧tsɤ˥ gv̩˩-ɲi˩ pi˩! |
crdo-NRU_F4_HEALING_HealingS104.wav	"ʈʂʰɯ˧-ɲi˥-kv̩˩, | ɖɯ˧-njɤ˧ | tʰi˩˥, | hɑ˧ | ʈʰæ˧ɻæ˩ so˩-hĩ˩ | ʈʂʰɯ˧-ɲi˥-kv̩˩-ɳɯ˩ |
			gv̩˩˥! |"
crdo-NRU_F4_FUNERAL_F4_FUNERAL_S247.wav	ə˧ɲi˧-tsʰi˧ɲi˧, | ʈʂʰɯ˧ne˧ ʝi˥-dʑo˩-mæ˩! |
crdo-NRU_F4_ELDERS3_Elders3S057.wav	ə˧mi˧ | ɖɯ˧-v̩˧-lɑ˧ dʑo˧-ze˥! |
crdo-NRU_F4_MOUNTAINS_F4_MountainsS035.wav	"mv̩˩tɕo˧ zɑ˩-tsʰɯ˩-dʑo˩ | tʰi˩˥, | hĩ˧-ki˧: | ""ə˧mi˧! | njɤ˧ | ɖɯ˧zɯ˧-ɖɯ˧ʈʂʰæ˧˥ ◊ -dʑo˩, | ə˧tso˧-mɤ˧-ɲi˩ | dʑo˧! |"
crdo-NRU_AGRICULTURAL_ACTIVITIES_Agriculture_S107.wav	le˧-ʂɯ˧-kwɤ˧tɕɯ˥-lɑ˩, | <ə˧mɑ˧… | ʈʂʰɯ˧-ʁ… | > ʈʂʰɯ˧ mɤ˧-dʑo˧, | pi˧-dʑo˩, | hĩ˧ | dzɑ˧ | ʐwæ˩-ɲi˥-tsɯ˩ | mv̩˩! |
crdo-NRU_Naissance_du_Lac_V3_Lake3_S048.wav	ɖɯ˧-ʑi˩-ɻ̍˩-dʑo˩, | ə˧mi˧ | bo˩-hɑ˧ ki˩-dʑo˩, | pi˧-tsɯ˩ mv̩˩. | mv̩˩kʰv̩˧˥! |
crdo-NRU_F4_DOG2_Dog2S001.wav	ə˧ʝi˧-ʂɯ˥ʝi˩-dʑo˩, | zo˩no˥, | hĩ˧-lɑ˩ | kʰv̩˩mi˩-ʈʂʰɯ˥-dʑo˩, ◊ ə˩-gi˩! |
crdo-NRU_F4_DOG2_Dog2S068.wav	"""kʰv̩˧-ʈʂʰɯ˧, | ʁæ˧-mɤ˧-ʑi˧, | ʝi˧-mɤ˧-ɖo˧"" -pi˧-zo˥! | ʈʂʰɯ˧ne˧-ʝi˥ | ʐwɤ˩-kv̩˩˥, | æ˧ʂæ˧! |"
crdo-NRU_F4_HOUSEBUILDING2_HOUSEBUILDING2_S076.wav	əəə… ɖɯ˧-ɲi˥-dʑo˩, | se˧tʰo˩ gv̩˩-ɲi˩ pi˩! |
crdo-NRU_F4_COMING_OF_AGE2_F4_ComingOfAge2S005.wav	tsʰe˩-so˩-kʰv̩˩ gv̩˩˥ | tʰi˩˥, | ɑ˩ʁo˧ le˧-kʰi˧˥! |
crdo-NRU_F4_FOOD_SHORTAGE2_FOOD_SHORTAGE2S012.wav	"""hɑ˧-ʐwɤ˩ | le˧-ʂɯ˧-hĩ˧-ʁo˧to˩-dʑo˩, | mv̩˩˥ | le˧-tɕʰi˧-hĩ˧ | ɖɯ˧-pi˧˥ | tsɤ˧-ʝi˧! | ɖwæ˩-mɤ˧-zo˧!"" |"
crdo-NRU_F4_MUSHROOMS_MUSHROOMS_S059.wav	<dʑ…> ɖɯ˧-v̩˥ | tʰi˧-tɕɤ˩-dʑo˩, | mo˧-ɳɯ˥ | mo˧-dʑɯ˥ tɕɤ˩-se˩-hĩ˩! | kv̩˧ tʰi˩-kʰɯ˩! |
crdo-NRU_F4_HOUSEBUILDING2_HOUSEBUILDING2_S188.wav	hõ˩ ʝi˩-bi˩˥ | pi˧, | tsʰe˩-hõ˩-ɲi˩ qo˥ tʰv̩˩-kʰɯ˩. | …pi˧! |
crdo-NRU_F4_FOOD_SHORTAGE_FoodShortageS010.wav	"mmm… ""di˩li˩-ʁo˩bv̩˥ F | <le˧-tɕʰi˧-ze˧… əəə…> le˧-tʰv̩˧-ze˧!"" | pi˧, | le˧-hɯ˩-ɲi˩-tsɯ˩ ◊ -mv̩˩!"
crdo-NRU_F4_TIGER2_Tiger2S002.wav	zo˩no˥, | lɑ˧, | ʐæ˩˥, | pi˧-hĩ˧-ʈʂʰɯ˧-dʑo˩, | zo˩no˥, | hĩ˧ ʈʰæ˩, | ʈʂʰɯ˧-dʑo˩, ◊ ə˩-gi˩! |
crdo-NRU_F4_MOUNTAINS_F4_MountainsS105.wav	tʰi˩˥, | <kɤ… kɤ… ʈʂʰɯ… tʰi… tɕ…> ʈʂʰɯ˧ne˧-ʝi˥ | le˧-hɯ˩-dʑo˩, | ə˧ʝi˧-ʂɯ˥ʝi˩, | õ˧dɤ˧ɻ̍˧ | ʐɤ˩mi˩-qo˥ | ʈʂʰɯ˧ne˧-ʝi˥ | ɖɯ˧-kʰɯ˩ le˩-hɯ˩, | qv̩˧ɻ̍˧-ki˧ | ʈʂʰɯ˧ne˧-ʝi˥, | ʈʂʰɯ˧ne˧-ʝi˥, | ʈʂʰɯ˧ne˧-ʝi˥, | ʈʂʰɯ˧ne˧-ʝi˥, | ʈʂʰɯ˧ne˧-ʝi˥, | ʈʂʰɯ˧ne˧-ʝi˥, | ʐɤ˩mi˩˥ | ɖɯ˧-kʰɯ˩ le˩-hɯ˩! |
crdo-NRU_F4_SEEDS_SeedsS042.wav	ŋwɤ˩-bæ˩-hĩ˥-ʈʂʰɯ˩, | mv̩˧dze˧ | ɖɯ˧-bæ˧, | dze˧ɭɯ˧ | ɖɯ˧-bæ˧, | əəə… | qʰɑ˧dze˧ | ɖɯ˧-bæ˧, | ɕi˧ɭɯ˧ | ɖɯ˧-bæ˧, | nv̩˩ɭɯ˧ | ɖɯ˧-bæ˧. |
crdo-NRU_F4_HOUSEBUILDING2_HOUSEBUILDING2_S055.wav	hĩ˧ ɳɯ˧ | pi˧, | ɖɯ˧-njɤ˧ | ɑ˩ʁo˧-ɳɯ˧ | gv̩˩-ɲi˥-ze˩ mæ˩! |
crdo-NRU_F4_MUSHROOMS_MUSHROOMS_S143.wav	tɕi˧sɯ˧pɤ˧-ʈʂʰɯ˧, | mɤ˧-dʑo˧ mɤ˧-tʰɑ˧ pi˥-zo˩! | ɖɯ˧-ʑi˩-ɖɯ˩-ʑi˩ | ɑ˩ʁo˧ | ɖɯ˧-kʰwɤ˥~ɖɯ˩-kʰwɤ˩ | tʰi˧-tɕɯ˥-kv̩˩-mv̩˩. |
crdo-NRU_F4_HEALING_HealingS035.wav	mv̩˧-qo˩ | tʰi˧-qæ˧˥ ◊ -dʑo˩ | tʰi˩˥, |
crdo-NRU_F4_DOG2_Dog2S086.wav	<hwɤ˧…> hwɤ˧li˧-tʰv̩˥, | ʐv̩˧-kʰv̩˩, | ŋwɤ˧-kʰv̩˩! | qʰv̩˧kʰv̩˥-ʂɯ˩kʰv̩˩, | dʑɤ˩˥ | zɯ˧ ʂæ˧-hĩ˧ tʰv̩˧-v̩˧-ɳɯ˩! |
crdo-NRU_F4_FUNERAL_F4_FUNERAL_S049.wav	əəə… ɖɯ˧-njɤ˧ | tʰi˧-ʈʂv̩˩! |
crdo-NRU_AGRICULTURAL_ACTIVITIES_Agriculture_S077.wav	"nɑ˩-bv̩˧ | hɑ˧-ʈʂʰɯ˧-dʑo˩, | ""nɑ˩-hɑ˧ F, | wo˩˥!"", | pi˧-ɲi˥ mæ˩. | ""nɑ˩-dʑi˧ F, | sɑ˧!"" -pi˩-ɲi˩-mæ˩. |"
crdo-NRU_F4_CARAVANS_CaravansS008.wav	tʰi˩˥, | ɬɑ˧sɑ˧ hɯ˧ | le˧-tsʰɯ˩-dʑo˩, | li˩˥! | mmm… mɤ˧! | ʈʂʰɯ˧ | le˧-tɕɯ˧-le˥-po˩-tsʰɯ˩! | ɬi˧di˩-di˩mi˩-qo˩! |
crdo-NRU_F4_TIGER2_Tiger2S111.wav	"""əəə… 'lɑ˧ do˩, ə˩dɑ˩ ʂɯ˩! | ʐæ˩ do˥, ə˩mi˩ ʂɯ˩!' | pi˧. |"
crdo-NRU_F4_HOUSEBUILDING2_HOUSEBUILDING2_S111.wav	ʂe˧-ʈʂʰɯ˧, | tʰi˧-dzɯ˥-tɕɯ˩, | ʂe˧mɤ˧-ʈʂʰɯ˥, | tʰi˧-dzɯ˥-tɕɯ˩ pi˩, | mɤ˧-ɖʐo˧ ɲi˥! |
crdo-NRU_F4_HOUSEBUILDING2_HOUSEBUILDING2_S074.wav	ɖɯ˧-ɲi˥-dʑo˩, | pv̩˧tsɤ˥ gv̩˩-ɲi˩ pi˩! |
crdo-NRU_Mariage_De_La_Soeur_V3_Sister3_S071.wav	tʰi˩˥, | ʂɯ˧-kwɤ˧tɕɯ˥-lɑ˩, | tʰi˩˥, | hĩ˧=ɻæ˥: | «ə˧mi˧!» | ɖɯ˧-tɑ˧˥: | «ʈʂʰɯ˧ ə˧mv̩˩ ɲi˩-ze˩-ho˩» | pi˧, | gi˩˥ | gɤ˩-tse˩ hɤ˩˥, | le˧-tse˩ | mɤ˧-ɖɯ˧-ɲi˥-tsɯ˩ ◊ -mv̩˩. |
crdo-NRU_F4_HOUSEBUILDING2_HOUSEBUILDING2_S271.wav	njɤ˧ F | le˧-sɯ˥, | njɤ˧ F | ɑ˩ʁo˧ | do˩˥, | ʁæ˧bæ˧-ʈʂʰɯ˧! | si˧! | si˧ po˩ ɳɯ˩ le˩-gv̩˩-hĩ˩ ʁæ˩bæ˩!
crdo-NRU_F4_FOOD_SHORTAGE2_FOOD_SHORTAGE2S007.wav	"""zo˧mv̩˥ | ʈʂʰɯ˧-tɕi˩-bi˩ li˩, | ɳɯ˧go˧˥ | ʐwæ˩˥!"" | pi˧ | tʰi˩˥, | ə˧mi˧-ɳɯ˧-dʑo˥, | ""ə˧mi˧! | ə˩-sɯ˧kv̩˥-di˩-qo˩, | ʈʂʰɯ˧ne˧-ʝi˥ | hɑ˧-ʐwɤ˩!"""
crdo-NRU_F4_MOUNTAINS_F4_MountainsS104.wav	ʈʂʰɯ˧ne˧-ʝi˥ | -zo˩, | <mv̩˧…> zo˩no˥, | ʁwɤ˧-ʈʂʰɯ˧ | ɖɯ˧-ɭɯ˧~ɖɯ˧-ɭɯ˧-ʈʂʰɯ˧ | ə˧tso˧ mv̩˧ tsʰi˧-hĩ˧-ʈʂʰɯ˧, | tʰi˩˥, | njɤ˧ | ə˧si˧-ɳɯ˧ | ʈʂʰɯ˧ne˧-ʝi˥ | ʐwɤ˩-kv̩˩˥ ◊ -mv̩˩:
crdo-NRU_Mariage_De_La_Soeur_V3_Sister3_S004.wav	ə˧tse˧ ʝi˧-zo˥ | ʈʂʰɯ˧ne˧-ʝi˥ | pi˧-hĩ˧[-ʈʂʰɯ˧-dʑo˧] <| pi˧ >? | kʰv̩˩mi˩˥ | ʐo˩ mɤ˩-ɖɯ˩-hĩ˥ | ʈʂʰɯ˧-dʑo˩, |
crdo-NRU_F4_CARAVANS_CaravansS175.wav	"gi˩˥, | sɯ˧pʰi˧ | ʐwæ˧ mɤ˧-tɕɯ˧˥, | õ˧˥ | v̩˧lɑ˩ | le˧-ʝi˥, | ɖɯ˧-kʰwɤ˥~ɖɯ˩-kʰwɤ˩
			ɖɯ˩, | õ˧˥ | dɑ˧ʝi˩ | le˧-hwæ˧! |"
crdo-NRU_F4_CARAVANS_CaravansS160.wav	"əəə… ""tsʰi˧ɲi˧-dʑo˩, | hæ˧di˩ bi˩-tso˩-ɲi˩!"" | pi˧. | ɕi˧ʈʂʰwæ˧ ʈʂʰɯ˧=ɻæ˧-pi˥! |
			ə˧ʝi˧-ʂɯ˥ʝi˩, | ɬi˧di˩-di˩mi˩-qo˩, | ɕi˧ʈʂʰwæ˧ | mɤ˧-dʑo˧-ɲi˥-mæ˩! |"
crdo-NRU_F4_HEALING_HealingS068.wav	"o! tʰi˧-ʑi˧-ɲi˥-ze˩! | so˧ɲi˥, | wɤ˩˥, | ʈæ˧bɤ˧ ʁɑ˧ʂe˩-kʰi˩, | ʈæ˧bɤ˧ ʁɑ˧ʂe˩-kʰi˩.
			|"
crdo-NRU_F4_FOOD_SHORTAGE2_FOOD_SHORTAGE2S051.wav	"""tʰi˩˥, | mɤ˧-tɕʰi˧!"" |"
crdo-NRU_F4_CARAVANS_CaravansS066.wav	tʰi˩˥, | ho˧di˧ hɯ˧, | ʂe˧ʈʂe˩… | ʂe˧ʈʂe˩ hwæ˩ | le˧-po˧-tsʰɯ˧˥! |
crdo-NRU_F4_HEALING_HealingS012.wav	"ə˧ʝi˧-ʂɯ˥-ʝi˩-dʑo˩, | le˧-ɻ̃˧-zo˥! | le˧-ɻ̃˧-zo˥! | ɖɯ˧-ʑi˩=ɻ̍˩-dʑo˩, | ɲi˧mi˧
			ʈʂʰɯ˧-qʰɑ˧-ʂæ˧~ʂæ˧-hĩ˧, | hĩ˧-ʈʂʰɯ˧ | go˩-tsɯ˥ | mv̩˩! |"
crdo-NRU_F4_CARAVANS_CaravansS165.wav	"ʐwæ˧ tɕɯ˩-zo˩-ʈʂʰɯ˩-ɳɯ˩! | v̩˧lɑ˩ | le˧-ʝi˥, | ʐwæ˧-ʈʂʰɯ˧ | tʰi˩˥, | tʰo˩lo˧, | ɻ̍˧lo˩
			| ʈʰææ̃˧˥… | ʐwæ˧-ʈʂʰɯ˧, | so˧-tsʰi˧, | ʐv̩˧-tsʰi˩, | ŋwɤ˧-tsʰi˩, | ʈʂʰɯ˧=ɻæ˧
			tɕʰo˧~tɕʰo˥! |"
crdo-NRU_F4_MOUNTAINS_F4_MountainsS024.wav	ʝi˧qv̩˥! | ʝi˧qv̩˥-pi˩-zo˩, | æ˩gv̩˩˥ | gv̩˩-nɑ˩-hĩ˥ | ʈʂʰɯ˧=ɻæ˥, | ʝi˧ | ɲi˧-pʰo˧-ɳɯ˥, | æ˩gv̩˩˥ | ɖɯ˧-nɑ˧! | ɲi˧-pʰo˧-ɳɯ˥, | æ˩gv̩˩˥ | ɖɯ˧-nɑ˧ dʑo˧-ɲi˥-kv̩˩-tsɯ˩ ◊ -mv̩˩!
crdo-NRU_F4_FUNERAL_F4_FUNERAL_S249.wav	ɖɯ˩lo˥-ɳɯ˩ | dʑo˧-ɲi˥! | ɲi˧-ɭɯ˧-ʈʂʰɯ˧ | qo˩ho˧-qo˥ | le˧-wo˧ tʰi˧-kʰɯ˧˥! |
crdo-NRU_F4_MOUNTAINS_F4_MountainsS002.wav	qv̩˧ɻ̍˧-ʁo˧qʰwɤ˥-ʈʂʰɯ˩, | hĩ˧ | ɖɯ˧-ʑi˧=ɻ̍˩ mv̩˩ʈʂæ˩-hĩ˩-ʈʂʰɯ˩-dʑo˩ | tʰi˩˥, | mmm… æ˧ʂæ˧-dʑo˩ | tʰi˩˥, | qv̩˧ɻ̍˧-ʁo˧qʰwɤ˥ | hĩ˧ | ɖɯ˧-ʑi˩=ɻ̍˩-dʑo˩, | mv̩˩lo˥ʝi˩ mv̩˩ʈʂæ˩-kv̩˩-tsɯ˩ ◊ -mv̩˩!
crdo-NRU_F4_CARAVANS_CaravansS112.wav	"""ə˧mi˧! | ɳæ˧=ɻ̍˩-se˩, | le˧-gɤ˩-ze˩-wɤ˩! | ə˧v̩˧ tsʰo˧pæ˧ le˧-tsʰɯ˧-zo˥, |
			tsʰo˧pæ˧-ɳɯ˩ | dʑi˧ qæ˧-kʰɯ˩-ze˩! | pi˧-kv̩˩-mæ˩. |"
crdo-NRU_Naissance_du_Lac_V3_Lake3_S060.wav	tʰi˩˥, | ʈʂʰɯ˧ ɲi˥-kv̩˩-ɳɯ˩, | ə˧ʝi˧-ʂɯ˥ʝi˩, | ʈʂʰɯ˧-qo˧-ɳɯ˧, |
crdo-NRU_F4_COMING_OF_AGE2_F4_ComingOfAge2S049.wav	ə˧mi˧ | dʑi˧hṽ˧ mv̩˩-hĩ˩ | tʰv̩˧-v̩˧-ki˧-sɯ˩ | ɬo˧pv̩˥ | le˧-ti˩! |
crdo-NRU_F4_CARAVANS_CaravansS193.wav	ɬi˩qʰwɤ˩˥ | tɑ˧kʰv̩˩ | tʰv̩˧-kʰwɤ˥-lɑ˩ | tʰi˧-ki˩! |
crdo-NRU_F4_ELDERS3_Elders3S039.wav	tʰi˩˥, | njɤ˧ | ə˧ʑi˧-ʈʂʰɯ˥, | ɖwæ˧˥ | hɤ˩-ɲi˥! |
crdo-NRU_F4_FOOD_SHORTAGE_FoodShortageS095.wav	"""zo˩no˥, | no˧sɯ˩kv̩˩ | ə˧tso˧ mɤ˧-dʑo˧? | ə˧tso˧ mɤ˧-ɲi˩, | dʑo˧-ze˧!"" |"
crdo-NRU_F4_HOUSEBUILDING2_HOUSEBUILDING2_S165.wav	"""ə˧mi˧! | njɤ˧ | ʑi˧mi˧ | dʑɤ˩-ɭɯ˧ dɑ˧˥ | ɖɯ˧ wɤ˧! | tsʰi˧qʰæ˧˥ ◊ -dʑo˩, | le˧-ʂɯ˧-bi˧, | le˧-gɤ˩-ho˩-ze˩!"" |"
crdo-NRU_F4_HEALING_HealingS062.wav	"njɤ˧ | ə˧mi˧ ɖɯ˧-v̩˧-ɳɯ˧-ʈʂʰɯ˧, | ə˧ʝi˧-ʂɯ˥ʝi˩, | zo˩no˥, | ə˧mi˧-tɕi˩ |
			dʑo˩-sɯ˩-mæ˥!"
crdo-NRU_F4_MOUNTAINS_F4_MountainsS069.wav	tʰi˩˥, | gi˩˥, | gi˩˥, | gi˩˥ ◊ -dʑo˩ | tʰi˩˥, | əəə… zo˩no˥, | mv̩˧di˧-qo˥, | sɑ˧ | zo˩bv̩˥ɭɯ˩ | ɖɯ˧-tɑ˧˥ | tʰi˩˥, | qv̩˧ɻ̍˧-ʁo˧qʰwɤ˥ dzi˩-hĩ˩ | ʈʂʰɯ˧-ʑi˧=ɻ̍˧ pi˥-kv̩˩-tsɯ˩ ◊ -mv̩˩! |
crdo-NRU_F4_MUSHROOMS_MUSHROOMS_S131.wav	mv̩˧tsʰi˧ mɤ˧-kv̩˩-hĩ˩, | əəə… zo˩no˥, | dzɯ˧ | pi˧-dʑo˩, | zo˩no˥, | mmm… hĩ˧ | dv̩˩-kv̩˩-tsɯ˥-mv̩˩! |
