tʰi˩˥	tʰ i ˩˥  
əəə…	əəə…  
mv̩˩	m v̩ ˩  
ʈʂʰɯ˧ne˧ʝi˥	ʈʂʰ ɯ ˧ n e ˧ ʝ i ˥  
hĩ˧	h ĩ ˧  
pi˧	p i ˧  
dʑo˩	dʑ o ˩  
zo˩no˥	z o ˩ n o ˥  
wɤ˩˥	wɤ ˩˥  
mæ˩	m æ ˩  
ə˩gi˩	ə ˩ g i ˩  
ə˧mi˧	ə ˧ m i ˧  
njɤ˧	n jɤ ˧  
ə˧ʝi˧ʂɯ˥ʝi˩	ə ˧ ʝ i ˧ ʂ ɯ ˥ ʝ i ˩  
ʈʂʰɯ˧	ʈʂʰ ɯ ˧  
mmm…	mmm…  
no˧	n o ˧  
pi˧zo˩	p i ˧ z o ˩  
ɑ˩ʁo˧	ɑ ˩ ʁ o ˧  
hɑ˧	h ɑ ˧  
ʈʂʰɯ˧ne˧	ʈʂʰ ɯ ˧ n e ˧  
pi˧dʑo˩	p i ˧ dʑ o ˩  
ɖɯ˧v̩˧	ɖ ɯ ˧ v̩ ˧  
ɲi˩	ɲ i ˩  
ɖɯ˧ɭɯ˧	ɖ ɯ ˧ ɭ ɯ ˧  
ʈʂʰɯ˧dʑo˩	ʈʂʰ ɯ ˧ dʑ o ˩  
ʐwæ˧	ʐ wæ ˧  
njæ˧sɯ˩kv̩˩	n jæ ˧ s ɯ ˩ k v̩ ˩  
ə˧tso˧	ə ˧ ts o ˧  
ə˧ʝi˧ʂɯ˥ʝi˩dʑo˩	ə ˧ ʝ i ˧ ʂ ɯ ˥ ʝ i ˩ dʑ o ˩  
ɖɯ˧tɑ˧˥	ɖ ɯ ˧ t ɑ ˧˥  
zo˧	z o ˧  
ɖwæ˧˥	ɖ wæ ˧˥  
ʈʂʰɯ˧qo˧	ʈʂʰ ɯ ˧ q o ˧  
gi˩˥	g i ˩˥  
ʝi˥	ʝ i ˥  
ʝi˧	ʝ i ˧  
hĩ˧ʈʂʰɯ˧	h ĩ ˧ ʈʂʰ ɯ ˧  
pi˧tsɯ˩	p i ˧ ts ɯ ˩  
ə˧tso˧mɤ˧ɲi˩	ə ˧ ts o ˧ m ɤ ˧ ɲ i ˩  
ə˧mɑ˧	ə ˧ m ɑ ˧  
ə˧v̩˧˥	ə ˧ v̩ ˧˥  
ʈʰææ̃˧	ʈʰ æ æ̃ ˧  
ʐɯ˧	ʐ ɯ ˧  
mɤ˧dʑo˧	m ɤ ˧ dʑ o ˧  
pi˩	p i ˩  
ʈæ˧bɤ˧	ʈ æ ˧ b ɤ ˧  
dʑɤ˩˥	dʑ ɤ ˩˥  
dʑɯ˧	dʑ ɯ ˧  
ʐwɤ˩kv̩˩˥	ʐ wɤ ˩ k v̩ ˩˥  
ʑi˧qʰwɤ˧	ʑ i ˧ qʰ wɤ ˧  
õ˧bv̩˥õ˩	õ ˧ b v̩ ˥ õ ˩  
ʂe˧	ʂ e ˧  
le˧po˧tsʰɯ˧˥	l e ˧ p o ˧ tsʰ ɯ ˧˥  
sɑ˧	s ɑ ˧  
tʰi˧dzi˩	tʰ i ˧ dz i ˩  
tʰv̩˧	tʰ v̩ ˧  
æ˧ʂæ˧	æ ˧ ʂ æ ˧  
ɖɯ˧kʰwɤ˥	ɖ ɯ ˧ kʰ wɤ ˥  
ɖɯ˧pi˧˥	ɖ ɯ ˧ p i ˧˥  
di˩li˩ʁo˩bv̩˥	d i ˩ l i ˩ ʁ o ˩ b v̩ ˥  
tʰi˧ki˧	tʰ i ˧ k i ˧  
tʰi˧kʰɯ˧˥	tʰ i ˧ kʰ ɯ ˧˥  
ə˧zɯ˩	ə ˧ z ɯ ˩  
ʁɑ˩mi˧	ʁ ɑ ˩ m i ˧  
ʂɯ˧	ʂ ɯ ˧  
zo˧mv̩˥	z o ˧ m v̩ ˥  
mɤ˧ɲi˩	m ɤ ˧ ɲ i ˩  
õ	õ  
pi˧kv̩˩	p i ˧ k v̩ ˩  
tʰi˩kʰɯ˩	tʰ i ˩ kʰ ɯ ˩  
ɖɯ˧ʂɯ˩	ɖ ɯ ˧ ʂ ɯ ˩  
hĩ˧ɻæ˥	h ĩ ˧ ɻ æ ˥  
tʰi˧tɕɯ˥	tʰ i ˧ tɕ ɯ ˥  
v̩˩tsʰɤ˧˥	v̩ ˩ tsʰ ɤ ˧˥  
zo˩qo˧	z o ˩ q o ˧  
ɬo˧pv̩˥	ɬ o ˧ p v̩ ˥  
ɲi˥	ɲ i ˥  
dzɯ˧	dz ɯ ˧  
kwɤ˩tɕɯ˩lɑ˩	k wɤ ˩ tɕ ɯ ˩ l ɑ ˩  
le˧tɕɤ˧˥	l e ˧ tɕ ɤ ˧˥  
qʰɑ˩jɤ˩	qʰ ɑ ˩ jɤ ˩  
qʰɑ˩ne˩	qʰ ɑ ˩ n e ˩  
qʰɑ˩ne˩˥	qʰ ɑ ˩ n e ˩˥  
tɕɯ˩	tɕ ɯ ˩  
wɤ˩	wɤ ˩  
ɖɯ˧njɤ˧	ɖ ɯ ˧ n jɤ ˧  
dʑo˧ɲi˥	dʑ o ˧ ɲ i ˥  
ho˧di˧	h o ˧ d i ˧  
ki˩	k i ˩  
le˧	l e ˧  
li˩	l i ˩  
dʑo˧	dʑ o ˧  
mv̩˧	m v̩ ˧  
mv̩˩˥	m v̩ ˩˥  
tʰv̩˧qo˧	tʰ v̩ ˧ q o ˧  
ɖɯ˧kʰv̩˧˥	ɖ ɯ ˧ kʰ v̩ ˧˥  
go˧mi˧	g o ˧ m i ˧  
ĩ˧	ĩ ˧  
le˧gv̩˩	l e ˧ g v̩ ˩  
njɤ˧ɻ̍˩	n jɤ ˧ ɻ̍ ˩  
no˧˥	n o ˧˥  
õ˧˥	õ ˧˥  
ɖɯ˧ɲi˥dʑo˩	ɖ ɯ ˧ ɲ i ˥ dʑ o ˩  
ə˧mi˧ɳɯ˧	ə ˧ m i ˧ ɳ ɯ ˧  
ʈʰæ˧qʰwɤ˧	ʈʰ æ ˧ qʰ wɤ ˧  
no˧sɯ˩kv̩˩	n o ˧ s ɯ ˩ k v̩ ˩  
tʰv̩˩	tʰ v̩ ˩  
dzi˩	dz i ˩  
dʑɯ˩ʁo˩˥	dʑ ɯ ˩ ʁ o ˩˥  
gɤ˩tɕo˧	g ɤ ˩ tɕ o ˧  
hĩ˧ɳɯ˩	h ĩ ˧ ɳ ɯ ˩  
le˧ti˩	l e ˧ t i ˩  
mv̩˩tɕo˧	m v̩ ˩ tɕ o ˧  
õ˧ʈʂʰɯ˧ne˧ʝi˥	õ ˧ ʈʂʰ ɯ ˧ n e ˧ ʝ i ˥  
pi˧hĩ˧	p i ˧ h ĩ ˧  
tʰv̩˩dʑo˩	tʰ v̩ ˩ dʑ o ˩  
zɯ˧	z ɯ ˧  
le˧tɕɯ˧˥	l e ˧ tɕ ɯ ˧˥  
nɑ˩ʈʂʰɯ˥dʑo˩	n ɑ ˩ ʈʂʰ ɯ ˥ dʑ o ˩  
õ˧	õ ˧  
tso˧tso˧	ts o ˧ ts o ˧  
tʰv̩˧v̩˧ɳɯ˩	tʰ v̩ ˧ v̩ ˧ ɳ ɯ ˩  
æ˧ʂæ˧tɑ˩mv̩˩	æ ˧ ʂ æ ˧ t ɑ ˩ m v̩ ˩  
ɖɯ˧	ɖ ɯ ˧  
ə˧dɑ˧	ə ˧ d ɑ ˧  
ʁo˧dɑ˧	ʁ o ˧ d ɑ ˧  
ʑi˧mi˧	ʑ i ˧ m i ˧  
dɑ˧pɤ˧	d ɑ ˧ p ɤ ˧  
kʰv̩˩mi˩˥	kʰ v̩ ˩ m i ˩˥  
le˧dzɯ˥	l e ˧ dz ɯ ˥  
le˧qæ˧˥	l e ˧ q æ ˧˥  
lɑ˧	l ɑ ˧  
mo˧˥	m o ˧˥  
ni˧	n i ˧  
njɤ˧ɳɯ˧	n jɤ ˧ ɳ ɯ ˧  
no˧ɻ̍˩	n o ˧ ɻ̍ ˩  
pɤ˩jɤ˧	p ɤ ˩ jɤ ˧  
ɖɯ˧sɑ˥	ɖ ɯ ˧ s ɑ ˥  
ɖɯ˧ɲi˥	ɖ ɯ ˧ ɲ i ˥  
ɖɯ˧ʑi˩	ɖ ɯ ˧ ʑ i ˩  
ɖʐe˧	ɖʐ e ˧  
ɲi˩ze˩	ɲ i ˩ z e ˩  
ɳɯ˩dʑɯ˥	ɳ ɯ ˩ dʑ ɯ ˥  
ʐwæ˧ʈʂʰɯ˧	ʐ wæ ˧ ʈʂʰ ɯ ˧  
dzo˧	dz o ˧  
dʑo˩˥	dʑ o ˩˥  
hɯ˧	h ɯ ˧  
le˧dɑ˧˥	l e ˧ d ɑ ˧˥  
le˧se˥	l e ˧ s e ˥  
le˧tsʰɯ˩	l e ˧ tsʰ ɯ ˩  
le˧ŋv̩˩	l e ˧ ŋ v̩ ˩  
le˧ʂɯ˧	l e ˧ ʂ ɯ ˧  
mɤ˧sɯ˥	m ɤ ˧ s ɯ ˥  
tsʰi˧ɲi˧	tsʰ i ˧ ɲ i ˧  
zo˩	z o ˩  
zo˩no˧	z o ˩ n o ˧  
ɖɯ˧kʰwɤ˧	ɖ ɯ ˧ kʰ wɤ ˧  
ɖɯ˧so˩	ɖ ɯ ˧ s o ˩  
ʁwɤ˧	ʁ wɤ ˧  
ʁwɤ˧qo˧	ʁ wɤ ˧ q o ˧  
ʝi˥dʑo˩	ʝ i ˥ dʑ o ˩  
ʝi˧kʰv̩˥dʑo˩	ʝ i ˧ kʰ v̩ ˥ dʑ o ˩  
bɑ˩lɑ˩˥	b ɑ ˩ l ɑ ˩˥  
di˧qo˧	d i ˧ q o ˧  
di˩	d i ˩  
dzɯ˩	dz ɯ ˩  
dʑo˩kv̩˩	dʑ o ˩ k v̩ ˩  
gv̩˩	g v̩ ˩  
gɯ˩ʝi˥	g ɯ ˩ ʝ i ˥  
jɤ	jɤ  
kv̩˧	k v̩ ˧  
le˧hwæ˧	l e ˧ h wæ ˧  
le˧tɕɯ˧le˥po˩tsʰɯ˩	l e ˧ tɕ ɯ ˧ l e ˥ p o ˩ tsʰ ɯ ˩  
le˧ʈʂʰo˧	l e ˧ ʈʂʰ o ˧  
nɑ˩ʈʂʰɯ˥	n ɑ ˩ ʈʂʰ ɯ ˥  
qv̩˧ɻ̍˧ʁo˧qʰwɤ˥	q v̩ ˧ ɻ̍ ˧ ʁ o ˧ qʰ wɤ ˥  
si˧	s i ˧  
tɕʰi˩	tɕʰ i ˩  
ŋv̩˧	ŋ v̩ ˧  
ɕi˧ʈʂʰwæ˧	ɕ i ˧ ʈʂʰ wæ ˧  
ɖwæ˩mɤ˧zo˧	ɖ wæ ˩ m ɤ ˧ z o ˧  
ɖɯ˧ʁo˩	ɖ ɯ ˧ ʁ o ˩  
ɖɯ˧ʝi˧	ɖ ɯ ˧ ʝ i ˧  
ə	ə  
ə˧mv̩˧˥	ə ˧ m v̩ ˧˥  
ə˧sɯ˩kv̩˩	ə ˧ s ɯ ˩ k v̩ ˩  
ə˧tse˧	ə ˧ ts e ˧  
ɳɯ˩	ɳ ɯ ˩  
ʂe˧ʈʂe˩	ʂ e ˧ ʈʂ e ˩  
ʈʂe˧	ʈʂ e ˧  
ʐwɤ˩	ʐ wɤ ˩  
dɑ˧˥	d ɑ ˧˥  
dʑɤ˩pi˧	dʑ ɤ ˩ p i ˧  
gv̩˥	g v̩ ˥  
hwɤ˧tɕi˥ʁo˩bv̩˩	h wɤ ˧ tɕ i ˥ ʁ o ˩ b v̩ ˩  
kɤ˧kɤ˩	k ɤ ˧ k ɤ ˩  
kʰi˧	kʰ i ˧  
le˧tʰv̩˧	l e ˧ tʰ v̩ ˧  
le˧ɖʐɤ˧˥	l e ˧ ɖʐ ɤ ˧˥  
le˧ʁɑ˥ʂe˩	l e ˧ ʁ ɑ ˥ ʂ e ˩  
mɤ˧tʰɑ˧˥	m ɤ ˧ tʰ ɑ ˧˥  
o	o  
õ˧ʈʂʰɯ˧ne˧	õ ˧ ʈʂʰ ɯ ˧ n e ˧  
pi˧ɲi˥tsɯ˩	p i ˧ ɲ i ˥ ts ɯ ˩  
po˧˥	p o ˧˥  
qæ˧do˧	q æ ˧ d o ˧  
tsɯ˩	ts ɯ ˩  
tsʰi˧qʰæ˧˥	tsʰ i ˧ qʰ æ ˧˥  
tsʰo˧pæ˧	tsʰ o ˧ p æ ˧  
wo˩˥	w o ˩˥  
ɖɯ˧pʰæ˧	ɖ ɯ ˧ pʰ æ ˧  
ɖɯ˧v̩˧dʑo˧	ɖ ɯ ˧ v̩ ˧ dʑ o ˧  
ɖɯ˧v̩˧ɳɯ˧	ɖ ɯ ˧ v̩ ˧ ɳ ɯ ˧  
ɖɯ˧ɭɯ˧qo˧	ɖ ɯ ˧ ɭ ɯ ˧ q o ˧  
ɖʐv̩˧	ɖʐ v̩ ˧  
ə˧lɑ˧ʁwɤ˧	ə ˧ l ɑ ˧ ʁ wɤ ˧  
ə˧ʑi˧lɑ˥	ə ˧ ʑ i ˧ l ɑ ˥  
ə˧ʑi˧˥	ə ˧ ʑ i ˧˥  
ə˩sɯ˧kv̩˥	ə ˩ s ɯ ˧ k v̩ ˥  
ə˩zɯ˩˥	ə ˩ z ɯ ˩˥  
ʈʂʰæ˧ɣɯ˧	ʈʂʰ æ ˧ ɣ ɯ ˧  
ʈʰæ˩	ʈʰ æ ˩  
dʑo˧ɲi˥mæ˩	dʑ o ˧ ɲ i ˥ m æ ˩  
dʑɯ˩ʁo˩	dʑ ɯ ˩ ʁ o ˩  
gv̩˩˥	g v̩ ˩˥  
hĩ˧bæ˧	h ĩ ˧ b æ ˧  
le˧po˧jo˥	l e ˧ p o ˧ jo ˥  
le˧pv̩˧	l e ˧ p v̩ ˧  
li˩˥	l i ˩˥  
mɤ˧dʑo˧ze˧	m ɤ ˧ dʑ o ˧ z e ˧  
mɤ˧kv̩˧˥	m ɤ ˧ k v̩ ˧˥  
no˧ɳɯ˧	n o ˧ ɳ ɯ ˧  
pi˧kv̩˩mæ˩	p i ˧ k v̩ ˩ m æ ˩  
pɤ˩jɤ˧˥	p ɤ ˩ jɤ ˧˥  
pʰv̩˧ɖɯ˧	pʰ v̩ ˧ ɖ ɯ ˧  
tɕɯ˧˥	tɕ ɯ ˧˥  
tʰv̩˧ɲi˧	tʰ v̩ ˧ ɲ i ˧  
zo˩no˧dʑo˥	z o ˩ n o ˧ dʑ o ˥  
ɑ˩ʁo˧ɳɯ˧	ɑ ˩ ʁ o ˧ ɳ ɯ ˧  
ɖɯ˧kʰwɤ˥ɖɯ˩kʰwɤ˩	ɖ ɯ ˧ kʰ wɤ ˥ ɖ ɯ ˩ kʰ wɤ ˩  
ɖɯ˧v̩˧lɑ˧	ɖ ɯ ˧ v̩ ˧ l ɑ ˧  
ɖɯ˧v̩˧ɖɯ˧v̩˧	ɖ ɯ ˧ v̩ ˧ ɖ ɯ ˧ v̩ ˧  
ɖɯ˧zɯ˧	ɖ ɯ ˧ z ɯ ˧  
ɖɯ˧ʈv̩˩	ɖ ɯ ˧ ʈ v̩ ˩  
ə˧si˧	ə ˧ s i ˧  
ə˧si˧ɳɯ˧	ə ˧ s i ˧ ɳ ɯ ˧  
ə˧v̩˧ɳɯ˥	ə ˧ v̩ ˧ ɳ ɯ ˥  
ɬi˧di˩	ɬ i ˧ d i ˩  
ɬi˧di˩di˩mi˩qo˩	ɬ i ˧ d i ˩ d i ˩ m i ˩ q o ˩  
ɲi˥ze˩	ɲ i ˥ z e ˩  
ɲi˧kv̩˧˥	ɲ i ˧ k v̩ ˧˥  
ʁɑ˩ʂɯ˧	ʁ ɑ ˩ ʂ ɯ ˧  
ʈʂʰɯ˧v̩˧ɳɯ˩	ʈʂʰ ɯ ˧ v̩ ˧ ɳ ɯ ˩  
ʈʂʰɯ˧ʁo˥	ʈʂʰ ɯ ˧ ʁ o ˥  
ʐo˩	ʐ o ˩  
bi˧	b i ˧  
dɑ˧pɤ˧ɳɯ˧	d ɑ ˧ p ɤ ˧ ɳ ɯ ˧  
dʑo˥	dʑ o ˥  
dʑɤ˩hĩ˥	dʑ ɤ ˩ h ĩ ˥  
dʑɯ˩	dʑ ɯ ˩  
hhh	h h h  
le	l e  
le˧ɲi˩	l e ˧ ɲ i ˩  
le˧ʈʂʰæ˥	l e ˧ ʈʂʰ æ ˥  
lo˧	l o ˧  
lɑ˧ɳɯ˧	l ɑ ˧ ɳ ɯ ˧  
mo˥hĩ˩	m o ˥ h ĩ ˩  
mv̩˩si˧njɤ˧˥	m v̩ ˩ s i ˧ n jɤ ˧˥  
mæ˧qo˩	m æ ˧ q o ˩  
mɤ˧dzɯ˥	m ɤ ˧ dz ɯ ˥  
mɤ˧dʑo˧hĩ˧	m ɤ ˧ dʑ o ˧ h ĩ ˧  
mɤ˧dʑo˧ɲi˥mæ˩	m ɤ ˧ dʑ o ˧ ɲ i ˥ m æ ˩  
mɤ˧dʑo˩	m ɤ ˧ dʑ o ˩  
njɤ˧ki˧	n jɤ ˧ k i ˧  
no˩	n o ˩  
nɑ˩tsʰi˩˥	n ɑ ˩ tsʰ i ˩˥  
pi˥zo˩	p i ˥ z o ˩  
pi˧zo˥	p i ˧ z o ˥  
qo˩	q o ˩  
qo˩ho˧qo˥	q o ˩ h o ˧ q o ˥  
qʰv̩˩tsʰi˧kʰv̩˥	qʰ v̩ ˩ tsʰ i ˧ kʰ v̩ ˥  
si˧dzi˩	s i ˧ dz i ˩  
so˧	s o ˧  
sɯ˧kʰɯ˩	s ɯ ˧ kʰ ɯ ˩  
ti˩	t i ˩  
tsɑ˧˥	ts ɑ ˧˥  
tsɤ˧ʝi˧	ts ɤ ˧ ʝ i ˧  
tsʰe˧	tsʰ e ˧  
tsʰi˧ʝi˧dʑo˩	tsʰ i ˧ ʝ i ˧ dʑ o ˩  
tʰv̩˧v̩˧ki˧	tʰ v̩ ˧ v̩ ˧ k i ˧  
v̩˧	v̩ ˧  
zɯ˧zɯ˧	z ɯ ˧ z ɯ ˧  
æ˧ʂæ˧dʑo˩	æ ˧ ʂ æ ˧ dʑ o ˩  
ŋv̩˩˥	ŋ v̩ ˩˥  
ɖæ˩lɑ˧so˧	ɖ æ ˩ l ɑ ˧ s o ˧  
ɖɯ˧qʰwɤ˧˥	ɖ ɯ ˧ qʰ wɤ ˧˥  
ɖɯ˩hĩ˩˥	ɖ ɯ ˩ h ĩ ˩˥  
ə˧sɯ˥	ə ˧ s ɯ ˥  
ə˧ʝi˧tsʰi˧ʝi˧dʑo˩	ə ˧ ʝ i ˧ tsʰ i ˧ ʝ i ˧ dʑ o ˩  
ʁo˧tʰo˩	ʁ o ˧ tʰ o ˩  
ʂɯ˧ɬi˧mi˧	ʂ ɯ ˧ ɬ i ˧ m i ˧  
ʐæ˩sɯ˩˥	ʐ æ ˩ s ɯ ˩˥  
ʝi˥kv̩˩	ʝ i ˥ k v̩ ˩  
ʝi˧kʰv̩˥	ʝ i ˧ kʰ v̩ ˥  
bi˩	b i ˩  
dɑ˥	d ɑ ˥  
dʑi˧	dʑ i ˧  
dʑi˧mi˧	dʑ i ˧ m i ˧  
dʑo˧kv̩˧˥	dʑ o ˧ k v̩ ˧˥  
gv̩˧wo˥	g v̩ ˧ w o ˥  
gv̩˩ɬi˩mi˩˥	g v̩ ˩ ɬ i ˩ m i ˩˥  
hĩ˧bi˥	h ĩ ˧ b i ˥  
hĩ˧ki˧	h ĩ ˧ k i ˧  
hĩ˧ki˧ki˩	h ĩ ˧ k i ˧ k i ˩  
hĩ˧ʈʂʰɯ˧dʑo˩	h ĩ ˧ ʈʂʰ ɯ ˧ dʑ o ˩  
hwæ˧	h wæ ˧  
jɤ˧	jɤ ˧  
kʰv̩˧	kʰ v̩ ˧  
kʰv̩˧ʂɯ˥	kʰ v̩ ˧ ʂ ɯ ˥  
kʰv̩˩mi˩ɳɯ˥	kʰ v̩ ˩ m i ˩ ɳ ɯ ˥  
kʰv̩˩mi˩ʈʂʰɯ˥	kʰ v̩ ˩ m i ˩ ʈʂʰ ɯ ˥  
le˧bi˩	l e ˧ b i ˩  
le˧go˩	l e ˧ g o ˩  
le˧qʰæ˧˥	l e ˧ qʰ æ ˧˥  
le˧ʂe˧	l e ˧ ʂ e ˧  
le˧ʂɯ˧hĩ˧	l e ˧ ʂ ɯ ˧ h ĩ ˧  
le˧ʝi˥	l e ˧ ʝ i ˥  
lɑ˩	l ɑ ˩  
mi˩zɯ˩˥	m i ˩ z ɯ ˩˥  
mmm	m m m  
mo˧ɳɯ˥	m o ˧ ɳ ɯ ˥  
mɤ˧do˩	m ɤ ˧ d o ˩  
mɤ˧dʑo˩ze˩	m ɤ ˧ dʑ o ˩ z e ˩  
mɤ˧po˧˥	m ɤ ˧ p o ˧˥  
n	n  
nɑ˩˥	n ɑ ˩˥  
õ˩	õ ˩  
pæ˧kʰwɤ˧	p æ ˧ kʰ wɤ ˧  
pʰi˧	pʰ i ˧  
so˩kv̩˩˥	s o ˩ k v̩ ˩˥  
tsʰe˩so˩kʰv̩˩	tsʰ e ˩ s o ˩ kʰ v̩ ˩  
tv̩˩	t v̩ ˩  
tɕi˩hĩ˩˥	tɕ i ˩ h ĩ ˩˥  
tɕɯ˩zo˩	tɕ ɯ ˩ z o ˩  
tʰi˥kʰɯ˩	tʰ i ˥ kʰ ɯ ˩  
tʰi˧hɑ̃˧˥	tʰ i ˧ h ɑ̃ ˧˥  
tʰi˧tɕɤ˧˥	tʰ i ˧ tɕ ɤ ˧˥  
tʰv̩˧v̩˧dʑo˩	tʰ v̩ ˧ v̩ ˧ dʑ o ˩  
v̩˩tsʰɤ˧	v̩ ˩ tsʰ ɤ ˧  
zo˧mv̩˥ʈʂʰɯ˩	z o ˧ m v̩ ˥ ʈʂʰ ɯ ˩  
ɕjɤ	ɕ jɤ  
ɖwæ˩	ɖ wæ ˩  
ɖɯ˧bæ˧	ɖ ɯ ˧ b æ ˧  
ɖɯ˧kʰɯ˩	ɖ ɯ ˧ kʰ ɯ ˩  
ɖɯ˧pʰæ˧˥	ɖ ɯ ˧ pʰ æ ˧˥  
ɖɯ˧qʰwɤ˧	ɖ ɯ ˧ qʰ wɤ ˧  
ɖɯ˧ɭɯ˧ɖɯ˧ɭɯ˧	ɖ ɯ ˧ ɭ ɯ ˧ ɖ ɯ ˧ ɭ ɯ ˧  
ɖɯ˩ʁo˩	ɖ ɯ ˩ ʁ o ˩  
ə˧dɑ˥	ə ˧ d ɑ ˥  
ə˧dɑ˧ə˧mi˧	ə ˧ d ɑ ˧ ə ˧ m i ˧  
ə˧mv̩˩	ə ˧ m v̩ ˩  
ə˧pʰv̩˧ki˧	ə ˧ pʰ v̩ ˧ k i ˧  
ɬi˧ʈv̩˥	ɬ i ˧ ʈ v̩ ˥  
ɲi˧ɭɯ˧	ɲ i ˧ ɭ ɯ ˧  
ɳɯ˧	ɳ ɯ ˧  
ʂæ˧	ʂ æ ˧  
ʈʂʰɯ˧bæ˧	ʈʂʰ ɯ ˧ b æ ˧  
ʈʂʰɯ˧ɭɯ˧	ʈʂʰ ɯ ˧ ɭ ɯ ˧  
ʈʰæ˧ɻæ˩	ʈʰ æ ˧ ɻ æ ˩  
ʐo˩˥	ʐ o ˩˥  
ʐv̩˩kv̩˩˥	ʐ v̩ ˩ k v̩ ˩˥  
ʝi˥se˩dʑo˩	ʝ i ˥ s e ˩ dʑ o ˩  
bo˩	b o ˩  
dzi˩hĩ˩	dz i ˩ h ĩ ˩  
dʑo˧ze˥	dʑ o ˧ z e ˥  
dʑo˧ɲi˥tsɯ˩	dʑ o ˧ ɲ i ˥ ts ɯ ˩  
dʑo˧˥	dʑ o ˧˥  
dʑɤ˩	dʑ ɤ ˩  
dʑɯ˧li˧	dʑ ɯ ˧ l i ˧  
dʑɯ˩nɑ˩mi˩ʁo˩˥	dʑ ɯ ˩ n ɑ ˩ m i ˩ ʁ o ˩˥  
gv̩˧	g v̩ ˧  
gv̩˩pʰæ˩˥	g v̩ ˩ pʰ æ ˩˥  
gɤ˩ʑi˥	g ɤ ˩ ʑ i ˥  
hɑ˧ʈʂʰɯ˧	h ɑ ˧ ʈʂʰ ɯ ˧  
hɤ˩˥	h ɤ ˩˥  
hɯ˧dʑo˧	h ɯ ˧ dʑ o ˧  
hɯ˧hĩ˧	h ɯ ˧ h ĩ ˧  
kwɤ˩	k wɤ ˩  
kwɤ˩tɕɯ˩	k wɤ ˩ tɕ ɯ ˩  
kʰv̩˩mi˩ki˥	kʰ v̩ ˩ m i ˩ k i ˥  
kʰv̩˩mi˩ʈʂʰɯ˥dʑo˩	kʰ v̩ ˩ m i ˩ ʈʂʰ ɯ ˥ dʑ o ˩  
le˧bi˩kv̩˩ze˩mæ˩	l e ˧ b i ˩ k v̩ ˩ z e ˩ m æ ˩  
le˧bi˩kwɤ˩tɕɯ˩lɑ˩	l e ˧ b i ˩ k wɤ ˩ tɕ ɯ ˩ l ɑ ˩  
le˧bæ˧˥	l e ˧ b æ ˧˥  
le˧hɯ˩dʑo˩	l e ˧ h ɯ ˩ dʑ o ˩  
le˧lɑ˧˥	l e ˧ l ɑ ˧˥  
le˧mo˩	l e ˧ m o ˩  
le˧po˧˥	l e ˧ p o ˧˥  
le˧pɤ˥pɤ˩	l e ˧ p ɤ ˥ p ɤ ˩  
le˧tsʰɯ˩dʑo˩	l e ˧ tsʰ ɯ ˩ dʑ o ˩  
le˧tv̩˧	l e ˧ t v̩ ˧  
le˧tʰv̩˧ze˧	l e ˧ tʰ v̩ ˧ z e ˧  
le˧wo˥	l e ˧ w o ˥  
le˧ʂɯ˧ze˧	l e ˧ ʂ ɯ ˧ z e ˧  
le˧ʑi˩	l e ˧ ʑ i ˩  
le˧ʝi˩ze˩	l e ˧ ʝ i ˩ z e ˩  
lo˩dʑo˥	l o ˩ dʑ o ˥  
lɑ˧do˧	l ɑ ˧ d o ˧  
mo˧ʈʂʰɯ˧	m o ˧ ʈʂʰ ɯ ˧  
mv	m v  
mv̩˧di˧qo˥	m v̩ ˧ d i ˧ q o ˥  
mv̩˧dze˧	m v̩ ˧ dz e ˧  
mv̩˧ɭɯ˩sɯ˩pʰi˩	m v̩ ˧ ɭ ɯ ˩ s ɯ ˩ pʰ i ˩  
mv̩˩zo˩˥	m v̩ ˩ z o ˩˥  
mv̩˩zɯ˩ʈʂʰɯ˥dʑo˩	m v̩ ˩ z ɯ ˩ ʈʂʰ ɯ ˥ dʑ o ˩  
mv̩˩ɳɯ˥	m v̩ ˩ ɳ ɯ ˥  
mɤ˧tɕʰi˧	m ɤ ˧ tɕʰ i ˧  
õ˧bv̩˥	õ ˧ b v̩ ˥  
pi˧ɲi˥mæ˩	p i ˧ ɲ i ˥ m æ ˩  
pæ˧˥hwɤ˧	p æ ˧˥ h wɤ ˧  
pʰæ˧tɕi˥	pʰ æ ˧ tɕ i ˥  
qv̩˧ɻ̍˧ʈʂʰæ˧nɑ˥	q v̩ ˧ ɻ̍ ˧ ʈʂʰ æ ˧ n ɑ ˥  
qʰo˧˥	qʰ o ˧˥  
se˩	s e ˩  
so˧ɬi˧mi˧	s o ˧ ɬ i ˧ m i ˧  
so˧ɭɯ˧	s o ˧ ɭ ɯ ˧  
so˧ɲi˥	s o ˧ ɲ i ˥  
sɯ˧pʰi˧ɳɯ˧	s ɯ ˧ pʰ i ˧ ɳ ɯ ˧  
tɕɤ˧˥	tɕ ɤ ˧˥  
tɕɯ˩hĩ˩	tɕ ɯ ˩ h ĩ ˩  
tʰi˧di˩	tʰ i ˧ d i ˩  
tʰv̩˧qo˧ɳɯ˧	tʰ v̩ ˧ q o ˧ ɳ ɯ ˧  
tʰv̩˧v̩˧	tʰ v̩ ˧ v̩ ˧  
tʰv̩˧ɭɯ˧	tʰ v̩ ˧ ɭ ɯ ˧  
tʰv̩˧ɲi˧dʑo˩	tʰ v̩ ˧ ɲ i ˧ dʑ o ˩  
tʰv̩˩kʰɯ˩	tʰ v̩ ˩ kʰ ɯ ˩  
tʰæ˧ɻæ˩	tʰ æ ˧ ɻ æ ˩  
zo˧ɳɯ˩	z o ˧ ɳ ɯ ˩  
zo˩no˧ni˩	z o ˩ n o ˧ n i ˩  
æ˧ʂæ˧tɑ˩mv̩˩dʑo˩	æ ˧ ʂ æ ˧ t ɑ ˩ m v̩ ˩ dʑ o ˩  
ɑ˩pʰo˩	ɑ ˩ pʰ o ˩  
ɖɯ˧kʰv̩˧ɳɯ˥	ɖ ɯ ˧ kʰ v̩ ˧ ɳ ɯ ˥  
ɖɯ˧pæ˥	ɖ ɯ ˧ p æ ˥  
ɖɯ˧pɤ˩	ɖ ɯ ˧ p ɤ ˩  
ɖɯ˧tɕʰi˩	ɖ ɯ ˧ tɕʰ i ˩  
ɖɯ˧ɬi˧	ɖ ɯ ˧ ɬ i ˧  
ɖɯ˧ɲi˧	ɖ ɯ ˧ ɲ i ˧  
ɖɯ˧ʂɯ˩lɑ˩	ɖ ɯ ˧ ʂ ɯ ˩ l ɑ ˩  
ɖɯ˧ʑi˩ɻ̍˩dʑo˩	ɖ ɯ ˧ ʑ i ˩ ɻ̍ ˩ dʑ o ˩  
əəə	ə ə ə  
ə˧dɑ˥ɳɯ˩	ə ˧ d ɑ ˥ ɳ ɯ ˩  
ə˧mi˧lɑ˧	ə ˧ m i ˧ l ɑ ˧  
ə˧mi˧ɻæ˩	ə ˧ m i ˧ ɻ æ ˩  
ə˧ti˥dzi˩	ə ˧ t i ˥ dz i ˩  
ɣɯ˧	ɣ ɯ ˧  
ɬɑ˧sɑ˧	ɬ ɑ ˧ s ɑ ˧  
ɲi˥kv̩˩	ɲ i ˥ k v̩ ˩  
ɲi˥ze˩mæ˩	ɲ i ˥ z e ˩ m æ ˩  
ɲi˧kv̩˧	ɲ i ˧ k v̩ ˧  
ɲi˧zo˧	ɲ i ˧ z o ˧  
ʂɯ˩	ʂ ɯ ˩  
ʈʂʰɯ˧qo˧ɳɯ˧	ʈʂʰ ɯ ˧ q o ˧ ɳ ɯ ˧  
ʈʂʰɯ˧tɕi˩	ʈʂʰ ɯ ˧ tɕ i ˩  
ʈʂʰɯ˧ɻæ˥	ʈʂʰ ɯ ˧ ɻ æ ˥  
ʈʂʰɯ˧ʑi˧ɻ̍˥dʑo˩	ʈʂʰ ɯ ˧ ʑ i ˧ ɻ̍ ˥ dʑ o ˩  
ʈʂʰɯ˩dʑo˩	ʈʂʰ ɯ ˩ dʑ o ˩  
ʈʰæ˧	ʈʰ æ ˧  
ʐwæ˩˥	ʐ wæ ˩˥  
ʐwɤ˩˥	ʐ wɤ ˩˥  
ʐɤ˩mi˩˥	ʐ ɤ ˩ m i ˩˥  
ʝi˧lv̩˧	ʝ i ˧ l v̩ ˧  
ʝi˧ɲi˥	ʝ i ˧ ɲ i ˥  
bo˩ʈʂʰæ˧	b o ˩ ʈʂʰ æ ˧  
bæ˧	b æ ˧  
bæ˧˥	b æ ˧˥  
di˩hĩ˩	d i ˩ h ĩ ˩  
di˩kv̩˩ze˩	d i ˩ k v̩ ˩ z e ˩  
do˩	d o ˩  
dv̩˩pʰæ˧	d v̩ ˩ pʰ æ ˧  
dze˧ɭɯ˧	dz e ˧ ɭ ɯ ˧  
dze˧ʈʂʰɤ˥	dz e ˧ ʈʂʰ ɤ ˥  
dzɯ˧di˧	dz ɯ ˧ d i ˧  
dzɯ˧di˧˥	dz ɯ ˧ d i ˧˥  
dʑ	dʑ  
dʑo˧mɤ˧kv̩˧˥	dʑ o ˧ m ɤ ˧ k v̩ ˧˥  
dʑo˧ze˧	dʑ o ˧ z e ˧  
dʑo˩kv̩˩mv̩˩	dʑ o ˩ k v̩ ˩ m v̩ ˩  
dʑo˩kv̩˩mæ˩	dʑ o ˩ k v̩ ˩ m æ ˩  
dʑɤ˩kʰɯ˥	dʑ ɤ ˩ kʰ ɯ ˥  
gv̩˧ɲi˥tsɯ˩	g v̩ ˧ ɲ i ˥ ts ɯ ˩  
gv̩˧˥	g v̩ ˧˥  
gv̩˩ze˩	g v̩ ˩ z e ˩  
gɤ˧qo˥	g ɤ ˧ q o ˥  
gɤ˩ʈi˧	g ɤ ˩ ʈ i ˧  
gɤ˩ʑi˥dʑo˩	g ɤ ˩ ʑ i ˥ dʑ o ˩  
gɤ˩ʑi˥hĩ˩	g ɤ ˩ ʑ i ˥ h ĩ ˩  
gɯ˩ʝi˥dʑo˩	g ɯ ˩ ʝ i ˥ dʑ o ˩  
h	h  
hi˧	h i ˧  
hi˧lɤ˩	h i ˧ l ɤ ˩  
hi˩	h i ˩  
hĩ˧dʑo˩	h ĩ ˧ dʑ o ˩  
ho˧	h o ˧  
hwæ˥	h wæ ˥  
hwɤ˧tɕi˥	h wɤ ˧ tɕ i ˥  
hæ˧ʐwɤ˩	h æ ˧ ʐ wɤ ˩  
hæ˧ʐwɤ˩dʑo˩	h æ ˧ ʐ wɤ ˩ dʑ o ˩  
hɑ̃˩	h ɑ̃ ˩  
hɯ˧ɲi˥tsɯ˩	h ɯ ˧ ɲ i ˥ ts ɯ ˩  
hɯ˩	h ɯ ˩  
jɤ˩jo˧	jɤ ˩ jo ˧  
kɯ˧ʈʂʰwɤ˩	k ɯ ˧ ʈʂʰ wɤ ˩  
kʰi˧bɤ˧	kʰ i ˧ b ɤ ˧  
kʰi˧mi˧	kʰ i ˧ m i ˧  
kʰi˧˥	kʰ i ˧˥  
kʰv̩˧tɕʰi˧	kʰ v̩ ˧ tɕʰ i ˧  
kʰɯ˧˥	kʰ ɯ ˧˥  
le˧dɑ˩	l e ˧ d ɑ ˩  
le˧dɑ˩dɑ˩	l e ˧ d ɑ ˩ d ɑ ˩  
le˧fv̩˧	l e ˧ f v̩ ˧  
le˧hæ̃˧˥	l e ˧ h æ̃ ˧˥  
le˧hɑ̃˧˥	l e ˧ h ɑ̃ ˧˥  
le˧kʰv̩˥	l e ˧ kʰ v̩ ˥  
le˧li˧	l e ˧ l i ˧  
le˧qwæ˧˥	l e ˧ q wæ ˧˥  
le˧qʰo˩	l e ˧ qʰ o ˩  
le˧se˩ɲi˩ze˩	l e ˧ s e ˩ ɲ i ˩ z e ˩  
le˧so˩	l e ˧ s o ˩  
le˧ʂɯ˧bi˧	l e ˧ ʂ ɯ ˧ b i ˧  
le˧ʈɤ˧	l e ˧ ʈ ɤ ˧  
le˧ʈʂʰo˥	l e ˧ ʈʂʰ o ˥  
le˧ʈʂʰæ˧ʈʂʰæ˧	l e ˧ ʈʂʰ æ ˧ ʈʂʰ æ ˧  
le˧ʐɤ˧	l e ˧ ʐ ɤ ˧  
li˧	l i ˧  
lo˧gv̩˩	l o ˧ g v̩ ˩  
lo˩jɤ˧	l o ˩ jɤ ˧  
mo˧ʈʂʰɯ˥	m o ˧ ʈʂʰ ɯ ˥  
mo˧ʈʂʰɯ˥dʑo˩	m o ˧ ʈʂʰ ɯ ˥ dʑ o ˩  
mv̩˧di˩	m v̩ ˧ d i ˩  
mv̩˧ʈʰæ˧	m v̩ ˧ ʈʰ æ ˧  
mv̩˩kʰv̩˧˥	m v̩ ˩ kʰ v̩ ˧˥  
mv̩˩lo˥ʝi˩	m v̩ ˩ l o ˥ ʝ i ˩  
mv̩˩zo˩	m v̩ ˩ z o ˩  
mv̩˩zɯ˩˥	m v̩ ˩ z ɯ ˩˥  
mɤ˧bi˧	m ɤ ˧ b i ˧  
mɤ˧dʑo˧˥	m ɤ ˧ dʑ o ˧˥  
mɤ˧dʑo˩zo˩	m ɤ ˧ dʑ o ˩ z o ˩  
mɤ˧dʑo˩ɲi˩	m ɤ ˧ dʑ o ˩ ɲ i ˩  
mɤ˧kv̩˩	m ɤ ˧ k v̩ ˩  
mɤ˩mv̩˩	m ɤ ˩ m v̩ ˩  
njæ˧sɯ˩kv̩˩dʑo˩	n jæ ˧ s ɯ ˩ k v̩ ˩ dʑ o ˩  
nv̩˩ɭɯ˧	n v̩ ˩ ɭ ɯ ˧  
pi˥	p i ˥  
pi˧hĩ˧ʈʂʰɯ˧dʑo˩	p i ˧ h ĩ ˧ ʈʂʰ ɯ ˧ dʑ o ˩  
pi˧kv̩˩tsɯ˩	p i ˧ k v̩ ˩ ts ɯ ˩  
pi˧kwɤ˩tɕɯ˩lɑ˩	p i ˧ k wɤ ˩ tɕ ɯ ˩ l ɑ ˩  
pi˩hĩ˩	p i ˩ h ĩ ˩  
pi˩zo˩	p i ˩ z o ˩  
pi˩ɲi˩tsɯ˩	p i ˩ ɲ i ˩ ts ɯ ˩  
po˧bi˥	p o ˧ b i ˥  
pv̩˩tʰɑ˩kʰɯ˥	p v̩ ˩ tʰ ɑ ˩ kʰ ɯ ˥  
pʰi˩	pʰ i ˩  
pʰɤ˧bɤ˧	pʰ ɤ ˧ b ɤ ˧  
qv̩˧ɻ̍˧	q v̩ ˧ ɻ̍ ˧  
qwæ˧˥	q wæ ˧˥  
qæ˧	q æ ˧  
qʰv̩˧ɬi˧mi˧	qʰ v̩ ˧ ɬ i ˧ m i ˧  
qʰæ˧	qʰ æ ˧  
so˧ʝi˥dʑo˩	s o ˧ ʝ i ˥ dʑ o ˩  
so˩	s o ˩  
sɯ˧pʰi˧	s ɯ ˧ pʰ i ˧  
to˩pv̩˧	t o ˩ p v̩ ˧  
tsʰe˧ɬi˧mi˧	tsʰ e ˧ ɬ i ˧ m i ˧  
tsʰe˩ŋwɤ˩hɑ̃˥	tsʰ e ˩ ŋ wɤ ˩ h ɑ̃ ˥  
tsʰi˧ʝi˧	tsʰ i ˧ ʝ i ˧  
tsʰi˧˥	tsʰ i ˧˥  
tsʰo˧qʰwɤ˩dʑo˩	tsʰ o ˧ qʰ wɤ ˩ dʑ o ˩  
tsʰɯ˧˥	tsʰ ɯ ˧˥  
tsʰɯ˩dʑo˩	tsʰ ɯ ˩ dʑ o ˩  
tɕɤ˩	tɕ ɤ ˩  
tɕʰi˧	tɕʰ i ˧  
tɕʰi˧bi˧pi˧	tɕʰ i ˧ b i ˧ p i ˧  
tɕʰi˧mɤ˧bi˧ze˧	tɕʰ i ˧ m ɤ ˧ b i ˧ z e ˧  
tɕʰɤ˧pɤ˧mi˧	tɕʰ ɤ ˧ p ɤ ˧ m i ˧  
tɕʰɯ˩jɤ˩	tɕʰ ɯ ˩ jɤ ˩  
tʰi˧	tʰ i ˧  
tʰi˧kwɤ˩kʰɯ˩	tʰ i ˧ k wɤ ˩ kʰ ɯ ˩  
tʰi˧pʰo˧˥	tʰ i ˧ pʰ o ˧˥  
tʰi˧ɬi˧˥	tʰ i ˧ ɬ i ˧˥  
tʰi˩tɕɯ˩	tʰ i ˩ tɕ ɯ ˩  
tʰv̩˧dʑo˧	tʰ v̩ ˧ dʑ o ˧  
tʰv̩˧kʰwɤ˧	tʰ v̩ ˧ kʰ wɤ ˧  
tʰv̩˧ʁo˥	tʰ v̩ ˧ ʁ o ˥  
tʰv̩˩kwɤ˩tɕɯ˩lɑ˩	tʰ v̩ ˩ k wɤ ˩ tɕ ɯ ˩ l ɑ ˩  
tʰææ̃˧	tʰ æ æ̃ ˧  
æ˧hi˩hi˩	æ ˧ h i ˩ h i ˩  
æ˧ʂæ˧ʈʂʰɯ˧dʑo˩	æ ˧ ʂ æ ˧ ʈʂʰ ɯ ˧ dʑ o ˩  
æ˩gv̩˩˥	æ ˩ g v̩ ˩˥  
ŋwɤ˧hɑ̃˩	ŋ wɤ ˧ h ɑ̃ ˩  
ɑ˩pʰo˩˥	ɑ ˩ pʰ o ˩˥  
ɑ˩ʁo˥	ɑ ˩ ʁ o ˥  
ɖwæ˩˥	ɖ wæ ˩˥  
ɖɯ˧dzi˩	ɖ ɯ ˧ dz i ˩  
ɖɯ˧pʰo˧˥	ɖ ɯ ˧ pʰ o ˧˥  
ɖɯ˧v̩˥	ɖ ɯ ˧ v̩ ˥  
ɖɯ˧ɬi˧mi˧	ɖ ɯ ˧ ɬ i ˧ m i ˧  
ɖɯ˧ʑi˩ɖɯ˩ʑi˩	ɖ ɯ ˧ ʑ i ˩ ɖ ɯ ˩ ʑ i ˩  
ɖɯ˧ʑi˩ɳɯ˩	ɖ ɯ ˧ ʑ i ˩ ɳ ɯ ˩  
ɖɯ˧ʑi˩ɻ̍˩	ɖ ɯ ˧ ʑ i ˩ ɻ̍ ˩  
ə˧dɑ˥lɑ˩	ə ˧ d ɑ ˥ l ɑ ˩  
ə˧hɑ˧bɑ˩lɑ˩	ə ˧ h ɑ ˧ b ɑ ˩ l ɑ ˩  
ə˧mv̩˩ki˩	ə ˧ m v̩ ˩ k i ˩  
ə˧pʰv̩˧	ə ˧ pʰ v̩ ˧  
ə˧ʑi˧ɳɯ˥	ə ˧ ʑ i ˧ ɳ ɯ ˥  
ə˧ʝi˧tsʰi˧ʝi˧	ə ˧ ʝ i ˧ tsʰ i ˧ ʝ i ˧  
ə˩kʰɯ˩lɑ˥	ə ˩ kʰ ɯ ˩ l ɑ ˥  
ə˩kʰɯ˩˥	ə ˩ kʰ ɯ ˩˥  
ə̃	ə̃  
ɬi˧di˩di˩mi˩	ɬ i ˧ d i ˩ d i ˩ m i ˩  
ɲi˥tsɯ˩	ɲ i ˥ ts ɯ ˩  
ɲi˧mi˧kʰɯ˧ʂɯ˧	ɲ i ˧ m i ˧ kʰ ɯ ˧ ʂ ɯ ˧  
ɲi˧ʈʂæ˧ʑi˧	ɲ i ˧ ʈʂ æ ˧ ʑ i ˧  
ɲi˩kv̩˩tsɯ˩	ɲ i ˩ k v̩ ˩ ts ɯ ˩  
ʁæ˧mɤ˧ʑi˧	ʁ æ ˧ m ɤ ˧ ʑ i ˧  
ʁɑ˩ʂe˩	ʁ ɑ ˩ ʂ e ˩  
ʂe˧pʰæ˩	ʂ e ˧ pʰ æ ˩  
ʂwæ˧hĩ˧qo˩	ʂ wæ ˧ h ĩ ˧ q o ˩  
ʂɯ˧hĩ˧	ʂ ɯ ˧ h ĩ ˧  
ʈʂʰ	ʈʂʰ  
ʈʂʰv̩˧	ʈʂʰ v̩ ˧  
ʈʂʰɯ˧dʑo˧	ʈʂʰ ɯ ˧ dʑ o ˧  
ʈʂʰɯ˧lɑ˩	ʈʂʰ ɯ ˧ l ɑ ˩  
ʈʂʰɯ˧ɳɯ˧	ʈʂʰ ɯ ˧ ɳ ɯ ˧  
ʈʂʰɯ˧ʑi˥	ʈʂʰ ɯ ˧ ʑ i ˥  
ʈʂʰɯ˩tɕi˩	ʈʂʰ ɯ ˩ tɕ i ˩  
ʈʰɯ˩˥	ʈʰ ɯ ˩˥  
ʐv̩˩kv̩˩	ʐ v̩ ˩ k v̩ ˩  
ʐv̩˩ɭɯ˩˥	ʐ v̩ ˩ ɭ ɯ ˩˥  
ʐwɤ˩ɲi˥tsɯ˩	ʐ wɤ ˩ ɲ i ˥ ts ɯ ˩  
ʐæ˩	ʐ æ ˩  
ʐɤ˩	ʐ ɤ ˩  
ʐɤ˩mi˩qo˥	ʐ ɤ ˩ m i ˩ q o ˥  
ʑi˧	ʑ i ˧  
ʑi˩	ʑ i ˩  
ʝi˧lv̩˧˥	ʝ i ˧ l v̩ ˧˥  
ʝi˧qv̩˥ɻ̍˩ɳɯ˩	ʝ i ˧ q v̩ ˥ ɻ̍ ˩ ɳ ɯ ˩  
ʝi˧se˧	ʝ i ˧ s e ˧  
ʝi˧zo˥	ʝ i ˧ z o ˥  
bi˧kv̩˧˥	b i ˧ k v̩ ˧˥  
bi˩˥	b i ˩˥  
bv̩˧	b v̩ ˧  
bv̩˩hwɤ˩qo˥	b v̩ ˩ h wɤ ˩ q o ˥  
bɑ˩lɑ˩	b ɑ ˩ l ɑ ˩  
di˧qo˧ɳɯ˧	d i ˧ q o ˧ ɳ ɯ ˧  
di˩li˩ʁo˩bv̩˥ʈʂʰɯ˩	d i ˩ l i ˩ ʁ o ˩ b v̩ ˥ ʈʂʰ ɯ ˩  
do˥	d o ˥  
do˧˥	d o ˧˥  
dze˧	dz e ˧  
dzɑ˧hĩ˧	dz ɑ ˧ h ĩ ˧  
dzɑ˩qʰwɤ˩˥	dz ɑ ˩ qʰ wɤ ˩˥  
dzɯ˧kv̩˩	dz ɯ ˧ k v̩ ˩  
dzɯ˧tʰɑ˩	dz ɯ ˧ tʰ ɑ ˩  
dɑ˩	d ɑ ˩  
dʑi˧hṽ˧	dʑ i ˧ h ṽ ˧  
dʑo˧kv̩˩	dʑ o ˧ k v̩ ˩  
dʑo˩ɲi˩tsɯ˩	dʑ o ˩ ɲ i ˩ ts ɯ ˩  
dʑɯ˧qo˧	dʑ ɯ ˧ q o ˧  
dʑɯ˧ʈʂʰwæ˧	dʑ ɯ ˧ ʈʂʰ wæ ˧  
dʑɯ˩nɑ˩mi˩ʁo˩	dʑ ɯ ˩ n ɑ ˩ m i ˩ ʁ o ˩  
dʑɯ˩nɑ˩mi˩˥	dʑ ɯ ˩ n ɑ ˩ m i ˩˥  
dʑɯ˩tsʰi˧	dʑ ɯ ˩ tsʰ i ˧  
dʑɯ˩ʈʂʰɯ˥	dʑ ɯ ˩ ʈʂʰ ɯ ˥  
g	g  
gi˧dʑɯ˧	g i ˧ dʑ ɯ ˧  
go˩	g o ˩  
go˩bo˥	g o ˩ b o ˥  
gõndõ	g õ n d õ  
gv̩˧kv̩˥	g v̩ ˧ k v̩ ˥  
gv̩˩hĩ˩˥	g v̩ ˩ h ĩ ˩˥  
gv̩˩pʰæ˩	g v̩ ˩ pʰ æ ˩  
gv̩˩ɲi˩	g v̩ ˩ ɲ i ˩  
gæ˩pʰæ˧	g æ ˩ pʰ æ ˧  
gɤ˧	g ɤ ˧  
gɤ˧bi˧	g ɤ ˧ b i ˧  
gɯ˩	g ɯ ˩  
gɯ˩˥	g ɯ ˩˥  
hi˩nɑ˧mi˧	h i ˩ n ɑ ˧ m i ˧  
hĩ˧lɑ˩	h ĩ ˧ l ɑ ˩  
hĩ˧mo˥ɻæ˩ɳɯ˩	h ĩ ˧ m o ˥ ɻ æ ˩ ɳ ɯ ˩  
hĩ˧qɑ˩	h ĩ ˧ q ɑ ˩  
hĩ˩	h ĩ ˩  
ho˧di˧dʑo˧	h o ˧ d i ˧ dʑ o ˧  
ho˩	h o ˩  
hõ˧	h õ ˧  
hwæ˩	h wæ ˩  
hwɤ˧tɕi˥ʈʂʰɯ˩	h wɤ ˧ tɕ i ˥ ʈʂʰ ɯ ˩  
hæ˧ɳɯ˧	h æ ˧ ɳ ɯ ˧  
hɑ˧lɑ˩	h ɑ ˧ l ɑ ˩  
hɑ˧ʐwɤ˩	h ɑ ˧ ʐ wɤ ˩  
hɤ˩hĩ˩˥	h ɤ ˩ h ĩ ˩˥  
hɯ˧dʑo˩	h ɯ ˧ dʑ o ˩  
hɯ˩dʑo˩	h ɯ ˩ dʑ o ˩  
jo˧	jo ˧  
jɤ˧ŋɤ˧	jɤ ˧ ŋ ɤ ˧  
ki˧kv̩˧˥	k i ˧ k v̩ ˧˥  
ki˧mɤ˧kv̩˧tsɯ˥	k i ˧ m ɤ ˧ k v̩ ˧ ts ɯ ˥  
ki˩˥	k i ˩˥  
kwɤ˧tɕɯ˥lɑ˩	k wɤ ˧ tɕ ɯ ˥ l ɑ ˩  
kʰv̩˧nɑ˥	kʰ v̩ ˧ n ɑ ˥  
kʰv̩˧tɕʰi˥	kʰ v̩ ˧ tɕʰ i ˥  
kʰv̩˧ʂe˧	kʰ v̩ ˧ ʂ e ˧  
kʰv̩˧ʈʂʰɯ˧	kʰ v̩ ˧ ʈʂʰ ɯ ˧  
kʰv̩˩	kʰ v̩ ˩  
kʰv̩˩mi˩	kʰ v̩ ˩ m i ˩  
kʰv̩˩mi˩lɑ˥	kʰ v̩ ˩ m i ˩ l ɑ ˥  
kʰɤ˧ʂɯ˧	kʰ ɤ ˧ ʂ ɯ ˧  
kʰɯ˧mɤ˥kv̩˩	kʰ ɯ ˧ m ɤ ˥ k v̩ ˩  
kʰɯ˧tsʰɤ˧˥	kʰ ɯ ˧ tsʰ ɤ ˧˥  
kʰɯ˩	kʰ ɯ ˩  
l	l  
le˧bi˩dʑo˩	l e ˧ b i ˩ dʑ o ˩  
le˧di˧˥	l e ˧ d i ˧˥  
le˧dʑo˧	l e ˧ dʑ o ˧  
le˧dʑo˩hĩ˩dʑo˩	l e ˧ dʑ o ˩ h ĩ ˩ dʑ o ˩  
le˧gɤ˧˥	l e ˧ g ɤ ˧˥  
le˧gɤ˩ze˩	l e ˧ g ɤ ˩ z e ˩  
le˧hæ̃˩hæ̃˩	l e ˧ h æ̃ ˩ h æ̃ ˩  
le˧hɤ˩	l e ˧ h ɤ ˩  
le˧hɯ˩	l e ˧ h ɯ ˩  
le˧kʰv̩˧˥	l e ˧ kʰ v̩ ˧˥  
le˧kʰɯ˧˥	l e ˧ kʰ ɯ ˧˥  
le˧lv̩˩	l e ˧ l v̩ ˩  
le˧lɑ˩lɑ˩	l e ˧ l ɑ ˩ l ɑ ˩  
le˧po˧bi˥	l e ˧ p o ˧ b i ˥  
le˧pʰo˧˥	l e ˧ pʰ o ˧˥  
le˧qʰv̩˩qʰv̩˩	l e ˧ qʰ v̩ ˩ qʰ v̩ ˩  
le˧qʰwɤ˧	l e ˧ qʰ wɤ ˧  
le˧qʰwɤ˧ze˧mæ˧	l e ˧ qʰ wɤ ˧ z e ˧ m æ ˧  
le˧se˩dʑo˩	l e ˧ s e ˩ dʑ o ˩  
le˧ti˩se˩dʑo˩	l e ˧ t i ˩ s e ˩ dʑ o ˩  
le˧tsɑ˧˥	l e ˧ ts ɑ ˧˥  
le˧tsʰo˧	l e ˧ tsʰ o ˧  
le˧tʰv̩˧dʑo˥	l e ˧ tʰ v̩ ˧ dʑ o ˥  
le˧wo˧tsʰɯ˧˥	l e ˧ w o ˧ tsʰ ɯ ˧˥  
le˧ɖɯ˩	l e ˧ ɖ ɯ ˩  
le˧ɬi˥	l e ˧ ɬ i ˥  
le˧ɻ̃˧zo˥	l e ˧ ɻ̃ ˧ z o ˥  
le˧ʂe˧le˧po˧tsʰɯ˧˥	l e ˧ ʂ e ˧ l e ˧ p o ˧ tsʰ ɯ ˧˥  
le˧ʂo˥	l e ˧ ʂ o ˥  
le˧ʂɯ˧kwɤ˧tɕɯ˥lɑ˩	l e ˧ ʂ ɯ ˧ k wɤ ˧ tɕ ɯ ˥ l ɑ ˩  
le˧ʂɯ˧ɲi˥ze˩	l e ˧ ʂ ɯ ˧ ɲ i ˥ z e ˩  
le˧ʈʂʰɻ̍˧˥	l e ˧ ʈʂʰ ɻ̍ ˧˥  
le˧ʐwæ˩ʐwæ˩	l e ˧ ʐ wæ ˩ ʐ wæ ˩  
lo˧pæ˧	l o ˧ p æ ˧  
lo˧qo˧	l o ˧ q o ˧  
lɑ˩kv̩˩tsɯ˩	l ɑ ˩ k v̩ ˩ ts ɯ ˩  
mo˧ʈʂʰɯ˧dʑo˩	m o ˧ ʈʂʰ ɯ ˧ dʑ o ˩  
mv̩˧mi˧	m v̩ ˧ m i ˧  
mv̩˧tsʰi˧qo˩	m v̩ ˧ tsʰ i ˧ q o ˩  
mv̩˧ɭɯ˩	m v̩ ˧ ɭ ɯ ˩  
mv̩˧ʁo˧ɻ̍˥	m v̩ ˧ ʁ o ˧ ɻ̍ ˥  
mv̩˩zo˩lɑ˥	m v̩ ˩ z o ˩ l ɑ ˥  
mv̩˩ɲi˩	m v̩ ˩ ɲ i ˩  
mɤ˧	m ɤ ˧  
mɤ˧dʑo˧ɲi˥	m ɤ ˧ dʑ o ˧ ɲ i ˥  
mɤ˧dʑɤ˩	m ɤ ˧ dʑ ɤ ˩  
mɤ˧gɤ˩ze˩	m ɤ ˧ g ɤ ˩ z e ˩  
mɤ˧ki˧	m ɤ ˧ k i ˧  
mɤ˧se˥	m ɤ ˧ s e ˥  
mɤ˧ɖo˧	m ɤ ˧ ɖ o ˧  
mɤ˧ɳv̩˧ɳv̩˧	m ɤ ˧ ɳ v̩ ˧ ɳ v̩ ˧  
mɤ˧ʂo˩	m ɤ ˧ ʂ o ˩  
mɤ˧ʝi˧	m ɤ ˧ ʝ i ˧  
mɤ˩	m ɤ ˩  
mɤ˩dʑo˩˥	m ɤ ˩ dʑ o ˩˥  
njæ˧sɯ˩kv̩˩ki˩	n jæ ˧ s ɯ ˩ k v̩ ˩ k i ˩  
njæ˧zɯ˩	n jæ ˧ z ɯ ˩  
njæ˧ɻ̍˩	n jæ ˧ ɻ̍ ˩  
njɤ˧bv̩˩	n jɤ ˧ b v̩ ˩  
njɤ˧ki˩	n jɤ ˧ k i ˩  
njɤ˧lɑ˥	n jɤ ˧ l ɑ ˥  
njɤ˩ɭɯ˧	n jɤ ˩ ɭ ɯ ˧  
no˧ki˧	n o ˧ k i ˧  
no˧ɻ̍˩dʑo˩	n o ˧ ɻ̍ ˩ dʑ o ˩  
næ˩qʰæ˥ʈʂʰe˩	n æ ˩ qʰ æ ˥ ʈʂʰ e ˩  
nɑ˩dʑi˧dʑo˩	n ɑ ˩ dʑ i ˧ dʑ o ˩  
õ˧ʈʂʰɯ˧	õ ˧ ʈʂʰ ɯ ˧  
pi˧ni˧˥	p i ˧ n i ˧˥  
pi˩ɲi˩mæ˩	p i ˩ ɲ i ˩ m æ ˩  
po˧hɯ˥	p o ˧ h ɯ ˥  
po˧po˧tsʰɤ˧˥	p o ˧ p o ˧ tsʰ ɤ ˧˥  
põ	p õ  
pv̩˩ɭɯ˥	p v̩ ˩ ɭ ɯ ˥  
pæ˩pʰæ˧˥	p æ ˩ pʰ æ ˧˥  
pʰo˩	pʰ o ˩  
qo˥	q o ˥  
qo˧	q o ˧  
qo˩qɑ˩˥	q o ˩ q ɑ ˩˥  
qwæ˩	q wæ ˩  
qwɤ˧ɭɯ˧ʁo˧	q wɤ ˧ ɭ ɯ ˧ ʁ o ˧  
qʰwɤ˧	qʰ wɤ ˧  
qʰæ˥tsʰɯ˩	qʰ æ ˥ tsʰ ɯ ˩  
qʰɑ˧dze˧	qʰ ɑ ˧ dz e ˧  
se˧lɑ˩	s e ˧ l ɑ ˩  
silisɑ̃lɑ̃	s i l i s ɑ̃ l ɑ̃  
si˧kʰɯ˧	s i ˧ kʰ ɯ ˧  
si˧tʰv̩˧	s i ˧ tʰ v̩ ˧  
si˧tʰv̩˧ki˧	s i ˧ tʰ v̩ ˧ k i ˧  
si˧ʁæ˧bæ˥	s i ˧ ʁ æ ˧ b æ ˥  
so	s o  
so˩hĩ˩	s o ˩ h ĩ ˩  
so˩kv̩˩	s o ˩ k v̩ ˩  
sɑ˧pʰv̩˧˥	s ɑ ˧ pʰ v̩ ˧˥  
sɯ˧pʰi˧ki˧	s ɯ ˧ pʰ i ˧ k i ˧  
sɯ˩	s ɯ ˩  
ti˥	t i ˥  
to˩mi˩	t o ˩ m i ˩  
tsɑ˩	ts ɑ ˩  
tsʰe˧do˧	tsʰ e ˧ d o ˧  
tsʰe˧ʝi˧	tsʰ e ˧ ʝ i ˧  
tsʰi˧ɲi˧dʑo˩	tsʰ i ˧ ɲ i ˧ dʑ o ˩  
tsʰo˧qʰwɤ˩	tsʰ o ˧ qʰ wɤ ˩  
tv̩˧	t v̩ ˧  
tv̩˧tsʰɯ˧	t v̩ ˧ tsʰ ɯ ˧  
tɕi˧dʑɯ˩	tɕ i ˧ dʑ ɯ ˩  
tɕɤ˧kv̩˥mæ˩	tɕ ɤ ˧ k v̩ ˥ m æ ˩  
tɕɯ˧	tɕ ɯ ˧  
tɕʰi˧le˥wo˩tsʰɯ˩	tɕʰ i ˧ l e ˥ w o ˩ tsʰ ɯ ˩  
tɕʰɤ˧ɲi˧ni˧˥	tɕʰ ɤ ˧ ɲ i ˧ n i ˧˥  
tʰ	tʰ  
tʰi	tʰ i  
tʰi˥tɕɯ˩	tʰ i ˥ tɕ ɯ ˩  
tʰi˧di˥tsɯ˩	tʰ i ˧ d i ˥ ts ɯ ˩  
tʰi˧dzi˩dʑo˩	tʰ i ˧ dz i ˩ dʑ o ˩  
tʰi˧dzi˩hĩ˩	tʰ i ˧ dz i ˩ h ĩ ˩  
tʰi˧hĩ˧˥	tʰ i ˧ h ĩ ˧˥  
tʰi˧hwɤ˩	tʰ i ˧ h wɤ ˩  
tʰi˧ki˧hĩ˧	tʰ i ˧ k i ˧ h ĩ ˧  
tʰi˧ki˩	tʰ i ˧ k i ˩  
tʰi˧kwɤ˩	tʰ i ˧ k wɤ ˩  
tʰi˧li˧	tʰ i ˧ l i ˧  
tʰi˧pæ˩	tʰ i ˧ p æ ˩  
tʰi˧qæ˧˥	tʰ i ˧ q æ ˧˥  
tʰi˧qʰæ˧ze˥	tʰ i ˧ qʰ æ ˧ z e ˥  
tʰi˧se˥	tʰ i ˧ s e ˥  
tʰi˧tɕʰo˩	tʰ i ˧ tɕʰ o ˩  
tʰi˧ʈʂv̩˩	tʰ i ˧ ʈʂ v̩ ˩  
tʰi˧ʈʂæ˧˥	tʰ i ˧ ʈʂ æ ˧˥  
tʰi˩di˥tsɯ˩	tʰ i ˩ d i ˥ ts ɯ ˩  
tʰi˩ki˩	tʰ i ˩ k i ˩  
tʰi˩tɕɤ˩	tʰ i ˩ tɕ ɤ ˩  
tʰo˩lo˧	tʰ o ˩ l o ˧  
tʰv̩˧ne˧ʝi˥	tʰ v̩ ˧ n e ˧ ʝ i ˥  
tʰv̩˧qo˧dʑo˧	tʰ v̩ ˧ q o ˧ dʑ o ˧  
tʰv̩˩v̩˩ki˥	tʰ v̩ ˩ v̩ ˩ k i ˥  
tʰv̩˩ɭɯ˩˥	tʰ v̩ ˩ ɭ ɯ ˩˥  
wo˩bv̩˥	w o ˩ b v̩ ˥  
wo˩ʈʂʰɯ˥dʑo˩	w o ˩ ʈʂʰ ɯ ˥ dʑ o ˩  
zo˧hṽ̩˥	z o ˧ h ṽ̩ ˥  
zo˧hṽ̩˧˥	z o ˧ h ṽ̩ ˧˥  
zo˧mv̩˥ki˩	z o ˧ m v̩ ˥ k i ˩  
zo˩no˧ni˩zo˩	z o ˩ n o ˧ n i ˩ z o ˩  
zɯ˧zɯ˧ʈʂʰɯ˧	z ɯ ˧ z ɯ ˧ ʈʂʰ ɯ ˧  
æ˧bv̩˧ʂe˧bv̩˥	æ ˧ b v̩ ˧ ʂ e ˧ b v̩ ˥  
æ˧ʂæ˧qʰwɤ˧ʈʂʰɯ˥dʑo˩	æ ˧ ʂ æ ˧ qʰ wɤ ˧ ʈʂʰ ɯ ˥ dʑ o ˩  
æ˧ʝi˩	æ ˧ ʝ i ˩  
ŋv̩˩	ŋ v̩ ˩  
ŋwɤ˧pʰæ˧˥	ŋ wɤ ˧ pʰ æ ˧˥  
ɑ˧ʁɑ˩dɑ˩pɤ˩	ɑ ˧ ʁ ɑ ˩ d ɑ ˩ p ɤ ˩  
ɕi˧ɭɯ˧	ɕ i ˧ ɭ ɯ ˧  
ɖ	ɖ  
ɖæ˩mi˧sɯ˩pʰi˩	ɖ æ ˩ m i ˧ s ɯ ˩ pʰ i ˩  
ɖæ˩mi˧sɯ˩pʰi˩ki˩	ɖ æ ˩ m i ˧ s ɯ ˩ pʰ i ˩ k i ˩  
ɖɯ˧kʰɤ˧	ɖ ɯ ˧ kʰ ɤ ˧  
ɖɯ˧mɤ˧kv̩˧tsɯ˥	ɖ ɯ ˧ m ɤ ˧ k v̩ ˧ ts ɯ ˥  
ɖɯ˧nɑ˧	ɖ ɯ ˧ n ɑ ˧  
ɖɯ˧pʰo˧	ɖ ɯ ˧ pʰ o ˧  
ɖɯ˧tsʰɤ˩ɖɯ˩tsʰɤ˩	ɖ ɯ ˧ tsʰ ɤ ˩ ɖ ɯ ˩ tsʰ ɤ ˩  
ɖɯ˧tɕo˥	ɖ ɯ ˧ tɕ o ˥  
ɖɯ˧tɕʰo˩	ɖ ɯ ˧ tɕʰ o ˩  
ɖɯ˧v̩˧ki˧ɳɯ˩	ɖ ɯ ˧ v̩ ˧ k i ˧ ɳ ɯ ˩  
ɖɯ˧æ˩	ɖ ɯ ˧ æ ˩  
ɖɯ˧ɭɯ˧hĩ˧	ɖ ɯ ˧ ɭ ɯ ˧ h ĩ ˧  
ɖɯ˧ʁwɤ˧	ɖ ɯ ˧ ʁ wɤ ˧  
ɖɯ˧ʈʂæ˧	ɖ ɯ ˧ ʈʂ æ ˧  
ɖɯ˧ʈʂʰɻ̍˧	ɖ ɯ ˧ ʈʂʰ ɻ̍ ˧  
ɖɯ˧ʈʰɤ˧	ɖ ɯ ˧ ʈʰ ɤ ˧  
ɖɯ˩	ɖ ɯ ˩  
ɖɯ˩hĩ˩	ɖ ɯ ˩ h ĩ ˩  
ɖɯ˩lo˧	ɖ ɯ ˩ l o ˧  
ɖʐo˧	ɖʐ o ˧  
ɖʐv̩˧nɑ˥mi˩	ɖʐ v̩ ˧ n ɑ ˥ m i ˩  
ɖʐv̩˧nɑ˥mi˩ʈʂʰɯ˩dʑo˩	ɖʐ v̩ ˧ n ɑ ˥ m i ˩ ʈʂʰ ɯ ˩ dʑ o ˩  
ə˧dɑ˧ki˧	ə ˧ d ɑ ˧ k i ˧  
ə˧mi˧ki˧	ə ˧ m i ˧ k i ˧  
ə˧mi˧pv̩˩ʈʰɯ˩	ə ˧ m i ˧ p v̩ ˩ ʈʰ ɯ ˩  
ə˧mv̩˧go˧mi˥	ə ˧ m v̩ ˧ g o ˧ m i ˥  
ə˧mɑ˧bv̩˧	ə ˧ m ɑ ˧ b v̩ ˧  
ə˧mɑ˧ɳɯ˧	ə ˧ m ɑ ˧ ɳ ɯ ˧  
ə˧tse˥	ə ˧ ts e ˥  
ə˧v̩˧hĩ˥	ə ˧ v̩ ˧ h ĩ ˥  
ə˧v̩˧lɑ˥	ə ˧ v̩ ˧ l ɑ ˥  
ə˧ɖo˧	ə ˧ ɖ o ˧  
ə˧ʑi˧	ə ˧ ʑ i ˧  
ə˧ʑi˧ki˥	ə ˧ ʑ i ˧ k i ˥  
ə˧ʑi˧mo˥	ə ˧ ʑ i ˧ m o ˥  
ə˩ljɤ˩hæ̃˩ʂɯ˥mo˩	ə ˩ l jɤ ˩ h æ̃ ˩ ʂ ɯ ˥ m o ˩  
ɬi˩bi˩	ɬ i ˩ b i ˩  
ɲi˥mæ˩	ɲ i ˥ m æ ˩  
ɲi˧bæ˧	ɲ i ˧ b æ ˧  
ɲi˧mi˧	ɲ i ˧ m i ˧  
ɲi˩pi˩	ɲ i ˩ p i ˩  
ɲi˩pi˩kv̩˩tsɯ˩	ɲ i ˩ p i ˩ k v̩ ˩ ts ɯ ˩  
ɲi˩ze˩mæ˩	ɲ i ˩ z e ˩ m æ ˩  
ɳæ˧ɻ̍˩se˩	ɳ æ ˧ ɻ̍ ˩ s e ˩  
ɻæ˩˥	ɻ æ ˩˥  
ʁwɑ	ʁ wɑ  
ʁɑ˧ʂe˥	ʁ ɑ ˧ ʂ e ˥  
ʁɑ˧ʂe˩	ʁ ɑ ˧ ʂ e ˩  
ʂe˧bæ˧	ʂ e ˧ b æ ˧  
ʂe˩	ʂ e ˩  
ʂwæ˩gv̩˩˥	ʂ wæ ˩ g v̩ ˩˥  
ʂæ˧hĩ˧	ʂ æ ˧ h ĩ ˧  
ʂɯ˧dʑo˩	ʂ ɯ ˧ dʑ o ˩  
ʂɯ˧hĩ˥	ʂ ɯ ˧ h ĩ ˥  
ʈæ˧bɤ˧ʈʂʰɯ˧	ʈ æ ˧ b ɤ ˧ ʈʂʰ ɯ ˧  
ʈɤ˧	ʈ ɤ ˧  
ʈʂe˧qo˩ɳɯ˩	ʈʂ e ˧ q o ˩ ɳ ɯ ˩  
ʈʂɤ˧ɲi˥ze˩mæ˩	ʈʂ ɤ ˧ ɲ i ˥ z e ˩ m æ ˩  
ʈʂʰv̩˩	ʈʂʰ v̩ ˩  
ʈʂʰwɤ˩	ʈʂʰ wɤ ˩  
ʈʂʰæ˩ʈʂʰæ˩˥	ʈʂʰ æ ˩ ʈʂʰ æ ˩˥  
ʈʂʰɯ˧gi˧	ʈʂʰ ɯ ˧ g i ˧  
ʈʂʰɯ˧kʰwɤ˧	ʈʂʰ ɯ ˧ kʰ wɤ ˧  
ʈʂʰɯ˧qo˧dʑo˧	ʈʂʰ ɯ ˧ q o ˧ dʑ o ˧  
ʈʂʰɯ˧tɕi˩ɳɯ˩	ʈʂʰ ɯ ˧ tɕ i ˩ ɳ ɯ ˩  
ʈʂʰɯ˧v̩˧	ʈʂʰ ɯ ˧ v̩ ˧  
ʈʂʰɯ˧ɖɯ˧ɖɯ˧hĩ˧	ʈʂʰ ɯ ˧ ɖ ɯ ˧ ɖ ɯ ˧ h ĩ ˧  
ʈʂʰɯ˧ɲi˧	ʈʂʰ ɯ ˧ ɲ i ˧  
ʈʂʰɯ˧ʂwæ˧gv̩˧kv̩˩	ʈʂʰ ɯ ˧ ʂ wæ ˧ g v̩ ˧ k v̩ ˩  
ʈʂʰɯ˧ʈʂæ˩qo˩	ʈʂʰ ɯ ˧ ʈʂ æ ˩ q o ˩  
ʈʂʰɯ˧ʑi˧ɻ̍˧	ʈʂʰ ɯ ˧ ʑ i ˧ ɻ̍ ˧  
ʈʰæ˧mi˧ɳɯ˩	ʈʰ æ ˧ m i ˧ ɳ ɯ ˩  
ʈʰɯ˧	ʈʰ ɯ ˧  
ʐe˧ʈæ˥ɬi˩	ʐ e ˧ ʈ æ ˥ ɬ i ˩  
ʐwæ˩ze˥	ʐ wæ ˩ z e ˥  
ʑi˧qʰwɤ˧ʈʂʰɯ˧	ʑ i ˧ qʰ wɤ ˧ ʈʂʰ ɯ ˧  
ʝi˥bi˩	ʝ i ˥ b i ˩  
ʝi˥kv̩˩mæ˩	ʝ i ˥ k v̩ ˩ m æ ˩  
ʝi˥zo˩	ʝ i ˥ z o ˩  
ʝi˧mɤ˧ɖo˧	ʝ i ˧ m ɤ ˧ ɖ o ˧  
ʝi˧qv̩˥	ʝ i ˧ q v̩ ˥  
b	b  
bi˥	b i ˥  
bi˧ho˥	b i ˧ h o ˥  
bi˧kv̩˧ze˥	b i ˧ k v̩ ˧ z e ˥  
bi˧kv̩˧ze˥mæ˩	b i ˧ k v̩ ˧ z e ˥ m æ ˩  
bi˧tsæ˧ɲi˩	b i ˧ ts æ ˧ ɲ i ˩  
bo˩ʈʂʰæ˥	b o ˩ ʈʂʰ æ ˥  
bõ	b õ  
bv̩˧nv̩˧zo˩	b v̩ ˧ n v̩ ˧ z o ˩  
bv̩˩	b v̩ ˩  
bv̩˩hwɤ˩pi˥zo˩	b v̩ ˩ h wɤ ˩ p i ˥ z o ˩  
bv̩˩hwɤ˩˥	b v̩ ˩ h wɤ ˩˥  
bɑ˩˥	b ɑ ˩˥  
d	d  
di˧qo˧gɤ˧	d i ˧ q o ˧ g ɤ ˧  
di˧qo˧ʈʂʰɯ˧dʑo˩	d i ˧ q o ˧ ʈʂʰ ɯ ˧ dʑ o ˩  
di˩kv̩˩mæ˩	d i ˩ k v̩ ˩ m æ ˩  
di˩ɲi˩mæ˩	d i ˩ ɲ i ˩ m æ ˩  
do˧mɤ˧dʑɯ˧	d o ˧ m ɤ ˧ dʑ ɯ ˧  
do˩mɤ˩ho˥	d o ˩ m ɤ ˩ h o ˥  
do˩˥	d o ˩˥  
dv̩˥mɤ˩kv̩˩	d v̩ ˥ m ɤ ˩ k v̩ ˩  
dv̩˩mɤ˧kv̩˧˥	d v̩ ˩ m ɤ ˧ k v̩ ˧˥  
dv̩˩˥	d v̩ ˩˥  
dze˧dv̩˩pɤ˩jɤ˩	dz e ˧ d v̩ ˩ p ɤ ˩ jɤ ˩  
dzi˧dzi˩	dz i ˧ dz i ˩  
dzɑ˧	dz ɑ ˧  
dzɑ˩qʰwɤ˩ʈʂʰɯ˥	dz ɑ ˩ qʰ wɤ ˩ ʈʂʰ ɯ ˥  
dzɯ˧ho˥ze˩	dz ɯ ˧ h o ˥ z e ˩  
dzɯ˧kv̩˩mæ˩	dz ɯ ˧ k v̩ ˩ m æ ˩  
dzɯ˩ho˥kwɤ˩tɕɯ˩lɑ˩	dz ɯ ˩ h o ˥ k wɤ ˩ tɕ ɯ ˩ l ɑ ˩  
dzɯ˩nɑ˩mi˩ʁo˥	dz ɯ ˩ n ɑ ˩ m i ˩ ʁ o ˥  
dzɯ˩˥	dz ɯ ˩˥  
dɑ˥kv̩˩tsɯ˩	d ɑ ˥ k v̩ ˩ ts ɯ ˩  
dɑ˧kv̩˥ze˩	d ɑ ˧ k v̩ ˥ z e ˩  
dɑ˧pɤ˧ʈʂʰɯ˧	d ɑ ˧ p ɤ ˧ ʈʂʰ ɯ ˧  
dɑ˧pɤ˧ʈʂʰɯ˧dʑo˩	d ɑ ˧ p ɤ ˧ ʈʂʰ ɯ ˧ dʑ o ˩  
dɑ˧ʝi˩	d ɑ ˧ ʝ i ˩  
dʑi˧hṽ˥	dʑ i ˧ h ṽ ˥  
dʑi˧hṽ̩˥	dʑ i ˧ h ṽ̩ ˥  
dʑi˧hṽ̩˧	dʑ i ˧ h ṽ̩ ˧  
dʑo˧hĩ˧	dʑ o ˧ h ĩ ˧  
dʑo˧kv̩˥	dʑ o ˧ k v̩ ˥  
dʑo˧ɲi˥ze˩mæ˩	dʑ o ˧ ɲ i ˥ z e ˩ m æ ˩  
dʑo˩dʑo˩	dʑ o ˩ dʑ o ˩  
dʑo˩hĩ˩	dʑ o ˩ h ĩ ˩  
dʑo˩kv̩˩tsɯ˩	dʑ o ˩ k v̩ ˩ ts ɯ ˩  
dʑo˩kv̩˩˥	dʑ o ˩ k v̩ ˩˥  
dʑo˩mɤ˩kv̩˥	dʑ o ˩ m ɤ ˩ k v̩ ˥  
dʑo˩ni˩gv̩˩	dʑ o ˩ n i ˩ g v̩ ˩  
dʑo˩ɲi˥	dʑ o ˩ ɲ i ˥  
dʑo˩ɲi˩	dʑ o ˩ ɲ i ˩  
dʑo˩ɲi˩ze˩	dʑ o ˩ ɲ i ˩ z e ˩  
dʑɖʐɤ˧	dʑ ɖʐ ɤ ˧  
dʑɤ˩hĩ˧	dʑ ɤ ˩ h ĩ ˧  
dʑɤ˩kv̩˧˥	dʑ ɤ ˩ k v̩ ˧˥  
dʑɤ˩kʰwɤ˧	dʑ ɤ ˩ kʰ wɤ ˧  
dʑɤ˩tsʰo˧	dʑ ɤ ˩ tsʰ o ˧  
dʑɤ˩tsʰo˧hĩ˧	dʑ ɤ ˩ tsʰ o ˧ h ĩ ˧  
dʑɤ˩ɲi˥	dʑ ɤ ˩ ɲ i ˥  
dʑɯ˧ki˥	dʑ ɯ ˧ k i ˥  
dʑɯ˧qo˧ɳɯ˧	dʑ ɯ ˧ q o ˧ ɳ ɯ ˧  
fv̩˧	f v̩ ˧  
fv̩˩bi˩˥	f v̩ ˩ b i ˩˥  
fæ˧tɕʰje˩	f æ ˧ tɕʰ j e ˩  
gi˧˥	g i ˧˥  
gi˩ɳɯ˥	g i ˩ ɳ ɯ ˥  
go˧mi˧dʑo˥	g o ˧ m i ˧ dʑ o ˥  
go˧mi˧ki˧	g o ˧ m i ˧ k i ˧  
gv	g v  
gv̩˥ɲi˩tsɯ˩	g v̩ ˥ ɲ i ˩ ts ɯ ˩  
gv̩˧ze˧gɤ˧	g v̩ ˧ z e ˧ g ɤ ˧  
gv̩˩kv̩˩	g v̩ ˩ k v̩ ˩  
gv̩˩kv̩˩ze˥	g v̩ ˩ k v̩ ˩ z e ˥  
gv̩˩ze˥	g v̩ ˩ z e ˥  
gv̩˩ɬi˩mi˩qo˥	g v̩ ˩ ɬ i ˩ m i ˩ q o ˥  
gwɤ˩kv̩˩˥	g wɤ ˩ k v̩ ˩˥  
gwɤ˩ɲi˥mæ˩	g wɤ ˩ ɲ i ˥ m æ ˩  
gæ˧ɻæ˩hĩ˩	g æ ˧ ɻ æ ˩ h ĩ ˩  
gɤ˥ti˩	g ɤ ˥ t i ˩  
gɤ˧lɑ˧	g ɤ ˧ l ɑ ˧  
gɤ˧˥	g ɤ ˧˥  
gɤ˩	g ɤ ˩  
gɤ˩dɑ˧˥	g ɤ ˩ d ɑ ˧˥  
gɤ˩qwɤ˥	g ɤ ˩ q wɤ ˥  
gɤ˩ʈi˥	g ɤ ˩ ʈ i ˥  
gɤ˩ʑi˥tsɯ˩	g ɤ ˩ ʑ i ˥ ts ɯ ˩  
gɤ˩ʑi˥ɲi˩	g ɤ ˩ ʑ i ˥ ɲ i ˩  
gɤ˩˥	g ɤ ˩˥  
gɯ˧mɤ˧gɯ˩	g ɯ ˧ m ɤ ˧ g ɯ ˩  
hĩ˧bæ˧dʑo˩	h ĩ ˧ b æ ˧ dʑ o ˩  
hĩ˧di˧qo˥	h ĩ ˧ d i ˧ q o ˥  
hĩ˧ɻæ˥dʑo˩	h ĩ ˧ ɻ æ ˥ dʑ o ˩  
hĩ˧ɻæ˧	h ĩ ˧ ɻ æ ˧  
hĩ˧ɻæ˧ni˧˥	h ĩ ˧ ɻ æ ˧ n i ˧˥  
ho	h o  
ho˩lo˧pv̩˥	h o ˩ l o ˧ p v̩ ˥  
hõ˧ɬi˧mi˧	h õ ˧ ɬ i ˧ m i ˧  
hõ˩tsʰi˧lɑ˥	h õ ˩ tsʰ i ˧ l ɑ ˥  
hu˧mi˧ʈʂʰæ˧ɣɯ˧	h u ˧ m i ˧ ʈʂʰ æ ˧ ɣ ɯ ˧  
hṽ˩ɖʐæ˩ɻæ˥	h ṽ ˩ ɖʐ æ ˩ ɻ æ ˥  
hwæ˧ze˧	h wæ ˧ z e ˧  
hwɤ˧	h wɤ ˧  
hæ˧	h æ ˧  
hæ˧bv̩˧	h æ ˧ b v̩ ˧  
hæ˧di˩	h æ ˧ d i ˩  
hæ˧ʐwɤ˩pi˩	h æ ˧ ʐ wɤ ˩ p i ˩  
hæ̃˥	h æ̃ ˥  
hæ̃˧pɤ˧	h æ̃ ˧ p ɤ ˧  
hæ̃˧qʰv̩˥	h æ̃ ˧ qʰ v̩ ˥  
hæ̃˩	h æ̃ ˩  
hɑ	h ɑ  
hɑ˧dʑo˩	h ɑ ˧ dʑ o ˩  
hɑ˧mi˥hĩ˩	h ɑ ˧ m i ˥ h ĩ ˩  
hɑ̃˩kv̩˩ze˩mæ˩	h ɑ̃ ˩ k v̩ ˩ z e ˩ m æ ˩  
hɤ˩	h ɤ ˩  
hɤ˩hĩ˥	h ɤ ˩ h ĩ ˥  
hɯ˧dʑo˥	h ɯ ˧ dʑ o ˥  
hɯ˧tsɯ˧˥	h ɯ ˧ ts ɯ ˧˥  
hɯ˧˥	h ɯ ˧˥  
hɯ˩hĩ˥	h ɯ ˩ h ĩ ˥  
hɯ˩hĩ˩˥	h ɯ ˩ h ĩ ˩˥  
jo˧lv̩˧	jo ˧ l v̩ ˧  
k	k  
ki˥hĩ˩	k i ˥ h ĩ ˩  
ki˧	k i ˧  
ki˧kv̩˧ze˥mæ˩	k i ˧ k v̩ ˧ z e ˥ m æ ˩  
ki˧ɲi˥	k i ˧ ɲ i ˥  
ki˧ɻ̍˩	k i ˧ ɻ̍ ˩  
ki˩bi˩pi˩	k i ˩ b i ˩ p i ˩  
ki˩dʑo˩	k i ˩ dʑ o ˩  
ki˩hĩ˥	k i ˩ h ĩ ˥  
ki˩kv̩˩ze˩	k i ˩ k v̩ ˩ z e ˩  
ki˩kʰɯ˩˥	k i ˩ kʰ ɯ ˩˥  
ki˩ɲi˩pi˩	k i ˩ ɲ i ˩ p i ˩  
ko˧	k o ˧  
kõtõ	k õ t õ  
kv̩˧dʑɯ˧ʈʰæ˧qo˥	k v̩ ˧ dʑ ɯ ˧ ʈʰ æ ˧ q o ˥  
kv̩˧ɳɯ˩	k v̩ ˧ ɳ ɯ ˩  
kv̩˩	k v̩ ˩  
kɤ	k ɤ  
kɤ˧wɤ˧ljɤ˧ɳɯ˥	k ɤ ˧ wɤ ˧ l jɤ ˧ ɳ ɯ ˥  
kɤ˧ʈʂo˧	k ɤ ˧ ʈʂ o ˧  
kɤ˩tjɤ˧ljɤ˧	k ɤ ˩ t jɤ ˧ l jɤ ˧  
kʰi˧zo˧	kʰ i ˧ z o ˧  
kʰv̩˧mæ˧	kʰ v̩ ˧ m æ ˧  
kʰv̩˧mæ˧ɳɯ˧	kʰ v̩ ˧ m æ ˧ ɳ ɯ ˧  
kʰv̩˧ʂɯ˥dʑo˩	kʰ v̩ ˧ ʂ ɯ ˥ dʑ o ˩  
kʰv̩˩mi˩ki˥dʑo˩	kʰ v̩ ˩ m i ˩ k i ˥ dʑ o ˩  
kʰv̩˩mi˩ki˥sɯ˩	kʰ v̩ ˩ m i ˩ k i ˥ s ɯ ˩  
kʰwɤ˧pʰv̩˧mo˧	kʰ wɤ ˧ pʰ v̩ ˧ m o ˧  
kʰɤ˧˥	kʰ ɤ ˧˥  
kʰɯ˧	kʰ ɯ ˧  
le˥wo˩tsʰɯ˩	l e ˥ w o ˩ tsʰ ɯ ˩  
le˥wo˩tsʰɯ˩pi˩kv̩˩	l e ˥ w o ˩ tsʰ ɯ ˩ p i ˩ k v̩ ˩  
le˧bi˩ze˩	l e ˧ b i ˩ z e ˩  
le˧do˩kwɤ˩tɕɯ˩lɑ˩	l e ˧ d o ˩ k wɤ ˩ tɕ ɯ ˩ l ɑ ˩  
le˧dv̩˩dʑo˩	l e ˧ d v̩ ˩ dʑ o ˩  
le˧dzɯ˧se˥dʑo˩	l e ˧ dz ɯ ˧ s e ˥ dʑ o ˩  
le˧gv̩˥	l e ˧ g v̩ ˥  
le˧gv̩˧gv̩˥	l e ˧ g v̩ ˧ g v̩ ˥  
le˧gv̩˩hĩ˩	l e ˧ g v̩ ˩ h ĩ ˩  
le˧hõ˩	l e ˧ h õ ˩  
le˧hwɤ˩	l e ˧ h wɤ ˩  
le˧hɯ˩hĩ˩	l e ˧ h ɯ ˩ h ĩ ˩  
le˧hɯ˩ɲi˩tsɯ˩	l e ˧ h ɯ ˩ ɲ i ˩ ts ɯ ˩  
le˧jo˩	l e ˧ jo ˩  
le˧jo˩dʑo˩	l e ˧ jo ˩ dʑ o ˩  
le˧ki˩	l e ˧ k i ˩  
le˧kv̩˧˥	l e ˧ k v̩ ˧˥  
le˧kʰɯ˩kʰɯ˩	l e ˧ kʰ ɯ ˩ kʰ ɯ ˩  
le˧po˧jo˥kv̩˩	l e ˧ p o ˧ jo ˥ k v̩ ˩  
le˧po˧tsʰɯ˧hĩ˧	l e ˧ p o ˧ tsʰ ɯ ˧ h ĩ ˧  
le˧po˧tsʰɯ˧ɲi˥tsɯ˩	l e ˧ p o ˧ tsʰ ɯ ˧ ɲ i ˥ ts ɯ ˩  
le˧pv̩˧dʑo˥	l e ˧ p v̩ ˧ dʑ o ˥  
le˧pv̩˧kʰɯ˧˥	l e ˧ p v̩ ˧ kʰ ɯ ˧˥  
le˧pʰi˧	l e ˧ pʰ i ˧  
le˧pʰo˩	l e ˧ pʰ o ˩  
le˧qæ˧se˥	l e ˧ q æ ˧ s e ˥  
le˧qæ˧se˥dʑo˩	l e ˧ q æ ˧ s e ˥ dʑ o ˩  
le˧qʰwɤ˧tsɯ˥	l e ˧ qʰ wɤ ˧ ts ɯ ˥  
le˧sɯ˥	l e ˧ s ɯ ˥  
le˧sɯ˥kwɤ˩tɕɯ˩lɑ˩	l e ˧ s ɯ ˥ k wɤ ˩ tɕ ɯ ˩ l ɑ ˩  
le˧tsɑ˩tsɑ˩	l e ˧ ts ɑ ˩ ts ɑ ˩  
le˧tsʰɯ˩hĩ˩	l e ˧ tsʰ ɯ ˩ h ĩ ˩  
le˧tsʰɯ˩pi˩	l e ˧ tsʰ ɯ ˩ p i ˩  
le˧tsʰɯ˩ɲi˩tsɯ˩	l e ˧ tsʰ ɯ ˩ ɲ i ˩ ts ɯ ˩  
le˧tɑ˧˥	l e ˧ t ɑ ˧˥  
le˧tɕɤ˧se˥dʑo˩	l e ˧ tɕ ɤ ˧ s e ˥ dʑ o ˩  
le˧tɕɯ˩tɕɯ˩	l e ˧ tɕ ɯ ˩ tɕ ɯ ˩  
le˧tɕʰi˧dʑo˥	l e ˧ tɕʰ i ˧ dʑ o ˥  
le˧tɕʰo˥tɕʰo˩	l e ˧ tɕʰ o ˥ tɕʰ o ˩  
le˧tɕʰo˥tɕʰo˩lɑ˩	l e ˧ tɕʰ o ˥ tɕʰ o ˩ l ɑ ˩  
le˧tɕʰɯ˧ɲi˥ze˩mæ˩	l e ˧ tɕʰ ɯ ˧ ɲ i ˥ z e ˩ m æ ˩  
le˧wo˧	l e ˧ w o ˧  
le˧wo˧tsʰɯ˧ze˥	l e ˧ w o ˧ tsʰ ɯ ˧ z e ˥  
le˧wo˧tʰo˥tɕo˩	l e ˧ w o ˧ tʰ o ˥ tɕ o ˩  
le˧ɖwæ˩	l e ˧ ɖ wæ ˩  
le˧ɖʐo˥kwɤ˩tɕɯ˩lɑ˩	l e ˧ ɖʐ o ˥ k wɤ ˩ tɕ ɯ ˩ l ɑ ˩  
le˧ɖʐo˩	l e ˧ ɖʐ o ˩  
le˧ɖʐɤ˩ɖʐɤ˩	l e ˧ ɖʐ ɤ ˩ ɖʐ ɤ ˩  
le˧ɬi˧˥	l e ˧ ɬ i ˧˥  
le˧ɳæ˧˥	l e ˧ ɳ æ ˧˥  
le˧ʁɑ˥ʂe˩dʑo˩	l e ˧ ʁ ɑ ˥ ʂ e ˩ dʑ o ˩  
le˧ʁɑ˧ʂe˩	l e ˧ ʁ ɑ ˧ ʂ e ˩  
le˧ʂo˧ʂo˧	l e ˧ ʂ o ˧ ʂ o ˧  
le˧ʂv̩˧	l e ˧ ʂ v̩ ˧  
le˧ʂɯ˧dʑo˩	l e ˧ ʂ ɯ ˧ dʑ o ˩  
le˧ʂɯ˧hĩ˧dʑo˩	l e ˧ ʂ ɯ ˧ h ĩ ˧ dʑ o ˩  
le˧ʂɯ˧hĩ˧ki˧dʑo˩	l e ˧ ʂ ɯ ˧ h ĩ ˧ k i ˧ dʑ o ˩  
le˧ʂɯ˧ho˩ɲi˩ze˩	l e ˧ ʂ ɯ ˧ h o ˩ ɲ i ˩ z e ˩  
le˧ʈʂæ˧po˥hɯ˩ɲi˩	l e ˧ ʈʂ æ ˧ p o ˥ h ɯ ˩ ɲ i ˩  
le˧ʈʂʰo˧dʑo˥	l e ˧ ʈʂʰ o ˧ dʑ o ˥  
le˧ʈʂʰæ˧bi˧	l e ˧ ʈʂʰ æ ˧ b i ˧  
le˧ʐv̩˩	l e ˧ ʐ v̩ ˩  
le˧ʐwɤ˩	l e ˧ ʐ wɤ ˩  
le˧ʑi˧ŋv̩˥	l e ˧ ʑ i ˧ ŋ v̩ ˥  
le˧ʝi˥ze˩	l e ˧ ʝ i ˥ z e ˩  
le˩hɯ˩	l e ˩ h ɯ ˩  
le˩jo˩	l e ˩ jo ˩  
le˩tʰi˩	l e ˩ tʰ i ˩  
li˧kʰɯ˧bi˥	l i ˧ kʰ ɯ ˧ b i ˥  
li˩sɯ˩mo˩qo˥	l i ˩ s ɯ ˩ m o ˩ q o ˥  
lo˧ʂv̩˩	l o ˧ ʂ v̩ ˩  
lo˧ʝi˧di˧˥	l o ˧ ʝ i ˧ d i ˧˥  
lv̩˧qo˧	l v̩ ˧ q o ˧  
lv̩˩	l v̩ ˩  
lwæ˧˥	l wæ ˧˥  
lwɤ˩	l wɤ ˩  
lɑ˧tʰɑ˧mi˥	l ɑ ˧ tʰ ɑ ˧ m i ˥  
lɑ˧tʰɑ˧mi˧ɻ̍˥	l ɑ ˧ tʰ ɑ ˧ m i ˧ ɻ̍ ˥  
lɑ˩jɤ˧ɬi˧	l ɑ ˩ jɤ ˧ ɬ i ˧  
lɑ˩lɑ˧˥	l ɑ ˩ l ɑ ˧˥  
mi˩pi˧	m i ˩ p i ˧  
mi˩zɯ˩ɻæ˥	m i ˩ z ɯ ˩ ɻ æ ˥  
mi˩zɯ˩ʈʂʰɯ˥dʑo˩	m i ˩ z ɯ ˩ ʈʂʰ ɯ ˥ dʑ o ˩  
mo˧kɤ˩ʈʰæ˩qo˩	m o ˧ k ɤ ˩ ʈʰ æ ˩ q o ˩  
mo˩kv̩˥	m o ˩ k v̩ ˥  
mo˩kv̩˧	m o ˩ k v̩ ˧  
mv̩˥do˩	m v̩ ˥ d o ˩  
mv̩˥ʈʂæ˩hĩ˩	m v̩ ˥ ʈʂ æ ˩ h ĩ ˩  
mv̩˧dze˧qwæ˩ʈʂwæ˩hɑ˩	m v̩ ˧ dz e ˧ q wæ ˩ ʈʂ wæ ˩ h ɑ ˩  
mv̩˧qo˩	m v̩ ˧ q o ˩  
mv̩˧tsʰi˧	m v̩ ˧ tsʰ i ˧  
mv̩˧ʁo˥dʑo˩	m v̩ ˧ ʁ o ˥ dʑ o ˩  
mv̩˧ʈʂv̩˩qo˩ɳɯ˩	m v̩ ˧ ʈʂ v̩ ˩ q o ˩ ɳ ɯ ˩  
mv̩˧ʐe˧qo˥	m v̩ ˧ ʐ e ˧ q o ˥  
mv̩˩di˩qo˥ʈʂʰɯ˩	m v̩ ˩ d i ˩ q o ˥ ʈʂʰ ɯ ˩  
mv̩˩dɑ˧˥	m v̩ ˩ d ɑ ˧˥  
mv̩˩lɑ˥	m v̩ ˩ l ɑ ˥  
mv̩˩mɤ˩tʰɑ˥tsɯ˩	m v̩ ˩ m ɤ ˩ tʰ ɑ ˥ ts ɯ ˩  
mv̩˩tɕi˥	m v̩ ˩ tɕ i ˥  
mv̩˩zo˩ɳɯ˥	m v̩ ˩ z o ˩ ɳ ɯ ˥  
mv̩˩zɯ˩lɑ˥	m v̩ ˩ z ɯ ˩ l ɑ ˥  
mv̩˩ɬi˥	m v̩ ˩ ɬ i ˥  
mv̩˩ɲi˥	m v̩ ˩ ɲ i ˥  
mɤ˥kv̩˩	m ɤ ˥ k v̩ ˩  
mɤ˧bi˧ze˧	m ɤ ˧ b i ˧ z e ˧  
mɤ˧dɑ˩mi˩	m ɤ ˧ d ɑ ˩ m i ˩  
mɤ˧dʑo˧dʑo˥	m ɤ ˧ dʑ o ˧ dʑ o ˥  
mɤ˧dʑo˧hĩ˧ki˧	m ɤ ˧ dʑ o ˧ h ĩ ˧ k i ˧  
mɤ˧dʑo˧zo˩	m ɤ ˧ dʑ o ˧ z o ˩  
mɤ˧dʑo˧ɲi˥tsɯ˩	m ɤ ˧ dʑ o ˧ ɲ i ˥ ts ɯ ˩  
mɤ˧dʑɤ˩hĩ˩	m ɤ ˧ dʑ ɤ ˩ h ĩ ˩  
mɤ˧fv̩˧	m ɤ ˧ f v̩ ˧  
mɤ˧fv̩˧di˩	m ɤ ˧ f v̩ ˧ d i ˩  
mɤ˧gɯ˩	m ɤ ˧ g ɯ ˩  
mɤ˧qʰwɤ˧	m ɤ ˧ qʰ wɤ ˧  
mɤ˧sɯ˥mæ˩	m ɤ ˧ s ɯ ˥ m æ ˩  
mɤ˧sɯ˥ze˩	m ɤ ˧ s ɯ ˥ z e ˩  
mɤ˧tsʰɯ˩bi˩	m ɤ ˧ tsʰ ɯ ˩ b i ˩  
mɤ˧tɕʰɯ˧˥	m ɤ ˧ tɕʰ ɯ ˧˥  
mɤ˧tʰɑ˧	m ɤ ˧ tʰ ɑ ˧  
mɤ˧v̩˧zo˥	m ɤ ˧ v̩ ˧ z o ˥  
mɤ˧wɤ˩hĩ˩	m ɤ ˧ wɤ ˩ h ĩ ˩  
mɤ˧zo˧	m ɤ ˧ z o ˧  
mɤ˧ɖwæ˩	m ɤ ˧ ɖ wæ ˩  
mɤ˧ɖwæ˩ze˩	m ɤ ˧ ɖ wæ ˩ z e ˩  
mɤ˧ɖɯ˧	m ɤ ˧ ɖ ɯ ˧  
mɤ˧ɲi˧ze˧	m ɤ ˧ ɲ i ˧ z e ˧  
mɤ˧ʂv̩˧ɖv̩˧lɑ˧	m ɤ ˧ ʂ v̩ ˧ ɖ v̩ ˧ l ɑ ˧  
mɤ˧ʈʂɤ˧	m ɤ ˧ ʈʂ ɤ ˧  
mɤ˧ʐɯ˧	m ɤ ˧ ʐ ɯ ˧  
mɤ˧ʝi˧ze˧	m ɤ ˧ ʝ i ˧ z e ˧  
mɤ˩di˩	m ɤ ˩ d i ˩  
mɤ˩dʑo˩	m ɤ ˩ dʑ o ˩  
mɤ˩kv̩˩	m ɤ ˩ k v̩ ˩  
mɤ˩ɖo˩	m ɤ ˩ ɖ o ˩  
mɤ˩ɖɯ˩hĩ˥	m ɤ ˩ ɖ ɯ ˩ h ĩ ˥  
ne˧	n e ˧  
ne˧ʝi˥	n e ˧ ʝ i ˥  
njɤ˧zo˧	n jɤ ˧ z o ˧  
njɤ˧ɻ˩	n jɤ ˧ ɻ ˩  
njɤ˩	n jɤ ˩  
njɤ˩ɭɯ˧ʈʂʰɯ˧	n jɤ ˩ ɭ ɯ ˧ ʈʂʰ ɯ ˧  
no˧bv̩˩	n o ˧ b v̩ ˩  
no˧ɳɯ˧dʑo˥	n o ˧ ɳ ɯ ˧ dʑ o ˥  
nv̩˧hṽ˩	n v̩ ˧ h ṽ ˩  
nv̩˩mi˩˥	n v̩ ˩ m i ˩˥  
nɑ˧nɑ˥	n ɑ ˧ n ɑ ˥  
nɑ˩	n ɑ ˩  
nɑ˩bv̩˥	n ɑ ˩ b v̩ ˥  
nɑ˩bv̩˧	n ɑ ˩ b v̩ ˧  
nɑ˩hɑ˧dʑo˩	n ɑ ˩ h ɑ ˧ dʑ o ˩  
nɑ˩ʐwɤ˥	n ɑ ˩ ʐ wɤ ˥  
nɑ˩ʐwɤ˥dʑo˩	n ɑ ˩ ʐ wɤ ˥ dʑ o ˩  
ooo	o o o  
õõõ	õ õ õ  
õ˧dɤ˧ɻ̍˧	õ ˧ d ɤ ˧ ɻ̍ ˧  
õ˧tʰv̩˧	õ ˧ tʰ v̩ ˧  
õ˧zɯ˧	õ ˧ z ɯ ˧  
õ˧ɻ̍˥	õ ˧ ɻ̍ ˥  
õ˧ʈʂʰɯ˧ne˧ʝi˥kv̩˩	õ ˧ ʈʂʰ ɯ ˧ n e ˧ ʝ i ˥ k v̩ ˩  
õ˧ʈʂʰɯ˧ʁo˥	õ ˧ ʈʂʰ ɯ ˧ ʁ o ˥  
pi˥hĩ˩	p i ˥ h ĩ ˩  
pi˥kv̩˩tsɯ˩	p i ˥ k v̩ ˩ ts ɯ ˩  
pi˧kæ˧	p i ˧ k æ ˧  
pi˧ɲi˥	p i ˧ ɲ i ˥  
pi˧ɲi˥kv̩˩tsɯ˩	p i ˧ ɲ i ˥ k v̩ ˩ ts ɯ ˩  
pi˩kv̩˩mv̩˩	p i ˩ k v̩ ˩ m v̩ ˩  
pi˩kv̩˩mæ˩	p i ˩ k v̩ ˩ m æ ˩  
po˧bi˥kv̩˩mæ˩	p o ˧ b i ˥ k v̩ ˩ m æ ˩  
po˧jo˥kv̩˩	p o ˧ jo ˥ k v̩ ˩  
po˩	p o ˩  
po˩ɳɯ˩	p o ˩ ɳ ɯ ˩  
pv̩˥	p v̩ ˥  
pv̩˧hĩ˧	p v̩ ˧ h ĩ ˧  
pv̩˧tsɤ˥	p v̩ ˧ ts ɤ ˥  
pv̩˩hĩ˩	p v̩ ˩ h ĩ ˩  
pʰo˩ɲi˩tsɯ˩	pʰ o ˩ ɲ i ˩ ts ɯ ˩  
pʰo˩˥	pʰ o ˩˥  
pʰv̩˧ɖɯ˧hĩ˥	pʰ v̩ ˧ ɖ ɯ ˧ h ĩ ˥  
pʰv̩˩tɕæ˩ɻæ˥zo˩	pʰ v̩ ˩ tɕ æ ˩ ɻ æ ˥ z o ˩  
pʰv̩˩˥	pʰ v̩ ˩˥  
pʰæ˧pʰæ˧ɻ̍˩	pʰ æ ˧ pʰ æ ˧ ɻ̍ ˩  
pʰæ˧˥	pʰ æ ˧˥  
qo˧lo˩	q o ˧ l o ˩  
qo˧pv̩˩	q o ˧ p v̩ ˩  
qo˩ho˧	q o ˩ h o ˧  
qo˩qɑ˩ʁo˩	q o ˩ q ɑ ˩ ʁ o ˩  
qv̩˧ɻ̍˧ki˧ɳɯ˩	q v̩ ˧ ɻ̍ ˧ k i ˧ ɳ ɯ ˩  
qæ˧qæ˧	q æ ˧ q æ ˧  
qɑ˧˥	q ɑ ˧˥  
qɑ˩	q ɑ ˩  
qʰv̩˧	qʰ v̩ ˧  
qʰv̩˧kv̩˧	qʰ v̩ ˧ k v̩ ˧  
qʰv̩˧kʰv̩˥	qʰ v̩ ˧ kʰ v̩ ˥  
qʰwæ˧	qʰ wæ ˧  
qʰwɤ˩˥	qʰ wɤ ˩˥  
qʰæ˥kv̩˩mæ˩	qʰ æ ˥ k v̩ ˩ m æ ˩  
qʰæ˧˥	qʰ æ ˧˥  
s	s  
se˧kʰɯ˩ʁo˩ni˩	s e ˧ kʰ ɯ ˩ ʁ o ˩ n i ˩  
se˧ɲi˥	s e ˧ ɲ i ˥  
se˩dʑo˩	s e ˩ dʑ o ˩  
se˩se˩	s e ˩ s e ˩  
si˧po˩ɳɯ˩	s i ˧ p o ˩ ɳ ɯ ˩  
so˧hwɤ˩	s o ˧ h wɤ ˩  
so˧kɯ˧	s o ˧ k ɯ ˧  
so˧tsʰi˧	s o ˧ tsʰ i ˧  
so˧ʑi˧	s o ˧ ʑ i ˧  
so˧ʝi˧bv̩˧	s o ˧ ʝ i ˧ b v̩ ˧  
so˩hɑ̃˩	s o ˩ h ɑ̃ ˩  
so˩hɑ̃˩˥	s o ˩ h ɑ̃ ˩˥  
so˩kv̩˩hĩ˥	s o ˩ k v̩ ˩ h ĩ ˥  
so˩ɲi˩so˩hɑ̃˥	s o ˩ ɲ i ˩ s o ˩ h ɑ̃ ˥  
so˩ɳɯ˩	s o ˩ ɳ ɯ ˩  
sɯ˧	s ɯ ˧  
sɯ˧hĩ˧	s ɯ ˧ h ĩ ˧  
sɯ˧pʰi˧bv̩˧	s ɯ ˧ pʰ i ˧ b v̩ ˧  
sɯ˧pʰi˧ʐwæ˧	s ɯ ˧ pʰ i ˧ ʐ wæ ˧  
t	t  
ti˩kv̩˩ze˩mæ˩	t i ˩ k v̩ ˩ z e ˩ m æ ˩  
ts	ts  
tso˥ɲi˩tsɯ˩	ts o ˥ ɲ i ˩ ts ɯ ˩  
tso˩	ts o ˩  
tsɑ˧bɤ˧	ts ɑ ˧ b ɤ ˧  
tsɤ˧ɲi˥	ts ɤ ˧ ɲ i ˥  
tsɤ˩	ts ɤ ˩  
tsɯ˧kv̩˩	ts ɯ ˧ k v̩ ˩  
tsɯ˧˥	ts ɯ ˧˥  
tsɯ˩lɑ˩	ts ɯ ˩ l ɑ ˩  
tsʰe˧tʰv̩˧	tsʰ e ˧ tʰ v̩ ˧  
tsʰe˩hõ˩pʰo˥	tsʰ e ˩ h õ ˩ pʰ o ˥  
tsʰe˩kv̩˩	tsʰ e ˩ k v̩ ˩  
tsʰe˩kv̩˩˥	tsʰ e ˩ k v̩ ˩˥  
tsʰe˩kʰv̩˩˥	tsʰ e ˩ kʰ v̩ ˩˥  
tsʰe˩so˩kʰv̩˩hĩ˥	tsʰ e ˩ s o ˩ kʰ v̩ ˩ h ĩ ˥  
tsʰe˩so˩kʰv̩˩lɑ˥	tsʰ e ˩ s o ˩ kʰ v̩ ˩ l ɑ ˥  
tsʰe˩so˩kʰv̩˩ɳɯ˥	tsʰ e ˩ s o ˩ kʰ v̩ ˩ ɳ ɯ ˥  
tsʰe˩so˩kʰv̩˩˥	tsʰ e ˩ s o ˩ kʰ v̩ ˩˥  
tsʰe˩ŋwɤ˩	tsʰ e ˩ ŋ wɤ ˩  
tsʰe˩ŋwɤ˩ɲi˥	tsʰ e ˩ ŋ wɤ ˩ ɲ i ˥  
tsʰi˧	tsʰ i ˧  
tsʰi˩hĩ˩˥	tsʰ i ˩ h ĩ ˩˥  
tsʰo˥	tsʰ o ˥  
tsʰɑ	tsʰ ɑ  
tv̩˧qʰv̩˧	t v̩ ˧ qʰ v̩ ˧  
tɑ˧tɑ˧	t ɑ ˧ t ɑ ˧  
tɕ	tɕ  
tɕi˧sɯ˧pɤ˧ʈʂʰɯ˧	tɕ i ˧ s ɯ ˧ p ɤ ˧ ʈʂʰ ɯ ˧  
tɕo˧˥ʂɯ˩	tɕ o ˧˥ ʂ ɯ ˩  
tɕæ˧ɻæ˩	tɕ æ ˧ ɻ æ ˩  
tɕɯ˥	tɕ ɯ ˥  
tɕɯ˥kv̩˩mæ˩	tɕ ɯ ˥ k v̩ ˩ m æ ˩  
tɕɯ˧le˥po˩tsʰɯ˩	tɕ ɯ ˧ l e ˥ p o ˩ tsʰ ɯ ˩  
tɕɯ˧lɑ˥	tɕ ɯ ˧ l ɑ ˥  
tɕɯ˩bi˩	tɕ ɯ ˩ b i ˩  
tɕɯ˩bi˩dʑo˩	tɕ ɯ ˩ b i ˩ dʑ o ˩  
tɕɯ˩pv̩˩kʰɯ˩	tɕ ɯ ˩ p v̩ ˩ kʰ ɯ ˩  
tɕɯ˩zo˩ɳɯ˩	tɕ ɯ ˩ z o ˩ ɳ ɯ ˩  
tɕʰi˧hɯ˧dʑo˥	tɕʰ i ˧ h ɯ ˧ dʑ o ˥  
tɕʰi˩bi˩pi˥	tɕʰ i ˩ b i ˩ p i ˥  
tɕʰi˩bi˩pi˥hɯ˩dʑo˩	tɕʰ i ˩ b i ˩ p i ˥ h ɯ ˩ dʑ o ˩  
tɕʰi˩bi˩zo˩ho˥	tɕʰ i ˩ b i ˩ z o ˩ h o ˥  
tɕʰi˩le˥wo˩tsʰɯ˩	tɕʰ i ˩ l e ˥ w o ˩ tsʰ ɯ ˩  
tɕʰi˩tʰv̩˩hĩ˥	tɕʰ i ˩ tʰ v̩ ˩ h ĩ ˥  
tɕʰo˧tɕʰo˥	tɕʰ o ˧ tɕʰ o ˥  
tɕʰo˧tɕʰo˧ɻ̍˩	tɕʰ o ˧ tɕʰ o ˧ ɻ̍ ˩  
tɕʰɤ˧ɲi˧ne˧ʝi˥	tɕʰ ɤ ˧ ɲ i ˧ n e ˧ ʝ i ˥  
tɕʰɯ˧ɭɯ˧	tɕʰ ɯ ˧ ɭ ɯ ˧  
tɕʰɯ˧ɳɯ˩	tɕʰ ɯ ˧ ɳ ɯ ˩  
tʰi˥ki˩	tʰ i ˥ k i ˩  
tʰi˥po˩	tʰ i ˥ p o ˩  
tʰi˧bv̩˥	tʰ i ˧ b v̩ ˥  
tʰi˧di˥hĩ˩	tʰ i ˧ d i ˥ h ĩ ˩  
tʰi˧dzi˧˥	tʰ i ˧ dz i ˧˥  
tʰi˧dzi˩kʰɯ˩	tʰ i ˧ dz i ˩ kʰ ɯ ˩  
tʰi˧dzi˩kʰɯ˩tsɯ˩	tʰ i ˧ dz i ˩ kʰ ɯ ˩ ts ɯ ˩  
tʰi˧dzɯ˥kʰɯ˩	tʰ i ˧ dz ɯ ˥ kʰ ɯ ˩  
tʰi˧dzɯ˥tɕɯ˩	tʰ i ˧ dz ɯ ˥ tɕ ɯ ˩  
tʰi˧dʑo˧	tʰ i ˧ dʑ o ˧  
tʰi˧dʑo˩	tʰ i ˧ dʑ o ˩  
tʰi˧dʑo˩dʑo˩	tʰ i ˧ dʑ o ˩ dʑ o ˩  
tʰi˧dʑo˩hĩ˩	tʰ i ˧ dʑ o ˩ h ĩ ˩  
tʰi˧dʑo˩lɑ˩	tʰ i ˧ dʑ o ˩ l ɑ ˩  
tʰi˧gɤ˧	tʰ i ˧ g ɤ ˧  
tʰi˧hĩ˧hõ˥	tʰ i ˧ h ĩ ˧ h õ ˥  
tʰi˧kʰɯ˩	tʰ i ˧ kʰ ɯ ˩  
tʰi˧mɤ˧ɲi˥	tʰ i ˧ m ɤ ˧ ɲ i ˥  
tʰi˧pɤ˧pɤ˥	tʰ i ˧ p ɤ ˧ p ɤ ˥  
tʰi˧pʰæ˧dʑo˥	tʰ i ˧ pʰ æ ˧ dʑ o ˥  
tʰi˧qo˩	tʰ i ˧ q o ˩  
tʰi˧qʰæ˧˥	tʰ i ˧ qʰ æ ˧˥  
tʰi˧se˩kʰɯ˩	tʰ i ˧ s e ˩ kʰ ɯ ˩  
tʰi˧tsɯ˥	tʰ i ˧ ts ɯ ˥  
tʰi˧tsʰi˧˥	tʰ i ˧ tsʰ i ˧˥  
tʰi˧ʂe˧	tʰ i ˧ ʂ e ˧  
tʰi˧ʈɯ˧˥	tʰ i ˧ ʈ ɯ ˧˥  
tʰi˩lɑ˩	tʰ i ˩ l ɑ ˩  
tʰv̩˧dʑo˥	tʰ v̩ ˧ dʑ o ˥  
tʰv̩˧dʑo˩	tʰ v̩ ˧ dʑ o ˩  
tʰv̩˧gi˥	tʰ v̩ ˧ g i ˥  
tʰv̩˧hɑ̃˩dʑo˩	tʰ v̩ ˧ h ɑ̃ ˩ dʑ o ˩  
tʰv̩˧kwɤ˧tɕɯ˥lɑ˩	tʰ v̩ ˧ k wɤ ˧ tɕ ɯ ˥ l ɑ ˩  
tʰv̩˧kʰwɤ˥	tʰ v̩ ˧ kʰ wɤ ˥  
tʰv̩˧kʰwɤ˧qo˩	tʰ v̩ ˧ kʰ wɤ ˧ q o ˩  
tʰv̩˧so˩	tʰ v̩ ˧ s o ˩  
tʰv̩˧so˩dʑo˩	tʰ v̩ ˧ s o ˩ dʑ o ˩  
tʰv̩˧v̩˧ki˧dʑo˩	tʰ v̩ ˧ v̩ ˧ k i ˧ dʑ o ˩  
tʰv̩˧v̩˧ɳɯ˩dʑo˩	tʰ v̩ ˧ v̩ ˧ ɳ ɯ ˩ dʑ o ˩  
tʰv̩˧ɲi˥	tʰ v̩ ˧ ɲ i ˥  
tʰv̩˧ɲi˥ze˩	tʰ v̩ ˧ ɲ i ˥ z e ˩  
tʰv̩˧ɻ̍˧	tʰ v̩ ˧ ɻ̍ ˧  
tʰv̩˧ʑi˥ki˩	tʰ v̩ ˧ ʑ i ˥ k i ˩  
tʰv̩˩tsɯ˩	tʰ v̩ ˩ ts ɯ ˩  
tʰv̩˩v̩˩	tʰ v̩ ˩ v̩ ˩  
tʰv̩˩v̩˩dʑo˩	tʰ v̩ ˩ v̩ ˩ dʑ o ˩  
tʰv̩˩ze˩	tʰ v̩ ˩ z e ˩  
tʰv̩˩ɲi˩	tʰ v̩ ˩ ɲ i ˩  
tʰæ˧ɻæ˧	tʰ æ ˧ ɻ æ ˧  
tʰɑ˩˥	tʰ ɑ ˩˥  
v	v  
v̩˧lɑ˩	v̩ ˧ l ɑ ˩  
v̩˧qo˩	v̩ ˧ q o ˩  
v̩˩tsʰɤ˧tæ˧pv̩˥	v̩ ˩ tsʰ ɤ ˧ t æ ˧ p v̩ ˥  
wo˧læ˩	w o ˧ l æ ˩  
wo˩ɻæ˥	w o ˩ ɻ æ ˥  
ze˩bæ˧	z e ˩ b æ ˧  
zo˧hṽ̩˧bi˥	z o ˧ h ṽ̩ ˧ b i ˥  
zo˧mv̩˥dʑo˩	z o ˧ m v̩ ˥ dʑ o ˩  
zo˧mv̩˥lɑ˩	z o ˧ m v̩ ˥ l ɑ ˩  
zo˩no˧ɲi˩pi˩	z o ˩ n o ˧ ɲ i ˩ p i ˩  
zɑ˩bɑ˧lɑ˩	z ɑ ˩ b ɑ ˧ l ɑ ˩  
zɯ˧kʰɯ˧ʈɯ˥	z ɯ ˧ kʰ ɯ ˧ ʈ ɯ ˥  
æ˧ʂæ˧ki˧	æ ˧ ʂ æ ˧ k i ˧  
æ˧ʂæ˧qʰwɤ˧˥	æ ˧ ʂ æ ˧ qʰ wɤ ˧˥  
æ˧ʂæ˧ʈʂʰɯ˧	æ ˧ ʂ æ ˧ ʈʂʰ ɯ ˧  
æ˩	æ ˩  
æ̃	æ̃  
æ̃˩	æ̃ ˩  
æ̃˩ʈv̩˥bi˩	æ̃ ˩ ʈ v̩ ˥ b i ˩  
æ̃˩˥	æ̃ ˩˥  
ŋ	ŋ  
ŋv̩˩ɲi˥tsɯ˩	ŋ v̩ ˩ ɲ i ˥ ts ɯ ˩  
ŋwæ˧qʰv̩˧	ŋ wæ ˧ qʰ v̩ ˧  
ŋwɤ˧hɑ̃˩lɑ˩	ŋ wɤ ˧ h ɑ̃ ˩ l ɑ ˩  
ŋwɤ˩bæ˩	ŋ wɤ ˩ b æ ˩  
ŋwɤ˩bæ˩hĩ˥	ŋ wɤ ˩ b æ ˩ h ĩ ˥  
ŋwɤ˩kv̩˩	ŋ wɤ ˩ k v̩ ˩  
ŋwɤ˩kv̩˩˥	ŋ wɤ ˩ k v̩ ˩˥  
ŋwɤ˩ɬi˩mi˩˥	ŋ wɤ ˩ ɬ i ˩ m i ˩˥  
ɑ˩pʰo˩hĩ˥	ɑ ˩ pʰ o ˩ h ĩ ˥  
ɑ˩ʁo˧hĩ˧	ɑ ˩ ʁ o ˧ h ĩ ˧  
ɑ˩ʁo˧hĩ˧ɳɯ˩	ɑ ˩ ʁ o ˧ h ĩ ˧ ɳ ɯ ˩  
ɕi˧ho˩ʂɯ˩	ɕ i ˧ h o ˩ ʂ ɯ ˩  
ɖwæ˩mɤ˧zo˧wɤ˧	ɖ wæ ˩ m ɤ ˧ z o ˧ wɤ ˧  
ɖæ˩mi˧	ɖ æ ˩ m i ˧  
ɖæ˩mi˧sɯ˩pʰi˩ɻ̍˩ɳɯ˩	ɖ æ ˩ m i ˧ s ɯ ˩ pʰ i ˩ ɻ̍ ˩ ɳ ɯ ˩  
ɖæ˩mi˧ə˧lɑ˧ʁwɤ˧	ɖ æ ˩ m i ˧ ə ˧ l ɑ ˧ ʁ wɤ ˧  
ɖɯ	ɖ ɯ  
ɖɯ˧bæ˧ɖɯ˧bæ˧	ɖ ɯ ˧ b æ ˧ ɖ ɯ ˧ b æ ˧  
ɖɯ˧dzi˥	ɖ ɯ ˧ dz i ˥  
ɖɯ˧dzi˧	ɖ ɯ ˧ dz i ˧  
ɖɯ˧dzi˧lɑ˧	ɖ ɯ ˧ dz i ˧ l ɑ ˧  
ɖɯ˧dzɤ˥	ɖ ɯ ˧ dz ɤ ˥  
ɖɯ˧dɑ˧˥	ɖ ɯ ˧ d ɑ ˧˥  
ɖɯ˧gi˥	ɖ ɯ ˧ g i ˥  
ɖɯ˧hɑ˩	ɖ ɯ ˧ h ɑ ˩  
ɖɯ˧hɑ˩ɻ̍˩	ɖ ɯ ˧ h ɑ ˩ ɻ̍ ˩  
ɖɯ˧jɤ˧˥	ɖ ɯ ˧ jɤ ˧˥  
ɖɯ˧kɤ˥kɤ˩	ɖ ɯ ˧ k ɤ ˥ k ɤ ˩  
ɖɯ˧kʰɯ˧˥	ɖ ɯ ˧ kʰ ɯ ˧˥  
ɖɯ˧qɑ˧ɻ̍˥	ɖ ɯ ˧ q ɑ ˧ ɻ̍ ˥  
ɖɯ˧tso˩	ɖ ɯ ˧ ts o ˩  
ɖɯ˧tso˩ɳɯ˩	ɖ ɯ ˧ ts o ˩ ɳ ɯ ˩  
ɖɯ˧tsʰi˥ɖɯ˩tsʰi˩	ɖ ɯ ˧ tsʰ i ˥ ɖ ɯ ˩ tsʰ i ˩  
ɖɯ˧tɕʰi˩ɳɯ˩	ɖ ɯ ˧ tɕʰ i ˩ ɳ ɯ ˩  
ɖɯ˧tʰv̩˧ɳɯ˧	ɖ ɯ ˧ tʰ v̩ ˧ ɳ ɯ ˧  
ɖɯ˧v̩˧ɖɯ˧v̩˧ɳɯ˧	ɖ ɯ ˧ v̩ ˧ ɖ ɯ ˧ v̩ ˧ ɳ ɯ ˧  
ɖɯ˧ɭɯ˧hĩ˧ʈʂʰɯ˧	ɖ ɯ ˧ ɭ ɯ ˧ h ĩ ˧ ʈʂʰ ɯ ˧  
ɖɯ˧ɭɯ˧qo˧ɳɯ˧	ɖ ɯ ˧ ɭ ɯ ˧ q o ˧ ɳ ɯ ˧  
ɖɯ˧ɲi˥ɖɯ˩ɲi˩	ɖ ɯ ˧ ɲ i ˥ ɖ ɯ ˩ ɲ i ˩  
ɖɯ˧ɲi˧ɻ̍˧dʑo˩	ɖ ɯ ˧ ɲ i ˧ ɻ̍ ˧ dʑ o ˩  
ɖɯ˧ʂɯ˩ɳɯ˩	ɖ ɯ ˧ ʂ ɯ ˩ ɳ ɯ ˩  
ɖɯ˧ʈæ˩tsʰo˩	ɖ ɯ ˧ ʈ æ ˩ tsʰ o ˩  
ɖɯ˧ʈɤ˧	ɖ ɯ ˧ ʈ ɤ ˧  
ɖɯ˧ʈɤ˧ɳɯ˧	ɖ ɯ ˧ ʈ ɤ ˧ ɳ ɯ ˧  
ɖɯ˧ʈʂʰæ˧	ɖ ɯ ˧ ʈʂʰ æ ˧  
ɖɯ˧ʈʂʰæ˧˥	ɖ ɯ ˧ ʈʂʰ æ ˧˥  
ɖɯ˧ʈʰɤ˥	ɖ ɯ ˧ ʈʰ ɤ ˥  
ɖɯ˧ʑi˩bv̩˩	ɖ ɯ ˧ ʑ i ˩ b v̩ ˩  
ɖɯ˧ʑi˩ki˩	ɖ ɯ ˧ ʑ i ˩ k i ˩  
ɖɯ˧ʑi˩ɻ̍˩ʈʂʰɯ˩dʑo˩	ɖ ɯ ˧ ʑ i ˩ ɻ̍ ˩ ʈʂʰ ɯ ˩ dʑ o ˩  
ɖɯ˩hĩ˩ki˥	ɖ ɯ ˩ h ĩ ˩ k i ˥  
ɖɯ˩ho˩	ɖ ɯ ˩ h o ˩  
ɖɯ˩pʰv̩˩	ɖ ɯ ˩ pʰ v̩ ˩  
ɖɯ˩v̩˩	ɖ ɯ ˩ v̩ ˩  
ɖɯ˩ɖʐɯ˧tsʰɯ˩ɻ̍˩	ɖ ɯ ˩ ɖʐ ɯ ˧ tsʰ ɯ ˩ ɻ̍ ˩  
ɖʐo˧hĩ˧	ɖʐ o ˧ h ĩ ˧  
ɖʐɤ˥	ɖʐ ɤ ˥  
ə˧dɑ˧ə˧mi˧dʑo˩	ə ˧ d ɑ ˧ ə ˧ m i ˧ dʑ o ˩  
ə˧mi˥	ə ˧ m i ˥  
ə˧mi˧tɕi˩	ə ˧ m i ˧ tɕ i ˩  
ə˧mi˧ɳɯ˧dʑo˥	ə ˧ m i ˧ ɳ ɯ ˧ dʑ o ˥  
ə˧mi˧ɻæ˩dʑo˩	ə ˧ m i ˧ ɻ æ ˩ dʑ o ˩  
ə˧mi˧ɻæ˩ɳɯ˩	ə ˧ m i ˧ ɻ æ ˩ ɳ ɯ ˩  
ə˧mv̩˧	ə ˧ m v̩ ˧  
ə˧mv̩˩ɳɯ˩	ə ˧ m v̩ ˩ ɳ ɯ ˩  
ə˧mɑ˧lɑ˧	ə ˧ m ɑ ˧ l ɑ ˧  
ə˧pʰv̩˧ɳɯ˧	ə ˧ pʰ v̩ ˧ ɳ ɯ ˧  
ə˧so˧	ə ˧ s o ˧  
ə˧tse˧bi˧	ə ˧ ts e ˧ b i ˧  
ə˧tse˧ʝi˧ɲi˥	ə ˧ ts e ˧ ʝ i ˧ ɲ i ˥  
ə˧tso˧ə˧tso˥	ə ˧ ts o ˧ ə ˧ ts o ˥  
ə˧v̩˧	ə ˧ v̩ ˧  
ə˧v̩˧ki˥	ə ˧ v̩ ˧ k i ˥  
ə˧zɯ˩dʑo˩	ə ˧ z ɯ ˩ dʑ o ˩  
ə˧ɲi˧tsʰi˧ɲi˧	ə ˧ ɲ i ˧ tsʰ i ˧ ɲ i ˧  
ə˧ʑi˧se˥	ə ˧ ʑ i ˧ s e ˥  
ə˧ʑi˧ʈʂʰɯ˥	ə ˧ ʑ i ˧ ʈʂʰ ɯ ˥  
ə˧ʑi˧ʈʂʰɯ˥dʑo˩	ə ˧ ʑ i ˧ ʈʂʰ ɯ ˥ dʑ o ˩  
ə˧ʑi˧ʈʂʰɯ˧dʑo˩	ə ˧ ʑ i ˧ ʈʂʰ ɯ ˧ dʑ o ˩  
ə˧ʝi˧ʂɯ˥ʝi˩bv̩˩	ə ˧ ʝ i ˧ ʂ ɯ ˥ ʝ i ˩ b v̩ ˩  
ə˧˥dʑo˩	ə ˧˥ dʑ o ˩  
ə˩kʰɯ˩	ə ˩ kʰ ɯ ˩  
ə˩ɲi˩˥	ə ˩ ɲ i ˩˥  
ɣɯ˩˥	ɣ ɯ ˩˥  
ɬi˧	ɬ i ˧  
ɬi˧di˩di˩mi˩hĩ˩	ɬ i ˧ d i ˩ d i ˩ m i ˩ h ĩ ˩  
ɬi˧di˩di˩mi˩qo˩dʑo˩	ɬ i ˧ d i ˩ d i ˩ m i ˩ q o ˩ dʑ o ˩  
ɬi˧di˩ɳɯ˩	ɬ i ˧ d i ˩ ɳ ɯ ˩  
ɬi˧hĩ˧	ɬ i ˧ h ĩ ˧  
ɬi˩bi˩ʈʂʰɯ˥	ɬ i ˩ b i ˩ ʈʂʰ ɯ ˥  
ɬi˩bi˩˥	ɬ i ˩ b i ˩˥  
ɬo˧	ɬ o ˧  
ɬo˧kʰv̩˧	ɬ o ˧ kʰ v̩ ˧  
ɬɑ˧sɑ˧ɳɯ˧	ɬ ɑ ˧ s ɑ ˧ ɳ ɯ ˧  
ɬɬɬ	ɬ ɬ ɬ  
ɲi˥pi˩zo˩	ɲ i ˥ p i ˩ z o ˩  
ɲi˧gi˧	ɲ i ˧ g i ˧  
ɲi˧pʰo˧ɳɯ˥	ɲ i ˧ pʰ o ˧ ɳ ɯ ˥  
ɲi˧tsi˧	ɲ i ˧ ts i ˧  
ɲi˧ɬi˧mi˧	ɲ i ˧ ɬ i ˧ m i ˧  
ɲi˧ɲi˧	ɲ i ˧ ɲ i ˧  
ɲi˧ʂɯ˩	ɲ i ˧ ʂ ɯ ˩  
ɲi˧ʈʂæ˧ʑi˧˥	ɲ i ˧ ʈʂ æ ˧ ʑ i ˧˥  
ɲi˩kv̩˩˥	ɲ i ˩ k v̩ ˩˥  
ɲi˩tsɯ˩	ɲ i ˩ ts ɯ ˩  
ɲi˩˥	ɲ i ˩˥  
ɳæ˧˥	ɳ æ ˧˥  
ɳæ˩	ɳ æ ˩  
ɳɯ˥	ɳ ɯ ˥  
ɻwæ˧	ɻ wæ ˧  
ɻwæ˧kv̩˩mæ˩	ɻ wæ ˧ k v̩ ˩ m æ ˩  
ɻæ˩ʈʂʰɯ˥	ɻ æ ˩ ʈʂʰ ɯ ˥  
ʁo˧dɑ˧dʑo˧	ʁ o ˧ d ɑ ˧ dʑ o ˧  
ʁo˧dɑ˧se˥	ʁ o ˧ d ɑ ˧ s e ˥  
ʁo˧ni˥	ʁ o ˧ n i ˥  
ʁo˧qʰwɤ˩	ʁ o ˧ qʰ wɤ ˩  
ʁo˧ʂwæ˧	ʁ o ˧ ʂ wæ ˧  
ʁo˧ʂwæ˧qo˧pv̩˩	ʁ o ˧ ʂ wæ ˧ q o ˧ p v̩ ˩  
ʁæ˧bæ˧	ʁ æ ˧ b æ ˧  
ʁæ˩bæ˩	ʁ æ ˩ b æ ˩  
ʁɑ˧ʂe˩dʑo˩	ʁ ɑ ˧ ʂ e ˩ dʑ o ˩  
ʁɑ˧ʂe˩kv̩˩	ʁ ɑ ˧ ʂ e ˩ k v̩ ˩  
ʁɑ˧ʂe˩kʰi˩	ʁ ɑ ˧ ʂ e ˩ kʰ i ˩  
ʁɑ˩mi˥	ʁ ɑ ˩ m i ˥  
ʁɑ˩ʂɯ˥	ʁ ɑ ˩ ʂ ɯ ˥  
ʂ	ʂ  
ʂe˧dʑo˧	ʂ e ˧ dʑ o ˧  
ʂe˧hĩ˧	ʂ e ˧ h ĩ ˧  
ʂe˧lɑ˩	ʂ e ˧ l ɑ ˩  
ʂe˧ʈʂʰɯ˧	ʂ e ˧ ʈʂʰ ɯ ˧  
ʂe˧ʐe˧ʂe˧sɑ˥	ʂ e ˧ ʐ e ˧ ʂ e ˧ s ɑ ˥  
ʂe˩bv̩˩	ʂ e ˩ b v̩ ˩  
ʂo˧ko˧tʰɑ˩	ʂ o ˧ k o ˧ tʰ ɑ ˩  
ʂv̩˧ɖv̩˧	ʂ v̩ ˧ ɖ v̩ ˧  
ʂv̩˧ɖv̩˧ze˧jɤ	ʂ v̩ ˧ ɖ v̩ ˧ z e ˧ jɤ  
ʂv̩˧ɖv̩˧zo˥	ʂ v̩ ˧ ɖ v̩ ˧ z o ˥  
ʂwæ˧	ʂ wæ ˧  
ʂwæ˧gv̩˧	ʂ wæ ˧ g v̩ ˧  
ʂwæ˧gv̩˧ʈʂʰɯ˧	ʂ wæ ˧ g v̩ ˧ ʈʂʰ ɯ ˧  
ʂæ˧ɲi˥kv̩˩tsɯ˩	ʂ æ ˧ ɲ i ˥ k v̩ ˩ ts ɯ ˩  
ʂɯ˧pi˧	ʂ ɯ ˧ p i ˧  
ʂɯ˧ze˧	ʂ ɯ ˧ z e ˧  
ʂɯ˧ɲi˧ɳɯ˩	ʂ ɯ ˧ ɲ i ˧ ɳ ɯ ˩  
ʈæ˧bɤ˧ɳɯ˧	ʈ æ ˧ b ɤ ˧ ɳ ɯ ˧  
ʈæ˩tsʰo˥	ʈ æ ˩ tsʰ o ˥  
ʈæ˩tsʰo˧	ʈ æ ˩ tsʰ o ˧  
ʈʂe˧nɑ˥	ʈʂ e ˧ n ɑ ˥  
ʈʂo˧kʰɯ˩dʑo˩	ʈʂ o ˧ kʰ ɯ ˩ dʑ o ˩  
ʈʂo˧ɭɯ˧qo˩ɳɯ˩	ʈʂ o ˧ ɭ ɯ ˧ q o ˩ ɳ ɯ ˩  
ʈʂʰo˧do˩	ʈʂʰ o ˧ d o ˩  
ʈʂʰo˧do˩ʁo˩	ʈʂʰ o ˧ d o ˩ ʁ o ˩  
ʈʂʰo˧hɯ˧ʈʂʰo˧ɻ̍˥	ʈʂʰ o ˧ h ɯ ˧ ʈʂʰ o ˧ ɻ̍ ˥  
ʈʂʰwæ˩	ʈʂʰ wæ ˩  
ʈʂʰwæ˩˥	ʈʂʰ wæ ˩˥  
ʈʂʰwɤ˧	ʈʂʰ wɤ ˧  
ʈʂʰwɤ˩mɤ˩ɖɯ˩	ʈʂʰ wɤ ˩ m ɤ ˩ ɖ ɯ ˩  
ʈʂʰæ˩	ʈʂʰ æ ˩  
ʈʂʰɤ˧tsɯ˧ni˩gv̩˩	ʈʂʰ ɤ ˧ ts ɯ ˧ n i ˩ g v̩ ˩  
ʈʂʰɯ˧bv̩˧	ʈʂʰ ɯ ˧ b v̩ ˧  
ʈʂʰɯ˧dzɤ˧	ʈʂʰ ɯ ˧ dz ɤ ˧  
ʈʂʰɯ˧gɤ˧	ʈʂʰ ɯ ˧ g ɤ ˧  
ʈʂʰɯ˧jɤ˩ɳɯ˩	ʈʂʰ ɯ ˧ jɤ ˩ ɳ ɯ ˩  
ʈʂʰɯ˧ki˩	ʈʂʰ ɯ ˧ k i ˩  
ʈʂʰɯ˧mi˧ɳɯ˥	ʈʂʰ ɯ ˧ m i ˧ ɳ ɯ ˥  
ʈʂʰɯ˧v̩˥dʑo˩	ʈʂʰ ɯ ˧ v̩ ˥ dʑ o ˩  
ʈʂʰɯ˧v̩˧dʑo˩	ʈʂʰ ɯ ˧ v̩ ˧ dʑ o ˩  
ʈʂʰɯ˧v̩˧ki˧	ʈʂʰ ɯ ˧ v̩ ˧ k i ˧  
ʈʂʰɯ˧zɯ˩	ʈʂʰ ɯ ˧ z ɯ ˩  
ʈʂʰɯ˧ɖɯ˧ɖɯ˧	ʈʂʰ ɯ ˧ ɖ ɯ ˧ ɖ ɯ ˧  
ʈʂʰɯ˧ɖɯ˧ɖɯ˧zo˥	ʈʂʰ ɯ ˧ ɖ ɯ ˧ ɖ ɯ ˧ z o ˥  
ʈʂʰɯ˧ɲi˥kv̩˩	ʈʂʰ ɯ ˧ ɲ i ˥ k v̩ ˩  
ʈʂʰɯ˧ɲi˥kv̩˩ɳɯ˩	ʈʂʰ ɯ ˧ ɲ i ˥ k v̩ ˩ ɳ ɯ ˩  
ʈʂʰɯ˧ɻ̍˩	ʈʂʰ ɯ ˧ ɻ̍ ˩  
ʈʂʰɯ˧ɻ̍˩ɳɯ˩	ʈʂʰ ɯ ˧ ɻ̍ ˩ ɳ ɯ ˩  
ʈʂʰɯ˧ʂwæ˧ʂwæ˧	ʈʂʰ ɯ ˧ ʂ wæ ˧ ʂ wæ ˧  
ʈʂʰɯ˧ʑi˥ki˩	ʈʂʰ ɯ ˧ ʑ i ˥ k i ˩  
ʈʂʰɯ˧ʑi˧ɻ̍˥	ʈʂʰ ɯ ˧ ʑ i ˧ ɻ̍ ˥  
ʈʂʰɯ˧ʑi˧ɻ̍˧ɳɯ˥	ʈʂʰ ɯ ˧ ʑ i ˧ ɻ̍ ˧ ɳ ɯ ˥  
ʈʂʰɯ˩jɤ˩	ʈʂʰ ɯ ˩ jɤ ˩  
ʈʂʰɯ˩v̩˩	ʈʂʰ ɯ ˩ v̩ ˩  
ʈʰi˩˥	ʈʰ i ˩˥  
ʈʰæ˧˥	ʈʰ æ ˧˥  
ʈʰɯ˩	ʈʰ ɯ ˩  
ʈʰɯ˩gɤ˩	ʈʰ ɯ ˩ g ɤ ˩  
ʈʰɯ˩hõ˩˥	ʈʰ ɯ ˩ h õ ˩˥  
ʐ	ʐ  
ʐe˧ʈæ˥ɬi˩qo˩	ʐ e ˧ ʈ æ ˥ ɬ i ˩ q o ˩  
ʐo˩mɤ˩ɖɯ˩	ʐ o ˩ m ɤ ˩ ɖ ɯ ˩  
ʐv	ʐ v  
ʐv̩˥	ʐ v̩ ˥  
ʐv̩˧tsʰi˩lɑ˩	ʐ v̩ ˧ tsʰ i ˩ l ɑ ˩  
ʐv̩˩kv̩˩ɳɯ˥	ʐ v̩ ˩ k v̩ ˩ ɳ ɯ ˥  
ʐwæ˧ʁo˩	ʐ wæ ˧ ʁ o ˩  
ʐwɤ˥	ʐ wɤ ˥  
ʐwɤ˩dʑɯ˩˥	ʐ wɤ ˩ dʑ ɯ ˩˥  
ʐwɤ˩kv̩˩wɤ˥	ʐ wɤ ˩ k v̩ ˩ wɤ ˥  
ʐwɤ˩mɤ˩hĩ˩hĩ˥ʈʂʰɯ˩dʑo˩	ʐ wɤ ˩ m ɤ ˩ h ĩ ˩ h ĩ ˥ ʈʂʰ ɯ ˩ dʑ o ˩  
ʐwɤ˩mɤ˩kv̩˥hĩ˩	ʐ wɤ ˩ m ɤ ˩ k v̩ ˥ h ĩ ˩  
ʐɯ˩dzi˥	ʐ ɯ ˩ dz i ˥  
ʐɯ˩mo˧tʰv̩˥	ʐ ɯ ˩ m o ˧ tʰ v̩ ˥  
ʑi˧qʰwɤ˧qo˧	ʑ i ˧ qʰ wɤ ˧ q o ˧  
ʝi	ʝ i  
ʝilõʁõlõ	ʝ i l õ ʁ õ l õ  
ʝi˥dʑo˩mæ˩	ʝ i ˥ dʑ o ˩ m æ ˩  
ʝi˥kwɤ˩tɕɯ˩lɑ˩	ʝ i ˥ k wɤ ˩ tɕ ɯ ˩ l ɑ ˩  
ʝi˥se˩kwɤ˩tɕɯ˩lɑ˩	ʝ i ˥ s e ˩ k wɤ ˩ tɕ ɯ ˩ l ɑ ˩  
ʝi˥tso˩ɲi˩	ʝ i ˥ ts o ˩ ɲ i ˩  
ʝi˧bi˧di˧	ʝ i ˧ b i ˧ d i ˧  
ʝi˧bi˧ni˥gv̩˩	ʝ i ˧ b i ˧ n i ˥ g v̩ ˩  
ʝi˧hɯ˧zo˥	ʝ i ˧ h ɯ ˧ z o ˥  
ʝi˧kv̩˩	ʝ i ˧ k v̩ ˩  
ʝi˧kʰv̩˥ʝi˩kʰv̩˩	ʝ i ˧ kʰ v̩ ˥ ʝ i ˩ kʰ v̩ ˩  
ʝi˧kʰv̩˧	ʝ i ˧ kʰ v̩ ˧  
ʝi˧ɲi˥tsɯ˩	ʝ i ˧ ɲ i ˥ ts ɯ ˩  
ʝi˧ɻ̍˥	ʝ i ˧ ɻ̍ ˥  
ʝi˧ʁwɤ˩qo˩	ʝ i ˧ ʁ wɤ ˩ q o ˩  
ʝi˩bi˩˥	ʝ i ˩ b i ˩˥  
ʝi˩tsɯ˩	ʝ i ˩ ts ɯ ˩  
bi˧bv̩˥	b i ˧ b v̩ ˥  
bi˧dʑo˥	b i ˧ dʑ o ˥  
bi˧dʑo˩	b i ˧ dʑ o ˩  
bi˧hĩ˩mɤ˩kv̩˩	b i ˧ h ĩ ˩ m ɤ ˩ k v̩ ˩  
bi˧ho˥dʑo˩	b i ˧ h o ˥ dʑ o ˩  
bi˧mɤ˧ʁo˧hĩ˧	b i ˧ m ɤ ˧ ʁ o ˧ h ĩ ˧  
bi˧tɕo˧	b i ˧ tɕ o ˧  
bi˧tɕo˧hĩ˧ki˧	b i ˧ tɕ o ˧ h ĩ ˧ k i ˧  
bi˧tʰɑ˧ʝi˥	b i ˧ tʰ ɑ ˧ ʝ i ˥  
bi˧zo˧kv̩˧˥	b i ˧ z o ˧ k v̩ ˧˥  
bi˧zo˧ʝi˧	b i ˧ z o ˧ ʝ i ˧  
bi˩bi˩	b i ˩ b i ˩  
bi˩bi˩˥	b i ˩ b i ˩˥  
bi˩dʑo˩	b i ˩ dʑ o ˩  
bi˩kv̩˥ze˩	b i ˩ k v̩ ˥ z e ˩  
bi˩kv̩˩ze˩mæ˩	b i ˩ k v̩ ˩ z e ˩ m æ ˩  
bi˩kwɤ˩tɕɯ˩lɑ˩	b i ˩ k wɤ ˩ tɕ ɯ ˩ l ɑ ˩  
bi˩tso˩ɲi˩	b i ˩ ts o ˩ ɲ i ˩  
bi˩zo˩kv̩˩	b i ˩ z o ˩ k v̩ ˩  
bmæ˩	b m æ ˩  
bo˧zo˩	b o ˧ z o ˩  
bo˩bo˥	b o ˩ b o ˥  
bo˩bv̩˥	b o ˩ b v̩ ˥  
bo˩gv̩˧	b o ˩ g v̩ ˧  
bo˩hɑ˥	b o ˩ h ɑ ˥  
bo˩hɑ˧	b o ˩ h ɑ ˧  
bo˩hɑ˧ki˩hĩ˩bv̩˩	b o ˩ h ɑ ˧ k i ˩ h ĩ ˩ b v̩ ˩  
bo˩lo˧	b o ˩ l o ˧  
bo˩lo˧ʈʂʰɯ˧	b o ˩ l o ˧ ʈʂʰ ɯ ˧  
bo˩mi˧	b o ˩ m i ˧  
bo˩ɬo˧ʈʂʰɯ˩	b o ˩ ɬ o ˧ ʈʂʰ ɯ ˩  
bo˩ʂe˧	b o ˩ ʂ e ˧  
bo˩ʂe˧qo˩dʑo˩	b o ˩ ʂ e ˧ q o ˩ dʑ o ˩  
bo˩ʈʂʰæ˥bi˩	b o ˩ ʈʂʰ æ ˥ b i ˩  
bo˩ʈʂʰæ˥ʁo˩	b o ˩ ʈʂʰ æ ˥ ʁ o ˩  
bo˩ʈʂʰæ˧qo˩dʑo˩	b o ˩ ʈʂʰ æ ˧ q o ˩ dʑ o ˩  
bo˩ʈʂʰæ˧ʈʂʰɯ˩	b o ˩ ʈʂʰ æ ˧ ʈʂʰ ɯ ˩  
bo˩˥	b o ˩˥  
bv	b v  
bv̩˥tso˩ɲi˩	b v̩ ˥ ts o ˩ ɲ i ˩  
bv̩˧nv̩˧dʑo˧	b v̩ ˧ n v̩ ˧ dʑ o ˧  
bv̩˧nv̩˧tsɯ˥	b v̩ ˧ n v̩ ˧ ts ɯ ˥  
bv̩˧ɻ̍˧	b v̩ ˧ ɻ̍ ˧  
bv̩˧ʈʂɯ˥qo˩	b v̩ ˧ ʈʂ ɯ ˥ q o ˩  
bv̩˩bv̩˩	b v̩ ˩ b v̩ ˩  
bv̩˩dzɯ˩ɲi˩pi˩zo˩	b v̩ ˩ dz ɯ ˩ ɲ i ˩ p i ˩ z o ˩  
bv̩˩lv̩˩hĩ˥	b v̩ ˩ l v̩ ˩ h ĩ ˥  
bv̩˩lv̩˩hĩ˥ɳɯ˩	b v̩ ˩ l v̩ ˩ h ĩ ˥ ɳ ɯ ˩  
bv̩˩ʝi˩	b v̩ ˩ ʝ i ˩  
bæ˥kv̩˩hĩ˩	b æ ˥ k v̩ ˩ h ĩ ˩  
bæ˧dʑɯ˩	b æ ˧ dʑ ɯ ˩  
bæ˧ze˩	b æ ˧ z e ˩  
bæ˧ɖæ˧ʈʂʰɯ˧	b æ ˧ ɖ æ ˧ ʈʂʰ ɯ ˧  
bæ˧ɲi˥ho˩mæ˩	b æ ˧ ɲ i ˥ h o ˩ m æ ˩  
bæ˧ɲi˥pi˩tsɯ˩	b æ ˧ ɲ i ˥ p i ˩ ts ɯ ˩  
bæ˩bæ˩	b æ ˩ b æ ˩  
bæ˩bæ˩˥	b æ ˩ b æ ˩˥  
bæ˩dʑɯ˧	b æ ˩ dʑ ɯ ˧  
bæ˩jɤni˩jɤ	b æ ˩ jɤ n i ˩ jɤ  
bæ˩po˩ɳɯ˥	b æ ˩ p o ˩ ɳ ɯ ˥  
bæ˩ɲi˥ho˩	b æ ˩ ɲ i ˥ h o ˩  
bæ˩ɲi˥ho˩ze˩wɤ˩	b æ ˩ ɲ i ˥ h o ˩ z e ˩ wɤ ˩  
bæ˩ʈʂʰɯ˥	b æ ˩ ʈʂʰ ɯ ˥  
bæ˩˥	b æ ˩˥  
bɑ˩lɑ˩sɯ˥	b ɑ ˩ l ɑ ˩ s ɯ ˥  
di˥hĩ˩	d i ˥ h ĩ ˩  
di˥hĩ˩dʑo˩	d i ˥ h ĩ ˩ dʑ o ˩  
di˥kv̩˩	d i ˥ k v̩ ˩  
di˧	d i ˧  
di˧di˥kʰɯ˩kv̩˩mæ˩	d i ˧ d i ˥ kʰ ɯ ˩ k v̩ ˩ m æ ˩  
di˧kʰɯ˥	d i ˧ kʰ ɯ ˥  
di˧qo˧dʑo˧	d i ˧ q o ˧ dʑ o ˧  
di˧qo˧dʑo˩	d i ˧ q o ˧ dʑ o ˩  
di˧qo˧hĩ˧	d i ˧ q o ˧ h ĩ ˧  
di˧qo˧tsʰɯ˩dʑo˩	d i ˧ q o ˧ tsʰ ɯ ˩ dʑ o ˩  
di˧qo˧ʈʂʰɯ˧	d i ˧ q o ˧ ʈʂʰ ɯ ˧  
di˧˥	d i ˧˥  
di˩dʑɤ˥	d i ˩ dʑ ɤ ˥  
di˩hĩ˩dʑo˩	d i ˩ h ĩ ˩ dʑ o ˩  
di˩hĩ˩ʈʂʰɯ˩	d i ˩ h ĩ ˩ ʈʂʰ ɯ ˩  
di˩kv̩˩	d i ˩ k v̩ ˩  
di˩kv̩˩tsɯ˩mv̩˩	d i ˩ k v̩ ˩ ts ɯ ˩ m v̩ ˩  
di˩kv̩˩˥	d i ˩ k v̩ ˩˥  
di˩li˩ʁo˩	d i ˩ l i ˩ ʁ o ˩  
di˩li˩ʁo˩bv̩˥pɤ˩jɤ˩	d i ˩ l i ˩ ʁ o ˩ b v̩ ˥ p ɤ ˩ jɤ ˩  
di˩ɲi˩ze˩	d i ˩ ɲ i ˩ z e ˩  
do˧	d o ˧  
do˧dʑo˥	d o ˧ dʑ o ˥  
do˧mɤ˧dʑɯ˧ɲi˥	d o ˧ m ɤ ˧ dʑ ɯ ˧ ɲ i ˥  
do˧zo˥	d o ˧ z o ˥  
do˩ho˩	d o ˩ h o ˩  
do˩kv̩˩pʰæ˥di˩	d o ˩ k v̩ ˩ pʰ æ ˥ d i ˩  
do˩kwɤ˩tɕɯ˥lɑ˩	d o ˩ k wɤ ˩ tɕ ɯ ˥ l ɑ ˩  
do˩kwɤ˩tɕɯ˩lɑ˩	d o ˩ k wɤ ˩ tɕ ɯ ˩ l ɑ ˩  
do˩mæ˩˥	d o ˩ m æ ˩˥  
do˩mɤ˥do˩	d o ˩ m ɤ ˥ d o ˩  
do˩tsɯ˩	d o ˩ ts ɯ ˩  
dv̩˥kv̩˩pi˩zo˩	d v̩ ˥ k v̩ ˩ p i ˩ z o ˩  
dv̩˧mɤ˥kv̩˩tsɯ˩mv̩˩	d v̩ ˧ m ɤ ˥ k v̩ ˩ ts ɯ ˩ m v̩ ˩  
dv̩˧tɕo˥	d v̩ ˧ tɕ o ˥  
dv̩˩hĩ˥dʑo˩	d v̩ ˩ h ĩ ˥ dʑ o ˩  
dv̩˩hĩ˧kwɤ˧tɕɯ˥lɑ˩	d v̩ ˩ h ĩ ˧ k wɤ ˧ tɕ ɯ ˥ l ɑ ˩  
dv̩˩kv̩˩tsɯ˥mv̩˩	d v̩ ˩ k v̩ ˩ ts ɯ ˥ m v̩ ˩  
dv̩˩mɤ˩kv̩˥	d v̩ ˩ m ɤ ˩ k v̩ ˥  
dv̩˩mɤ˩kv̩˥mv̩˩	d v̩ ˩ m ɤ ˩ k v̩ ˥ m v̩ ˩  
dv̩˩ɲi˥tsɯ˩mv̩˩	d v̩ ˩ ɲ i ˥ ts ɯ ˩ m v̩ ˩  
dze˧ɭɯ˧hɑ˧ɭɯ˧ʈʂʰɯ˧dʑo˩	dz e ˧ ɭ ɯ ˧ h ɑ ˧ ɭ ɯ ˧ ʈʂʰ ɯ ˧ dʑ o ˩  
dze˧ʈʂɤ˥	dz e ˧ ʈʂ ɤ ˥  
dze˧ʈʂɤ˧pi˥zo˩	dz e ˧ ʈʂ ɤ ˧ p i ˥ z o ˩  
dze˧ʈʂʰɤ˧	dz e ˧ ʈʂʰ ɤ ˧  
dzi˥pi˩hĩ˩ʈʂʰɯ˩dʑo˩	dz i ˥ p i ˩ h ĩ ˩ ʈʂʰ ɯ ˩ dʑ o ˩  
dzi˧dzi˧mo˧˥	dz i ˧ dz i ˧ m o ˧˥  
dzi˧hĩ˥	dz i ˧ h ĩ ˥  
dzi˩bi˩kv̩˩tsɯ˩	dz i ˩ b i ˩ k v̩ ˩ ts ɯ ˩  
dzi˩di˩	dz i ˩ d i ˩  
dzi˩ho˩	dz i ˩ h o ˩  
dzi˩hɯ˩	dz i ˩ h ɯ ˩  
dzi˩kʰv̩˩	dz i ˩ kʰ v̩ ˩  
dzi˩kʰɯ˩tsɯ˩	dz i ˩ kʰ ɯ ˩ ts ɯ ˩  
dzi˩pv̩˩kʰɯ˩dʑo˩	dz i ˩ p v̩ ˩ kʰ ɯ ˩ dʑ o ˩  
dzi˩˥	dz i ˩˥  
dzɑ˧hĩ˧ki˧	dz ɑ ˧ h ĩ ˧ k i ˧  
dzɑ˧hĩ˧pʰæ˧di˥ze˩	dz ɑ ˧ h ĩ ˧ pʰ æ ˧ d i ˥ z e ˩  
dzɑ˧mɤ˧kv̩˩	dz ɑ ˧ m ɤ ˧ k v̩ ˩  
dzɑ˧ʝi˧	dz ɑ ˧ ʝ i ˧  
dzɑ˧ʝi˧ze˩pi˩	dz ɑ ˧ ʝ i ˧ z e ˩ p i ˩  
dzɑ˩qʰwɤ˩	dz ɑ ˩ qʰ wɤ ˩  
dzɑ˩qʰwɤ˩ʈʂʰɯ˥dʑo˩	dz ɑ ˩ qʰ wɤ ˩ ʈʂʰ ɯ ˥ dʑ o ˩  
dzɯ˧bi˧ni˧gv̩˧˥	dz ɯ ˧ b i ˧ n i ˧ g v̩ ˧˥  
dzɯ˧gɤ˥	dz ɯ ˧ g ɤ ˥  
dzɯ˧hĩ˧dʑo˩	dz ɯ ˧ h ĩ ˧ dʑ o ˩  
dzɯ˧ho˥	dz ɯ ˧ h o ˥  
dzɯ˧ho˥ze˩tsɯ˩	dz ɯ ˧ h o ˥ z e ˩ ts ɯ ˩  
dzɯ˧hõ˧	dz ɯ ˧ h õ ˧  
dzɯ˧kv̩˩hĩ˩	dz ɯ ˧ k v̩ ˩ h ĩ ˩  
dzɯ˧kv̩˩mmm…	dz ɯ ˧ k v̩ ˩ mmm…  
dzɯ˧lɑ˩	dz ɯ ˧ l ɑ ˩  
dzɯ˧lɑ˩ɲi˩	dz ɯ ˧ l ɑ ˩ ɲ i ˩  
dzɯ˧mɤ˧gɤ˩	dz ɯ ˧ m ɤ ˧ g ɤ ˩  
dzɯ˧mɤ˧kv̩˩	dz ɯ ˧ m ɤ ˧ k v̩ ˩  
dzɯ˧mɤ˧kv̩˩wɤ˩	dz ɯ ˧ m ɤ ˧ k v̩ ˩ wɤ ˩  
dzɯ˧mɤ˧kv̩˩ze˩mæ˩	dz ɯ ˧ m ɤ ˧ k v̩ ˩ z e ˩ m æ ˩  
dzɯ˧mɤ˧tʰɑ˩	dz ɯ ˧ m ɤ ˧ tʰ ɑ ˩  
dzɯ˧mɤ˧ɖo˧	dz ɯ ˧ m ɤ ˧ ɖ o ˧  
dzɯ˧no˩	dz ɯ ˧ n o ˩  
dzɯ˧pi˩	dz ɯ ˧ p i ˩  
dzɯ˧tso˧	dz ɯ ˧ ts o ˧  
dzɯ˧tsæ˧ɲi˩	dz ɯ ˧ ts æ ˧ ɲ i ˩  
dzɯ˧tʰɑ˥	dz ɯ ˧ tʰ ɑ ˥  
dzɯ˧tʰɑ˧kv̩˩	dz ɯ ˧ tʰ ɑ ˧ k v̩ ˩  
dzɯ˧tʰɑ˧ze˩	dz ɯ ˧ tʰ ɑ ˧ z e ˩  
dzɯ˧tʰɑ˩bi˩	dz ɯ ˧ tʰ ɑ ˩ b i ˩  
dzɯ˧tʰɑ˩hĩ˩	dz ɯ ˧ tʰ ɑ ˩ h ĩ ˩  
dzɯ˧tʰɑ˩kv̩˩ze˩	dz ɯ ˧ tʰ ɑ ˩ k v̩ ˩ z e ˩  
dzɯ˧zo˧kv̩˩	dz ɯ ˧ z o ˧ k v̩ ˩  
dzɯ˩hĩ˥	dz ɯ ˩ h ĩ ˥  
dzɯ˩kv̩˩mæ˩	dz ɯ ˩ k v̩ ˩ m æ ˩  
dzɯ˩kwɤ˩tɕɯ˩lɑ˩	dz ɯ ˩ k wɤ ˩ tɕ ɯ ˩ l ɑ ˩  
dzɯ˩se˥	dz ɯ ˩ s e ˥  
dzɯ˩ɳɯ˩	dz ɯ ˩ ɳ ɯ ˩  
dɑ˥dʑo˩	d ɑ ˥ dʑ o ˩  
dɑ˥tso˩	d ɑ ˥ ts o ˩  
dɑ˥ɲi˩	d ɑ ˥ ɲ i ˩  
dɑ˥ʈʂʰɯ˩dʑo˩	d ɑ ˥ ʈʂʰ ɯ ˩ dʑ o ˩  
dɑ˧bi˥	d ɑ ˧ b i ˥  
dɑ˧hĩ˧ʈʂʰɯ˧	d ɑ ˧ h ĩ ˧ ʈʂʰ ɯ ˧  
dɑ˧mɤ˧ʁo˧	d ɑ ˧ m ɤ ˧ ʁ o ˧  
dɑ˧pɤ˧ki˧	d ɑ ˧ p ɤ ˧ k i ˧  
dɑ˧pɤ˧pi˧	d ɑ ˧ p ɤ ˧ p i ˧  
dɑ˧tso˧	d ɑ ˧ ts o ˧  
dɑ˧tsɑ˥ɲi˩	d ɑ ˧ ts ɑ ˥ ɲ i ˩  
dɑ˧tʰɑ˥ho˩	d ɑ ˧ tʰ ɑ ˥ h o ˩  
dɑ˧zo˧ʝi˥	d ɑ ˧ z o ˧ ʝ i ˥  
dɑ˩˥	d ɑ ˩˥  
dɤ˧˥	d ɤ ˧˥  
dʑi˧hṽ˧mv̩˩di˩	dʑ i ˧ h ṽ ˧ m v̩ ˩ d i ˩  
dʑi˧hṽ̩˥ʈʂʰɯ˩dʑo˩	dʑ i ˧ h ṽ̩ ˥ ʈʂʰ ɯ ˩ dʑ o ˩  
dʑi˧mi˧dʑo˩	dʑ i ˧ m i ˧ dʑ o ˩  
dʑi˧mi˧po˩ɳɯ˩	dʑ i ˧ m i ˧ p o ˩ ɳ ɯ ˩  
dʑi˧mi˧ʈʂʰɯ˧	dʑ i ˧ m i ˧ ʈʂʰ ɯ ˧  
dʑi˩hṽ˩ʈʂʰɯ˩dʑo˩	dʑ i ˩ h ṽ ˩ ʈʂʰ ɯ ˩ dʑ o ˩  
dʑo	dʑ o  
dʑo˥kv̩˩	dʑ o ˥ k v̩ ˩  
dʑo˥kwɤ˩tɕɯ˩lɑ˩	dʑ o ˥ k wɤ ˩ tɕ ɯ ˩ l ɑ ˩  
dʑo˧bi˧	dʑ o ˧ b i ˧  
dʑo˧dʑo˧	dʑ o ˧ dʑ o ˧  
dʑo˧hĩ˥	dʑ o ˧ h ĩ ˥  
dʑo˧hĩ˥dʑo˩	dʑ o ˧ h ĩ ˥ dʑ o ˩  
dʑo˧hĩ˥ɻæ˩	dʑ o ˧ h ĩ ˥ ɻ æ ˩  
dʑo˧hĩ˥ɻæ˩dʑo˩	dʑ o ˧ h ĩ ˥ ɻ æ ˩ dʑ o ˩  
dʑo˧hɯ˧dʑo˧ɻ̍˥	dʑ o ˧ h ɯ ˧ dʑ o ˧ ɻ̍ ˥  
dʑo˧kv̩˥mæ˩	dʑ o ˧ k v̩ ˥ m æ ˩  
dʑo˧kv̩˧tsɯ˥	dʑ o ˧ k v̩ ˧ ts ɯ ˥  
dʑo˧kv̩˧tsɯ˥mv̩˩	dʑ o ˧ k v̩ ˧ ts ɯ ˥ m v̩ ˩  
dʑo˧kv̩˩mæ˩	dʑ o ˧ k v̩ ˩ m æ ˩  
dʑo˧kwɤ˧tɕɯ˥	dʑ o ˧ k wɤ ˧ tɕ ɯ ˥  
dʑo˧tsɯ˧˥	dʑ o ˧ ts ɯ ˧˥  
dʑo˧ze˥mæ˩	dʑ o ˧ z e ˥ m æ ˩  
dʑo˧zo˩	dʑ o ˧ z o ˩  
dʑo˧ɲi˥kv̩˩tsɯ˩	dʑ o ˧ ɲ i ˥ k v̩ ˩ ts ɯ ˩  
dʑo˧ɲi˥lɑ˩	dʑ o ˧ ɲ i ˥ l ɑ ˩  
dʑo˧ɲi˥wɤ˩	dʑ o ˧ ɲ i ˥ wɤ ˩  
dʑo˧ɲi˥ze˩	dʑ o ˧ ɲ i ˥ z e ˩  
dʑo˧ɲi˥ʝi˩ze˩	dʑ o ˧ ɲ i ˥ ʝ i ˩ z e ˩  
dʑo˧ʁo˧ɲi˥	dʑ o ˧ ʁ o ˧ ɲ i ˥  
dʑo˩bi˩pi˩bi˩bi˩	dʑ o ˩ b i ˩ p i ˩ b i ˩ b i ˩  
dʑo˩hĩ˥	dʑ o ˩ h ĩ ˥  
dʑo˩hĩ˩dʑo˩	dʑ o ˩ h ĩ ˩ dʑ o ˩  
dʑo˩kv̩˥ɲi˩	dʑ o ˩ k v̩ ˥ ɲ i ˩  
dʑo˩kv̩˩dʑo˩	dʑ o ˩ k v̩ ˩ dʑ o ˩  
dʑo˩kv̩˩tsɯ˥	dʑ o ˩ k v̩ ˩ ts ɯ ˥  
dʑo˩kv̩˩tsɯ˩mv̩˩	dʑ o ˩ k v̩ ˩ ts ɯ ˩ m v̩ ˩  
dʑo˩kv̩˩ze˩	dʑ o ˩ k v̩ ˩ z e ˩  
dʑo˩lɑ˥	dʑ o ˩ l ɑ ˥  
dʑo˩mæ˩	dʑ o ˩ m æ ˩  
dʑo˩pi˩tsɯ˩	dʑ o ˩ p i ˩ ts ɯ ˩  
dʑo˩sɯ˩mæ˥	dʑ o ˩ s ɯ ˩ m æ ˥  
dʑo˩tsɯ˩mv̩˩	dʑ o ˩ ts ɯ ˩ m v̩ ˩  
dʑo˩ze˥se˩	dʑ o ˩ z e ˥ s e ˩  
dʑo˩ze˩	dʑ o ˩ z e ˩  
dʑo˩ze˩mæ˩	dʑ o ˩ z e ˩ m æ ˩  
dʑo˩ɲi˥mæ˩	dʑ o ˩ ɲ i ˥ m æ ˩  
dʑo˩ɲi˥tsɯ˩	dʑ o ˩ ɲ i ˥ ts ɯ ˩  
dʑo˩ɲi˩ho˩ze˩mæ˩	dʑ o ˩ ɲ i ˩ h o ˩ z e ˩ m æ ˩  
dʑo˩ɲi˩mæ˩	dʑ o ˩ ɲ i ˩ m æ ˩  
dʑo˩ɲi˩tsɯ˩mv̩˩	dʑ o ˩ ɲ i ˩ ts ɯ ˩ m v̩ ˩  
dʑo˩ɻ̍˥dʑo˩	dʑ o ˩ ɻ̍ ˥ dʑ o ˩  
dʑo˩ɻ̍˩	dʑ o ˩ ɻ̍ ˩  
dʑo˩ɻ̍˩dʑo˩	dʑ o ˩ ɻ̍ ˩ dʑ o ˩  
dʑɤ˥bv̩˩dʑo˩	dʑ ɤ ˥ b v̩ ˩ dʑ o ˩  
dʑɤ˧bo˩	dʑ ɤ ˧ b o ˩  
dʑɤ˧do˩bv̩˩	dʑ ɤ ˧ d o ˩ b v̩ ˩  
dʑɤ˧˥	dʑ ɤ ˧˥  
dʑɤ˩bv̩˥ɲi˩tsɯ˩	dʑ ɤ ˩ b v̩ ˥ ɲ i ˩ ts ɯ ˩  
dʑɤ˩bv̩˧	dʑ ɤ ˩ b v̩ ˧  
dʑɤ˩bv̩˧dʑo˩	dʑ ɤ ˩ b v̩ ˧ dʑ o ˩  
dʑɤ˩ho˥	dʑ ɤ ˩ h o ˥  
dʑɤ˩kʰwɤ˩	dʑ ɤ ˩ kʰ wɤ ˩  
dʑɤ˩tsʰo˧dʑo˧	dʑ ɤ ˩ tsʰ o ˧ dʑ o ˧  
dʑɤ˩tsʰo˧jo˧kv̩˧˥	dʑ ɤ ˩ tsʰ o ˧ jo ˧ k v̩ ˧˥  
dʑɤ˩tsʰo˧kv̩˧ze˥mæ˩	dʑ ɤ ˩ tsʰ o ˧ k v̩ ˧ z e ˥ m æ ˩  
dʑɤ˩ɭɯ˧	dʑ ɤ ˩ ɭ ɯ ˧  
dʑɯ	dʑ ɯ  
dʑɯ˧mi˧	dʑ ɯ ˧ m i ˧  
dʑɯ˧ɭɯ˧bv̩˧	dʑ ɯ ˧ ɭ ɯ ˧ b v̩ ˧  
dʑɯ˧ɭɯ˧hɑ˧ʈʂʰɯ˧	dʑ ɯ ˧ ɭ ɯ ˧ h ɑ ˧ ʈʂʰ ɯ ˧  
dʑɯ˧ɳɯ˧	dʑ ɯ ˧ ɳ ɯ ˧  
dʑɯ˧ʈʂʰwæ˧ho˧ʈʂʰɯ˧	dʑ ɯ ˧ ʈʂʰ wæ ˧ h o ˧ ʈʂʰ ɯ ˧  
dʑɯ˩dʑo˥	dʑ ɯ ˩ dʑ o ˥  
dʑɯ˩mɤ˩dʑɯ˩	dʑ ɯ ˩ m ɤ ˩ dʑ ɯ ˩  
dʑɯ˩nɑ˩mi˩	dʑ ɯ ˩ n ɑ ˩ m i ˩  
dʑɯ˩nɑ˩mi˩bv̩˩˥	dʑ ɯ ˩ n ɑ ˩ m i ˩ b v̩ ˩˥  
dʑɯ˩nɑ˩mi˩ʁo˥	dʑ ɯ ˩ n ɑ ˩ m i ˩ ʁ o ˥  
dʑɯ˩pʰæ˩ʈwæ˥bi˩	dʑ ɯ ˩ pʰ æ ˩ ʈ wæ ˥ b i ˩  
dʑɯ˩si˩bi˥di˩hĩ˩	dʑ ɯ ˩ s i ˩ b i ˥ d i ˩ h ĩ ˩  
dʑɯ˩sɯ˥	dʑ ɯ ˩ s ɯ ˥  
dʑɯ˩tsʰi˩qo˥mv̩˩	dʑ ɯ ˩ tsʰ i ˩ q o ˥ m v̩ ˩  
dʑɯ˩ɳɯ˥	dʑ ɯ ˩ ɳ ɯ ˥  
dʑɯ˩ʁo˩hĩ	dʑ ɯ ˩ ʁ o ˩ h ĩ  
dʑɯ˩ʁo˩kʰi˥zo˩	dʑ ɯ ˩ ʁ o ˩ kʰ i ˥ z o ˩  
dʑɯ˩ʁo˩ɳɯ˥	dʑ ɯ ˩ ʁ o ˩ ɳ ɯ ˥  
dʑɯ˩ʁo˩ʈʂʰɯ˥	dʑ ɯ ˩ ʁ o ˩ ʈʂʰ ɯ ˥  
dʑɯ˩ʁo˩ʈʂʰɯ˥dʑo˩	dʑ ɯ ˩ ʁ o ˩ ʈʂʰ ɯ ˥ dʑ o ˩  
dʑɯ˩ʈʂʰɯ˥dʑo˩	dʑ ɯ ˩ ʈʂʰ ɯ ˥ dʑ o ˩  
dʑɯ˩ʈʂʰɯ˩ʈʰɤ˩˥	dʑ ɯ ˩ ʈʂʰ ɯ ˩ ʈʰ ɤ ˩˥  
dʑɯ˩ʈʰæ˩qo˥	dʑ ɯ ˩ ʈʰ æ ˩ q o ˥  
ejo	e jo  
fv	f v  
fv̩˧kv̩˧ze˥mæ˩	f v̩ ˧ k v̩ ˧ z e ˥ m æ ˩  
fv̩˧ʂɯ˩	f v̩ ˧ ʂ ɯ ˩  
fv̩˧ʝi˧ɲi˥tsɯ˩	f v̩ ˧ ʝ i ˧ ɲ i ˥ ts ɯ ˩  
fɑ˩pje˧zo˩	f ɑ ˩ p j e ˧ z o ˩  
gi˥	g i ˥  
gi˧dʑɯ˧dʑo˧qɑ˧	g i ˧ dʑ ɯ ˧ dʑ o ˧ q ɑ ˧  
gi˧dʑɯ˧ki˧	g i ˧ dʑ ɯ ˧ k i ˧  
gi˧mɤ˧kv̩˩tsɯ˩	g i ˧ m ɤ ˧ k v̩ ˩ ts ɯ ˩  
gi˧tɕʰo˧gi˥lɑ˩	g i ˧ tɕʰ o ˧ g i ˥ l ɑ ˩  
gi˧ʁo˧to˩ɳɯ˩	g i ˧ ʁ o ˧ t o ˩ ɳ ɯ ˩  
gi˩ho˥	g i ˩ h o ˥  
gi˩ho˥pʰæ˩di˩	g i ˩ h o ˥ pʰ æ ˩ d i ˩  
gi˩mɤ˩kv̩˥tsɯ˩	g i ˩ m ɤ ˩ k v̩ ˥ ts ɯ ˩  
go˧bɤ˩bv̩˩	g o ˧ b ɤ ˩ b v̩ ˩  
go˧mi˥ʈʂʰɯ˩dʑo˩	g o ˧ m i ˥ ʈʂʰ ɯ ˩ dʑ o ˩  
go˧mi˧dʑo˩	g o ˧ m i ˧ dʑ o ˩  
go˧mi˧ʈʂʰɯ˧	g o ˧ m i ˧ ʈʂʰ ɯ ˧  
go˧˥	g o ˧˥  
go˩dʑo˩	g o ˩ dʑ o ˩  
go˩kv̩˩˥	g o ˩ k v̩ ˩˥  
go˩kwɤ˩tɕɯ˥lɑ˩	g o ˩ k wɤ ˩ tɕ ɯ ˥ l ɑ ˩  
go˩pi˩	g o ˩ p i ˩  
go˩tsɯ˥	g o ˩ ts ɯ ˥  
go˩ɲi˩	g o ˩ ɲ i ˩  
gv̩˥ɲi˩	g v̩ ˥ ɲ i ˩  
gv̩˧dv̩˧gv̩˧mi˧	g v̩ ˧ d v̩ ˧ g v̩ ˧ m i ˧  
gv̩˧gv̩˥	g v̩ ˧ g v̩ ˥  
gv̩˧hɑ̃˩	g v̩ ˧ h ɑ̃ ˩  
gv̩˧hɑ̃˩ki˩	g v̩ ˧ h ɑ̃ ˩ k i ˩  
gv̩˧kv̩˩	g v̩ ˧ k v̩ ˩  
gv̩˧kwɤ˩tɕɯ˩lɑ˩	g v̩ ˧ k wɤ ˩ tɕ ɯ ˩ l ɑ ˩  
gv̩˧mɤ˧ʝi˧	g v̩ ˧ m ɤ ˧ ʝ i ˧  
gv̩˧pi˩hĩ˩	g v̩ ˧ p i ˩ h ĩ ˩  
gv̩˧ɭɯ˧di˩	g v̩ ˧ ɭ ɯ ˧ d i ˩  
gv̩˧ɲi˥ʝi˩	g v̩ ˧ ɲ i ˥ ʝ i ˩  
gv̩˩bi˩	g v̩ ˩ b i ˩  
gv̩˩dʑo˩	g v̩ ˩ dʑ o ˩  
gv̩˩dʑɯ˩˥	g v̩ ˩ dʑ ɯ ˩˥  
gv̩˩k	g v̩ ˩ k  
gv̩˩kv̩˩hĩ˥	g v̩ ˩ k v̩ ˩ h ĩ ˥  
gv̩˩kv̩˩hĩ˥ʈʂʰɯ˩	g v̩ ˩ k v̩ ˩ h ĩ ˥ ʈʂʰ ɯ ˩  
gv̩˩kv̩˩˥	g v̩ ˩ k v̩ ˩˥  
gv̩˩kwɤ˩tɕɯ˩lɑ˩	g v̩ ˩ k wɤ ˩ tɕ ɯ ˩ l ɑ ˩  
gv̩˩kʰɯ˥	g v̩ ˩ kʰ ɯ ˥  
gv̩˩mɤ˩kv̩˥hĩ˩ɳɯ˩	g v̩ ˩ m ɤ ˩ k v̩ ˥ h ĩ ˩ ɳ ɯ ˩  
gv̩˩nɑ˩hĩ˥	g v̩ ˩ n ɑ ˩ h ĩ ˥  
gv̩˩pi˥zo˩	g v̩ ˩ p i ˥ z o ˩  
gv̩˩pʰæ˩sɯ˥	g v̩ ˩ pʰ æ ˩ s ɯ ˥  
gv̩˩pʰæ˩ʈʂʰɯ˥	g v̩ ˩ pʰ æ ˩ ʈʂʰ ɯ ˥  
gv̩˩sɯ˩dʑo˩	g v̩ ˩ s ɯ ˩ dʑ o ˩  
gv̩˩tso˩ɲi˥ze˩	g v̩ ˩ ts o ˩ ɲ i ˥ z e ˩  
gv̩˩tsɯ˩	g v̩ ˩ ts ɯ ˩  
gv̩˩ɬi˩mi˩qo˥ɳɯ˩	g v̩ ˩ ɬ i ˩ m i ˩ q o ˥ ɳ ɯ ˩  
gv̩˩ɬi˩mi˩ɳɯ˥	g v̩ ˩ ɬ i ˩ m i ˩ ɳ ɯ ˥  
gv̩˩ɲi˥ze˩	g v̩ ˩ ɲ i ˥ z e ˩  
gv̩˩ɲi˩tsɯ˩	g v̩ ˩ ɲ i ˩ ts ɯ ˩  
gv̩˩ɳɯ˥	g v̩ ˩ ɳ ɯ ˥  
gv̩˩ɳɯ˩	g v̩ ˩ ɳ ɯ ˩  
gwɤ˩	g wɤ ˩  
gwɤ˩bi˩	g wɤ ˩ b i ˩  
gwɤ˩bi˩pi˩	g wɤ ˩ b i ˩ p i ˩  
gwɤ˩bi˩zo˩kv̩˩mæ˩	g wɤ ˩ b i ˩ z o ˩ k v̩ ˩ m æ ˩  
gwɤ˩kv̩˥mæ˩	g wɤ ˩ k v̩ ˥ m æ ˩  
gwɤ˩kʰi˥ɲi˩	g wɤ ˩ kʰ i ˥ ɲ i ˩  
gwɤ˩˥	g wɤ ˩˥  
gæ˩pʰæ˧dʑo˥	g æ ˩ pʰ æ ˧ dʑ o ˥  
gæ˩pʰæ˧pi˧	g æ ˩ pʰ æ ˧ p i ˧  
gɤ	g ɤ  
gɤ˥	g ɤ ˥  
gɤ˥ti˩ho˩ze˩	g ɤ ˥ t i ˩ h o ˩ z e ˩  
gɤ˧bi˧dʑo˩	g ɤ ˧ b i ˧ dʑ o ˩  
gɤ˧bi˧no˧˥	g ɤ ˧ b i ˧ n o ˧˥  
gɤ˧lɑ˧ʑi˩di˩	g ɤ ˧ l ɑ ˧ ʑ i ˩ d i ˩  
gɤ˧lɑ˧ʑi˩qo˩	g ɤ ˧ l ɑ ˧ ʑ i ˩ q o ˩  
gɤ˧lɑ˧ʑi˩qo˩sɯ˩	g ɤ ˧ l ɑ ˧ ʑ i ˩ q o ˩ s ɯ ˩  
gɤ˩do˧	g ɤ ˩ d o ˧  
gɤ˩dzɤ˥ɳɯ˩	g ɤ ˩ dz ɤ ˥ ɳ ɯ ˩  
gɤ˩dzɤ˧	g ɤ ˩ dz ɤ ˧  
gɤ˩gɤ˧˥	g ɤ ˩ g ɤ ˧˥  
gɤ˩hĩ˧	g ɤ ˩ h ĩ ˧  
gɤ˩mɤ˧ʈʂʰwæ˧	g ɤ ˩ m ɤ ˧ ʈʂʰ wæ ˧  
gɤ˩pɤ˧dʑo˩	g ɤ ˩ p ɤ ˧ dʑ o ˩  
gɤ˩pɤ˧kwɤ˩tɕɯ˩lɑ˩	g ɤ ˩ p ɤ ˧ k wɤ ˩ tɕ ɯ ˩ l ɑ ˩  
gɤ˩qwɤ˧ki˧	g ɤ ˩ q wɤ ˧ k i ˧  
gɤ˩se˩	g ɤ ˩ s e ˩  
gɤ˩tse˩	g ɤ ˩ ts e ˩  
gɤ˩tso˧	g ɤ ˩ ts o ˧  
gɤ˩tɕo˧ɻ̍˩	g ɤ ˩ tɕ o ˧ ɻ̍ ˩  
gɤ˩tɕʰɯ˧ni˧˥	g ɤ ˩ tɕʰ ɯ ˧ n i ˧˥  
gɤ˩tʰv̩˧	g ɤ ˩ tʰ v̩ ˧  
gɤ˩ʁɑ˧lɑ˧	g ɤ ˩ ʁ ɑ ˧ l ɑ ˧  
gɤ˩ʈi˧kwɤ˩tɕɯ˩lɑ˩	g ɤ ˩ ʈ i ˧ k wɤ ˩ tɕ ɯ ˩ l ɑ ˩  
gɤ˩ʈi˧tʰɑ˧ho˥	g ɤ ˩ ʈ i ˧ tʰ ɑ ˧ h o ˥  
gɤ˩ʈi˧ze˩tsɯ˩	g ɤ ˩ ʈ i ˧ z e ˩ ts ɯ ˩  
gɤ˩ʈʂwɤ˧kwɤ˧tɕɯ˥	g ɤ ˩ ʈʂ wɤ ˧ k wɤ ˧ tɕ ɯ ˥  
gɤ˩ʈʂʰwæ˧dʑo˥	g ɤ ˩ ʈʂʰ wæ ˧ dʑ o ˥  
gɤ˩ʈʂʰæ˧˥	g ɤ ˩ ʈʂʰ æ ˧˥  
gɤ˩ʈʂʰɯ˧qo˧	g ɤ ˩ ʈʂʰ ɯ ˧ q o ˧  
gɤ˩ʑi˥kv̩˩ze˩	g ɤ ˩ ʑ i ˥ k v̩ ˩ z e ˩  
gɤ˩ʑi˧lɑ˧	g ɤ ˩ ʑ i ˧ l ɑ ˧  
gɤ˩ʑi˩kv̩˩	g ɤ ˩ ʑ i ˩ k v̩ ˩  
gɤ˩ʑi˩kv̩˩ze˩	g ɤ ˩ ʑ i ˩ k v̩ ˩ z e ˩  
gɯ˧ɳɯ˧	g ɯ ˧ ɳ ɯ ˧  
gɯ˧ʐwɤ˧zo˧kv̩˧˥	g ɯ ˧ ʐ wɤ ˧ z o ˧ k v̩ ˧˥  
gɯ˩ɲi˥ho˩	g ɯ ˩ ɲ i ˥ h o ˩  
gɯ˩ɲi˥wɤ˩	g ɯ ˩ ɲ i ˥ wɤ ˩  
hhhh	h h h h  
hhhɑ̃	h h h ɑ̃  
hi˩mi˩po˥ɳɯ˩	h i ˩ m i ˩ p o ˥ ɳ ɯ ˩  
hi˩nɑ˧mi˧ʈʂʰɯ˧	h i ˩ n ɑ ˧ m i ˧ ʈʂʰ ɯ ˧  
hi˩ʈʂʰɯ˥	h i ˩ ʈʂʰ ɯ ˥  
hĩ	h ĩ  
hĩ˥	h ĩ ˥  
hĩ˧b	h ĩ ˧ b  
hĩ˧ki˧ki˩hĩ˩	h ĩ ˧ k i ˧ k i ˩ h ĩ ˩  
hĩ˧mmm…	h ĩ ˧ mmm…  
hĩ˧mo˥hĩ˩	h ĩ ˧ m o ˥ h ĩ ˩  
hĩ˧mo˥hĩ˩ki˩	h ĩ ˧ m o ˥ h ĩ ˩ k i ˩  
hĩ˧mo˥hĩ˩ɳɯ˩	h ĩ ˧ m o ˥ h ĩ ˩ ɳ ɯ ˩  
hĩ˧mo˥ɻæ˩dʑo˩	h ĩ ˧ m o ˥ ɻ æ ˩ dʑ o ˩  
hĩ˧mo˥ɻæ˩ki˩	h ĩ ˧ m o ˥ ɻ æ ˩ k i ˩  
hĩ˧mo˩	h ĩ ˧ m o ˩  
hĩ˧mo˩tɕɯ˩di˩ɲi˩	h ĩ ˧ m o ˩ tɕ ɯ ˩ d i ˩ ɲ i ˩  
hĩ˧qʰæ˧po˩ɳɯ˩	h ĩ ˧ qʰ æ ˧ p o ˩ ɳ ɯ ˩  
hĩ˧se˧di˧˥	h ĩ ˧ s e ˧ d i ˧˥  
hĩ˧tsɯ˥	h ĩ ˧ ts ɯ ˥  
hĩ˧tɕʰɯ˧	h ĩ ˧ tɕʰ ɯ ˧  
hĩ˧v̩˧	h ĩ ˧ v̩ ˧  
hĩ˧zɯ˧zɯ˥	h ĩ ˧ z ɯ ˧ z ɯ ˥  
hĩ˧zɯ˧zɯ˥ʈʂʰɯ˩dʑo˩	h ĩ ˧ z ɯ ˧ z ɯ ˥ ʈʂʰ ɯ ˩ dʑ o ˩  
hĩ˧ɲi˩tʰo˩	h ĩ ˧ ɲ i ˩ tʰ o ˩  
hĩ˧ɳɯ˩dʑo˩	h ĩ ˧ ɳ ɯ ˩ dʑ o ˩  
hĩ˧ɻæ˥ɳɯ˩	h ĩ ˧ ɻ æ ˥ ɳ ɯ ˩  
hĩ˧ɻæ˧qɑ˥	h ĩ ˧ ɻ æ ˧ q ɑ ˥  
hĩ˧ʈʂɤ˧	h ĩ ˧ ʈʂ ɤ ˧  
hĩ˩tsʰɯ˩ni˩	h ĩ ˩ tsʰ ɯ ˩ n i ˩  
hĩ˩ʈʂʰɯ˩dʑo˩	h ĩ ˩ ʈʂʰ ɯ ˩ dʑ o ˩  
hmmm…	h mmm…  
ho˧di˧bv̩˧	h o ˧ d i ˧ b v̩ ˧  
ho˧di˧dʑo˥	h o ˧ d i ˧ dʑ o ˥  
ho˧di˧ni˧fv̩˥pi˩	h o ˧ d i ˧ n i ˧ f v̩ ˥ p i ˩  
ho˧di˧pi˧	h o ˧ d i ˧ p i ˧  
ho˧di˧ɕi˧ʈʂʰwæ˧pi˧	h o ˧ d i ˧ ɕ i ˧ ʈʂʰ wæ ˧ p i ˧  
ho˧di˧ɳɯ˧	h o ˧ d i ˧ ɳ ɯ ˧  
ho˧di˧ʂe˧ʈʂe˩pi˩	h o ˧ d i ˧ ʂ e ˧ ʈʂ e ˩ p i ˩  
ho˧zo˥	h o ˧ z o ˥  
ho˩bi˩bi˩	h o ˩ b i ˩ b i ˩  
ho˩hĩ˥	h o ˩ h ĩ ˥  
ho˩tʰɑ˩˥	h o ˩ tʰ ɑ ˩˥  
ho˩ɲi˩	h o ˩ ɲ i ˩  
ho˩˥	h o ˩˥  
hõ	h õ  
hõ˧kv̩˥	h õ ˧ k v̩ ˥  
hõ˧pi˧	h õ ˧ p i ˧  
hõ˧ɬi˧mi˧kʰɤ˧ʂɯ˧	h õ ˧ ɬ i ˧ m i ˧ kʰ ɤ ˧ ʂ ɯ ˧  
hõ˧ɬi˧mi˧qo˩	h õ ˧ ɬ i ˧ m i ˧ q o ˩  
hõ˧ɭɯ˥	h õ ˧ ɭ ɯ ˥  
hõ˩	h õ ˩  
hõ˩bi˥	h õ ˩ b i ˥  
hõ˩tsʰi˧kʰv̩˥hĩ˩	h õ ˩ tsʰ i ˧ kʰ v̩ ˥ h ĩ ˩  
hu˧mi˥	h u ˧ m i ˥  
hu˧mi˧	h u ˧ m i ˧  
hṽ˧	h ṽ ˧  
hṽ˩ɖʐæ˩ɻæ˥zo˩	h ṽ ˩ ɖʐ æ ˩ ɻ æ ˥ z o ˩  
hṽ̩	h ṽ̩  
hṽ̩˧nɑ˩ni˩gv̩˩	h ṽ̩ ˧ n ɑ ˩ n i ˩ g v̩ ˩  
hṽ̩˩hĩ˩qo˥	h ṽ̩ ˩ h ĩ ˩ q o ˥  
hw	h w  
hwæ˥dʑo˩	h wæ ˥ dʑ o ˩  
hwæ˥kv̩˩ze˩mæ˩	h wæ ˥ k v̩ ˩ z e ˩ m æ ˩  
hwæ˧kv̩˧ze˥mæ˩	h wæ ˧ k v̩ ˧ z e ˥ m æ ˩  
hwæ˧mɤ˧zo˧	h wæ ˧ m ɤ ˧ z o ˧  
hwæ˩kʰɯ˩bi˩	h wæ ˩ kʰ ɯ ˩ b i ˩  
hwæ˩ze˩	h wæ ˩ z e ˩  
hwɤ˥	h wɤ ˥  
hwɤ˧li˥	h wɤ ˧ l i ˥  
hwɤ˧li˧tʰv̩˥	h wɤ ˧ l i ˧ tʰ v̩ ˥  
hwɤ˧tɕʰi˥ʁo˩bv̩˩	h wɤ ˧ tɕʰ i ˥ ʁ o ˩ b v̩ ˩  
hwɤ˩	h wɤ ˩  
hwɤ˩dʑɯ˩qo˥	h wɤ ˩ dʑ ɯ ˩ q o ˥  
hwɤ˩hĩ˩	h wɤ ˩ h ĩ ˩  
hwɤ˩kv̩˩mæ˩	h wɤ ˩ k v̩ ˩ m æ ˩  
hwɤ˩kv̩˩ze˩mæ˩	h wɤ ˩ k v̩ ˩ z e ˩ m æ ˩  
hwɤ˩tsʰɯ˩	h wɤ ˩ tsʰ ɯ ˩  
hwɤ˩tsʰɯ˩pi˩	h wɤ ˩ tsʰ ɯ ˩ p i ˩  
hwɤ˩ɲi˩	h wɤ ˩ ɲ i ˩  
hæ˧di˩dʑo˩	h æ ˧ d i ˩ dʑ o ˩  
hæ˧ni˩zo˩	h æ ˧ n i ˩ z o ˩  
hæ˧pɑ˩	h æ ˧ p ɑ ˩  
hæ˧ʈʂʰɯ˧dʑo˩	h æ ˧ ʈʂʰ ɯ ˧ dʑ o ˩  
hæ̃˧do˧	h æ̃ ˧ d o ˧  
hæ̃˧do˧qo˧	h æ̃ ˧ d o ˧ q o ˧  
hæ̃˧kʰɤ˧	h æ̃ ˧ kʰ ɤ ˧  
hæ̃˧qʰv̩˥dʑo˩	h æ̃ ˧ qʰ v̩ ˥ dʑ o ˩  
hæ̃˧ʈʂʰɯ˧	h æ̃ ˧ ʈʂʰ ɯ ˧  
hæ̃˧˥	h æ̃ ˧˥  
hæ̃˩bɑ˥lɑ˩	h æ̃ ˩ b ɑ ˥ l ɑ ˩  
hæ̃˩bɑ˥lɑ˩bɑ˩lɑ˩	h æ̃ ˩ b ɑ ˥ l ɑ ˩ b ɑ ˩ l ɑ ˩  
hæ̃˩dʑo˩tsɯ˩	h æ̃ ˩ dʑ o ˩ ts ɯ ˩  
hæ̃˩kv̩˥ze˩	h æ̃ ˩ k v̩ ˥ z e ˩  
hæ̃˩lo˩pv̩˩˥	h æ̃ ˩ l o ˩ p v̩ ˩˥  
hæ̃˩ni˩gv̩˩ɲi˥ze˩mæ˩	h æ̃ ˩ n i ˩ g v̩ ˩ ɲ i ˥ z e ˩ m æ ˩  
hɑ˧ɭɯ˧	h ɑ ˧ ɭ ɯ ˧  
hɑ˧ʈʂʰɯ˧dʑo˩	h ɑ ˧ ʈʂʰ ɯ ˧ dʑ o ˩  
hɑ˧ʐwɤ˩dʑo˩	h ɑ ˧ ʐ wɤ ˩ dʑ o ˩  
hɑ˧ʐwɤ˩kv̩˩tsɯ˩	h ɑ ˧ ʐ wɤ ˩ k v̩ ˩ ts ɯ ˩  
hɑ˧ʐwɤ˩kʰɯ˩	h ɑ ˧ ʐ wɤ ˩ kʰ ɯ ˩  
hɑ˧ʐwɤ˩zo˩	h ɑ ˧ ʐ wɤ ˩ z o ˩  
hɑ˩	h ɑ ˩  
hɑ˩dʑo˩	h ɑ ˩ dʑ o ˩  
hɑ̃˧tsɯ˥	h ɑ̃ ˧ ts ɯ ˥  
hɑ̃˧ʝi˧kʰɯ˩	h ɑ̃ ˧ ʝ i ˧ kʰ ɯ ˩  
hɑ̃˩ɖʐɯ˩ze˥	h ɑ̃ ˩ ɖʐ ɯ ˩ z e ˥  
hɤ˥	h ɤ ˥  
hɤ˥hĩ˩ɳɯ˩	h ɤ ˥ h ĩ ˩ ɳ ɯ ˩  
hɤ˥mɤ˩kv̩˩	h ɤ ˥ m ɤ ˩ k v̩ ˩  
hɤ˧dʑo˥	h ɤ ˧ dʑ o ˥  
hɤ˧ɲi˥	h ɤ ˧ ɲ i ˥  
hɤ˩hĩ˩dʑo˩	h ɤ ˩ h ĩ ˩ dʑ o ˩  
hɤ˩hĩ˩ki˥	h ɤ ˩ h ĩ ˩ k i ˥  
hɤ˩hĩ˩ɻæ˥	h ɤ ˩ h ĩ ˩ ɻ æ ˥  
hɤ˩hĩ˩ʈʂʰɯ˩tɕi˥ɳɯ˩	h ɤ ˩ h ĩ ˩ ʈʂʰ ɯ ˩ tɕ i ˥ ɳ ɯ ˩  
hɤ˩tsɯ˩˥	h ɤ ˩ ts ɯ ˩˥  
hɤ˩ɲi˥	h ɤ ˩ ɲ i ˥  
hɤ˩ʂe˩ʂe˩hĩ˥	h ɤ ˩ ʂ e ˩ ʂ e ˩ h ĩ ˥  
hɤ˩ʈʂɤ˩	h ɤ ˩ ʈʂ ɤ ˩  
hɤ˩ʈʂɤ˩bi˩˥	h ɤ ˩ ʈʂ ɤ ˩ b i ˩˥  
hɯ˧kwɤ˧tɕɯ˥lɑ˩	h ɯ ˧ k wɤ ˧ tɕ ɯ ˥ l ɑ ˩  
hɯ˧ze˧tsɯ˧˥	h ɯ ˧ z e ˧ ts ɯ ˧˥  
hɯ˧ɲi˥	h ɯ ˧ ɲ i ˥  
hɯ˧ɲi˥tsɯ˩mæ˩	h ɯ ˧ ɲ i ˥ ts ɯ ˩ m æ ˩  
hɯ˧ɲi˥tsɯ˩mɤ˩tsɯ˩	h ɯ ˧ ɲ i ˥ ts ɯ ˩ m ɤ ˩ ts ɯ ˩  
hɯ˧ɲi˥wɤ˩	h ɯ ˧ ɲ i ˥ wɤ ˩  
hɯ˩kwɤ˩tɕɯ˥lɑ˩	h ɯ ˩ k wɤ ˩ tɕ ɯ ˥ l ɑ ˩  
hɯ˩mɤ˩hɯ˩	h ɯ ˩ m ɤ ˩ h ɯ ˩  
hɯ˩tsɯ˩	h ɯ ˩ ts ɯ ˩  
hɯ˩ɲi˥tsɯ˩	h ɯ ˩ ɲ i ˥ ts ɯ ˩  
hɯ˩ɲi˩ze˩	h ɯ ˩ ɲ i ˩ z e ˩  
hɯ˩˥	h ɯ ˩˥  
ĩ	ĩ  
j	j  
je˩tʰi˧ʁæ˩bæ˩	j e ˩ tʰ i ˧ ʁ æ ˩ b æ ˩  
jo˧do˧mv̩˩	jo ˧ d o ˧ m v̩ ˩  
jo˧gv̩˧	jo ˧ g v̩ ˧  
jo˧gv̩˧ŋv̩˧ɭɯ˧ʈʰæ˧qo˩	jo ˧ g v̩ ˧ ŋ v̩ ˧ ɭ ɯ ˧ ʈʰ æ ˧ q o ˩  
jo˧kv̩˧mɤ˥kv̩˩	jo ˧ k v̩ ˧ m ɤ ˥ k v̩ ˩  
jo˧kv̩˧˥	jo ˧ k v̩ ˧˥  
jo˧lo˥dʑo˩pi˩	jo ˧ l o ˥ dʑ o ˩ p i ˩  
jo˧ʝi˧ɻ̍˥	jo ˧ ʝ i ˧ ɻ̍ ˥  
jo˩kv̩˥mæ˩	jo ˩ k v̩ ˥ m æ ˩  
jo˩kv̩˩mæ˩	jo ˩ k v̩ ˩ m æ ˩  
jo˩lo˩˥	jo ˩ l o ˩˥  
jæ˩ʂæ˧	jæ ˩ ʂ æ ˧  
jɤhɑ	jɤ h ɑ  
jɤw˧	jɤ w ˧  
jɤ˧ŋɤ˧dʑo˥	jɤ ˧ ŋ ɤ ˧ dʑ o ˥  
jɤ˧ŋɤ˧dʑo˧	jɤ ˧ ŋ ɤ ˧ dʑ o ˧  
jɤ˧ŋɤ˧pi˧	jɤ ˧ ŋ ɤ ˧ p i ˧  
jɤ˩ke˧	jɤ ˩ k e ˧  
jɤ˩tʰi˧ʁæ˩bæ˩	jɤ ˩ tʰ i ˧ ʁ æ ˩ b æ ˩  
ke	k e  
ki˥	k i ˥  
ki˥kv̩˩mæ˩	k i ˥ k v̩ ˩ m æ ˩  
ki˧bi˧ze˧	k i ˧ b i ˧ z e ˧  
ki˧dʑo˥	k i ˧ dʑ o ˥  
ki˧hĩ˧	k i ˧ h ĩ ˧  
ki˧ki˩	k i ˧ k i ˩  
ki˧mo˧	k i ˧ m o ˧  
ki˧mɤ˧bi˧	k i ˧ m ɤ ˧ b i ˧  
ki˧mɤ˧bi˧pi˧zo˥	k i ˧ m ɤ ˧ b i ˧ p i ˧ z o ˥  
ki˧mɤ˧kv̩˧ze˥	k i ˧ m ɤ ˧ k v̩ ˧ z e ˥  
ki˧mɤ˧kv̩˧˥	k i ˧ m ɤ ˧ k v̩ ˧˥  
ki˧mɤ˧ʝi˧	k i ˧ m ɤ ˧ ʝ i ˧  
ki˧tsɤ˧ɲi˩	k i ˧ ts ɤ ˧ ɲ i ˩  
ki˧tʰɑ˧kv̩˥mæ˩	k i ˧ tʰ ɑ ˧ k v̩ ˥ m æ ˩  
ki˧ze˥	k i ˧ z e ˥  
ki˧zo˧pi˧ɲi˥wɤ˩	k i ˧ z o ˧ p i ˧ ɲ i ˥ wɤ ˩  
ki˧zo˩kv̩˩ɲi˩ze˩	k i ˧ z o ˩ k v̩ ˩ ɲ i ˩ z e ˩  
ki˧ɲi˥kv̩˩tsɯ˩	k i ˧ ɲ i ˥ k v̩ ˩ ts ɯ ˩  
ki˧ɲi˥tsɯ˩	k i ˧ ɲ i ˥ ts ɯ ˩  
ki˧ɻ̍˩mo˩	k i ˧ ɻ̍ ˩ m o ˩  
ki˩bi˩ze˩	k i ˩ b i ˩ z e ˩  
ki˩di˩	k i ˩ d i ˩  
ki˩kv̩˩	k i ˩ k v̩ ˩  
ki˩kv̩˩mæ˩	k i ˩ k v̩ ˩ m æ ˩  
ki˩kv̩˩ze˥mæ˩	k i ˩ k v̩ ˩ z e ˥ m æ ˩  
ki˩mi˥	k i ˩ m i ˥  
ki˩ni˩zo˩	k i ˩ n i ˩ z o ˩  
ki˩tso˥ɲi˩	k i ˩ ts o ˥ ɲ i ˩  
ki˩tso˥ɲi˩ze˩	k i ˩ ts o ˥ ɲ i ˩ z e ˩  
ki˩ɲi˩mv̩˩	k i ˩ ɲ i ˩ m v̩ ˩  
ki˩ɲi˩skv̩˩tsɯ˩	k i ˩ ɲ i ˩ s k v̩ ˩ ts ɯ ˩  
ki˩ɲi˩tsɯ˩	k i ˩ ɲ i ˩ ts ɯ ˩  
ki˩ɳɯ˩	k i ˩ ɳ ɯ ˩  
ki˩ɻ̍˩	k i ˩ ɻ̍ ˩  
kjɤ˩tjɤ˧ljɤ˧	k jɤ ˩ t jɤ ˧ l jɤ ˧  
ko˧ʈʂʰɯ˧	k o ˧ ʈʂʰ ɯ ˧  
ko˩	k o ˩  
kv̩˥mæ˩	k v̩ ˥ m æ ˩  
kv̩˥tsɯ˩	k v̩ ˥ ts ɯ ˩  
kv̩˥ɲi˩	k v̩ ˥ ɲ i ˩  
kv̩˧dʑɯ˧pi˥kv̩˩	k v̩ ˧ dʑ ɯ ˧ p i ˥ k v̩ ˩  
kv̩˧dʑɯ˧pi˥kv̩˩mæ˩	k v̩ ˧ dʑ ɯ ˧ p i ˥ k v̩ ˩ m æ ˩  
kv̩˧dʑɯ˧qo˥	k v̩ ˧ dʑ ɯ ˧ q o ˥  
kv̩˧dʑɯ˧ʈʂʰɯ˥	k v̩ ˧ dʑ ɯ ˧ ʈʂʰ ɯ ˥  
kv̩˧dʑɯ˧˥	k v̩ ˧ dʑ ɯ ˧˥  
kv̩˧hĩ˥	k v̩ ˧ h ĩ ˥  
kv̩˧pi˥	k v̩ ˧ p i ˥  
kv̩˧sɑ˥	k v̩ ˧ s ɑ ˥  
kv̩˧tsɯ˥	k v̩ ˧ ts ɯ ˥  
kv̩˧tsʰɑ˥	k v̩ ˧ tsʰ ɑ ˥  
kv̩˧tsʰɑ˥ki˩	k v̩ ˧ tsʰ ɑ ˥ k i ˩  
kv̩˧zo˥	k v̩ ˧ z o ˥  
kv̩˧ɲi˥	k v̩ ˧ ɲ i ˥  
kv̩˧ʈʂʰɯ˧	k v̩ ˧ ʈʂʰ ɯ ˧  
kv̩˧ʝi˥	k v̩ ˧ ʝ i ˥  
kv̩˧˥	k v̩ ˧˥  
kv̩˩hĩ˩	k v̩ ˩ h ĩ ˩  
kv̩˩pi˩	k v̩ ˩ p i ˩  
kv̩˩ze˩	k v̩ ˩ z e ˩  
kwæ˧tsɯ˧	k wæ ˧ ts ɯ ˧  
kwæ˧tɕʰæ˩ɲi˩	k wæ ˧ tɕʰ æ ˩ ɲ i ˩  
kwɤ˥kv̩˩	k wɤ ˥ k v̩ ˩  
kwɤ˧pɤ˧	k wɤ ˧ p ɤ ˧  
kwɤ˧tɕɯ˥lɑ˥	k wɤ ˧ tɕ ɯ ˥ l ɑ ˥  
kwɤ˧wɤ˧	k wɤ ˧ wɤ ˧  
kwɤ˧˥	k wɤ ˧˥  
kwɤ˩bi˩kv̩˩mæ˩	k wɤ ˩ b i ˩ k v̩ ˩ m æ ˩  
kwɤ˩pi˧	k wɤ ˩ p i ˧  
kwɤ˩zo˩	k wɤ ˩ z o ˩  
kɤ˧mi˧	k ɤ ˧ m i ˧  
kɤ˧mv̩˧ki˥ɳɯ˩	k ɤ ˧ m v̩ ˧ k i ˥ ɳ ɯ ˩  
kɤ˧mv̩˧lɑ˥	k ɤ ˧ m v̩ ˧ l ɑ ˥  
kɤ˧mv̩˧ʈʂʰɯ˥dʑo˩	k ɤ ˧ m v̩ ˧ ʈʂʰ ɯ ˥ dʑ o ˩  
kɤ˧mv̩˧˥	k ɤ ˧ m v̩ ˧˥  
kɤ˧wɤ˧	k ɤ ˧ wɤ ˧  
kɤ˧zo˧	k ɤ ˧ z o ˧  
kɤ˧ʈʂɯ˥	k ɤ ˧ ʈʂ ɯ ˥  
kɤ˧ʈʂɯ˩	k ɤ ˧ ʈʂ ɯ ˩  
kɤ˧˥tʰɑ˩	k ɤ ˧˥ tʰ ɑ ˩  
kɤ˩ɲi˥	k ɤ ˩ ɲ i ˥  
kʰe˧mɤ˥ʝi˩	kʰ e ˧ m ɤ ˥ ʝ i ˩  
kʰi˥	kʰ i ˥  
kʰi˧bi˥	kʰ i ˧ b i ˥  
kʰi˧bɤ˧ʁo˧	kʰ i ˧ b ɤ ˧ ʁ o ˧  
kʰi˧dʑo˥	kʰ i ˧ dʑ o ˥  
kʰi˧mi˧tʰv̩˧	kʰ i ˧ m i ˧ tʰ v̩ ˧  
kʰi˧ɲi˥pi˩tsɯ˩	kʰ i ˧ ɲ i ˥ p i ˩ ts ɯ ˩  
kʰi˧ɲi˥tsɯ˩	kʰ i ˧ ɲ i ˥ ts ɯ ˩  
kʰi˧ʁo˧tʰo˥	kʰ i ˧ ʁ o ˧ tʰ o ˥  
kʰi˩	kʰ i ˩  
kʰi˩dʑo˩	kʰ i ˩ dʑ o ˩  
kʰi˩ni˩zo˩	kʰ i ˩ n i ˩ z o ˩  
kʰv	kʰ v  
kʰv̩˧lɑ˩	kʰ v̩ ˧ l ɑ ˩  
kʰv̩˧mo˥ni˩zo˩	kʰ v̩ ˧ m o ˥ n i ˩ z o ˩  
kʰv̩˧mo˥njɤ˩ɭɯ˩ni˩zo˩	kʰ v̩ ˧ m o ˥ n jɤ ˩ ɭ ɯ ˩ n i ˩ z o ˩  
kʰv̩˧mæ˥	kʰ v̩ ˧ m æ ˥  
kʰv̩˧qʰwɤ˧	kʰ v̩ ˧ qʰ wɤ ˧  
kʰv̩˧tʰɑ˧hõ˧	kʰ v̩ ˧ tʰ ɑ ˧ h õ ˧  
kʰv̩˧ɲi˥	kʰ v̩ ˧ ɲ i ˥  
kʰv̩˧ʂæ˧	kʰ v̩ ˧ ʂ æ ˧  
kʰv̩˧ʂɯ˥njɤ˩ʂɯ˩	kʰ v̩ ˧ ʂ ɯ ˥ n jɤ ˩ ʂ ɯ ˩  
kʰv̩˧ʂɯ˥se˩	kʰ v̩ ˧ ʂ ɯ ˥ s e ˩  
kʰv̩˧ʂɯ˥se˩ɳɯ˩	kʰ v̩ ˧ ʂ ɯ ˥ s e ˩ ɳ ɯ ˩  
kʰv̩˧ʂɯ˥ʁo˩to˩	kʰ v̩ ˧ ʂ ɯ ˥ ʁ o ˩ t o ˩  
kʰv̩˧ʈʂʰɯ˥	kʰ v̩ ˧ ʈʂʰ ɯ ˥  
kʰv̩˧ʈʂʰɯ˧dʑo˩	kʰ v̩ ˧ ʈʂʰ ɯ ˧ dʑ o ˩  
kʰv̩˧˥	kʰ v̩ ˧˥  
kʰv̩˩dʑo˩	kʰ v̩ ˩ dʑ o ˩  
kʰv̩˩mi˩dʑo˥	kʰ v̩ ˩ m i ˩ dʑ o ˥  
kʰv̩˩mi˩gi˩ɳɯ˥	kʰ v̩ ˩ m i ˩ g i ˩ ɳ ɯ ˥  
kʰv̩˩mi˩zɯ˩zɯ˥	kʰ v̩ ˩ m i ˩ z ɯ ˩ z ɯ ˥  
kʰv̩˩mi˩zɯ˩zɯ˩	kʰ v̩ ˩ m i ˩ z ɯ ˩ z ɯ ˩  
kʰv̩˩mi˩ʈʂʰɯ˩ɻæ˥	kʰ v̩ ˩ m i ˩ ʈʂʰ ɯ ˩ ɻ æ ˥  
kʰw	kʰ w  
kʰwɤ˧pʰv̩˧mo˧ʈʂʰɯ˥dʑo˩	kʰ wɤ ˧ pʰ v̩ ˧ m o ˧ ʈʂʰ ɯ ˥ dʑ o ˩  
kʰwɤ˧pʰv̩˧pi˧zo˥	kʰ wɤ ˧ pʰ v̩ ˧ p i ˧ z o ˥  
kʰɤ˧ʂɯ˧dʑo˧	kʰ ɤ ˧ ʂ ɯ ˧ dʑ o ˧  
kʰɤ˧ʂɯ˧dʑo˩	kʰ ɤ ˧ ʂ ɯ ˧ dʑ o ˩  
kʰɤ˧ʂɯ˧kv̩˩ze˩	kʰ ɤ ˧ ʂ ɯ ˧ k v̩ ˩ z e ˩  
kʰɯ˥dʑo˩	kʰ ɯ ˥ dʑ o ˩  
kʰɯ˧kv̩˥tsɯ˩	kʰ ɯ ˧ k v̩ ˥ ts ɯ ˩  
kʰɯ˧kʰɯ˥	kʰ ɯ ˧ kʰ ɯ ˥  
kʰɯ˧le˧po˧tsʰɯ˧ɲi˥tsɯ˩	kʰ ɯ ˧ l e ˧ p o ˧ tsʰ ɯ ˧ ɲ i ˥ ts ɯ ˩  
kʰɯ˧tsʰɤ˧ki˥	kʰ ɯ ˧ tsʰ ɤ ˧ k i ˥  
kʰɯ˩di˩	kʰ ɯ ˩ d i ˩  
kʰɯ˩dʑo˩	kʰ ɯ ˩ dʑ o ˩  
kʰɯ˩kv̩˩ze˩	kʰ ɯ ˩ k v̩ ˩ z e ˩  
kʰɯ˩kv̩˩ze˩pi˩kv̩˩	kʰ ɯ ˩ k v̩ ˩ z e ˩ p i ˩ k v̩ ˩  
kʰɯ˩kʰɯ˩ɲi˥	kʰ ɯ ˩ kʰ ɯ ˩ ɲ i ˥  
kʰɯ˩kʰɯ˩ɻ̍˩	kʰ ɯ ˩ kʰ ɯ ˩ ɻ̍ ˩  
kʰɯ˩ze˩pʰæ˩di˩	kʰ ɯ ˩ z e ˩ pʰ æ ˩ d i ˩  
kʰɯ˩zo˩	kʰ ɯ ˩ z o ˩  
kʰɯ˩zo˩ho˥ɲi˩ze˩	kʰ ɯ ˩ z o ˩ h o ˥ ɲ i ˩ z e ˩  
kʰɯ˩ʈɯ˩	kʰ ɯ ˩ ʈ ɯ ˩  
le˥dʑo˩	l e ˥ dʑ o ˩  
le˥po˩bi˩	l e ˥ p o ˩ b i ˩  
le˥po˩jo˩kv̩˩mæ˩	l e ˥ p o ˩ jo ˩ k v̩ ˩ m æ ˩  
le˥po˩jo˩kv̩˩tsɯ˩	l e ˥ p o ˩ jo ˩ k v̩ ˩ ts ɯ ˩  
le˥wo˩tsʰɯ˩ze˩	l e ˥ w o ˩ tsʰ ɯ ˩ z e ˩  
le˥wo˩tsʰɯ˩ɲi˩	l e ˥ w o ˩ tsʰ ɯ ˩ ɲ i ˩  
le˧bi˧se˩kwɤ˩tɕɯ˩lɑ˩	l e ˧ b i ˧ s e ˩ k wɤ ˩ tɕ ɯ ˩ l ɑ ˩  
le˧bi˩kv̩˩mæ˩	l e ˧ b i ˩ k v̩ ˩ m æ ˩  
le˧bi˩kv̩˩ze˩	l e ˧ b i ˩ k v̩ ˩ z e ˩  
le˧bi˩zo˩ho˩	l e ˧ b i ˩ z o ˩ h o ˩  
le˧bi˩zo˩kv̩˩tsɯ˩	l e ˧ b i ˩ z o ˩ k v̩ ˩ ts ɯ ˩  
le˧bo˧	l e ˧ b o ˧  
le˧bo˧se˩	l e ˧ b o ˧ s e ˩  
le˧bv̩˧bv̩˧	l e ˧ b v̩ ˧ b v̩ ˧  
le˧bv̩˩	l e ˧ b v̩ ˩  
le˧bæ˧	l e ˧ b æ ˧  
le˧bæ˧zo˥	l e ˧ b æ ˧ z o ˥  
le˧bæ˧zo˩	l e ˧ b æ ˧ z o ˩  
le˧dv̩˩zo˩	l e ˧ d v̩ ˩ z o ˩  
le˧dv̩˩ɲi˩kv̩˩tsɯ˩mv̩˩	l e ˧ d v̩ ˩ ɲ i ˩ k v̩ ˩ ts ɯ ˩ m v̩ ˩  
le˧dzɯ	l e ˧ dz ɯ  
le˧dzɯ˥dʑo˩	l e ˧ dz ɯ ˥ dʑ o ˩  
le˧dzɯ˥kwɤ˩tɕɯ˩lɑ˩	l e ˧ dz ɯ ˥ k wɤ ˩ tɕ ɯ ˩ l ɑ ˩  
le˧dzɯ˥kʰɯ˩	l e ˧ dz ɯ ˥ kʰ ɯ ˩  
le˧dzɯ˥pi˩	l e ˧ dz ɯ ˥ p i ˩  
le˧dzɯ˥se˩	l e ˧ dz ɯ ˥ s e ˩  
le˧dzɯ˥tʰɑ˩ze˩	l e ˧ dz ɯ ˥ tʰ ɑ ˩ z e ˩  
le˧dzɯ˥ze˩	l e ˧ dz ɯ ˥ z e ˩  
le˧dzɯ˧se˥	l e ˧ dz ɯ ˧ s e ˥  
le˧dɑ˧bi˥	l e ˧ d ɑ ˧ b i ˥  
le˧dɑ˧se˥	l e ˧ d ɑ ˧ s e ˥  
le˧dɑ˩zo˩	l e ˧ d ɑ ˩ z o ˩  
le˧dʑo˧kv̩˧	l e ˧ dʑ o ˧ k v̩ ˧  
le˧dʑo˧kwɤ˧tɕɯ˥lɑ˩	l e ˧ dʑ o ˧ k wɤ ˧ tɕ ɯ ˥ l ɑ ˩  
le˧dʑo˧ze˧	l e ˧ dʑ o ˧ z e ˧  
le˧dʑo˧ɲi˥kv̩˩tsɯ˩	l e ˧ dʑ o ˧ ɲ i ˥ k v̩ ˩ ts ɯ ˩  
le˧dʑo˧ɲi˥ze˩mæ˩	l e ˧ dʑ o ˧ ɲ i ˥ z e ˩ m æ ˩  
le˧dʑo˧ɲi˥ze˩wɤ˩	l e ˧ dʑ o ˧ ɲ i ˥ z e ˩ wɤ ˩  
le˧dʑo˧ʁo˧kwɤ˧tɕɯ˥lɑ˩	l e ˧ dʑ o ˧ ʁ o ˧ k wɤ ˧ tɕ ɯ ˥ l ɑ ˩  
le˧dʑo˩	l e ˧ dʑ o ˩  
le˧dʑo˩ɲi˩ze˩	l e ˧ dʑ o ˩ ɲ i ˩ z e ˩  
le˧dʑɯ˧zo˥	l e ˧ dʑ ɯ ˧ z o ˥  
le˧dʑɯ˩	l e ˧ dʑ ɯ ˩  
le˧go˩dʑo˩	l e ˧ g o ˩ dʑ o ˩  
le˧go˩zo˩	l e ˧ g o ˩ z o ˩  
le˧gv̩˩dʑo˩	l e ˧ g v̩ ˩ dʑ o ˩  
le˧gv̩˩se˩dʑo˩	l e ˧ g v̩ ˩ s e ˩ dʑ o ˩  
le˧gv̩˩zo˩	l e ˧ g v̩ ˩ z o ˩  
le˧gwɤ˩	l e ˧ g wɤ ˩  
le˧gwɤ˩gwɤ˩ɻ̍˩	l e ˧ g wɤ ˩ g wɤ ˩ ɻ̍ ˩  
le˧gɤ˧zo˥	l e ˧ g ɤ ˧ z o ˥  
le˧gɤ˩gɤ˩	l e ˧ g ɤ ˩ g ɤ ˩  
le˧gɤ˩ho˩ze˩	l e ˧ g ɤ ˩ h o ˩ z e ˩  
le˧gɤ˩ze˩wɤ˩	l e ˧ g ɤ ˩ z e ˩ wɤ ˩  
le˧ho˧ho˥	l e ˧ h o ˧ h o ˥  
le˧hwæ˧ki˧	l e ˧ h wæ ˧ k i ˧  
le˧hwæ˧le˧po˧jo˥	l e ˧ h wæ ˧ l e ˧ p o ˧ jo ˥  
le˧hwæ˧tʰi˧tɕɯ˥	l e ˧ h wæ ˧ tʰ i ˧ tɕ ɯ ˥  
le˧hæ̃˧	l e ˧ h æ̃ ˧  
le˧hæ̃˧se˥	l e ˧ h æ̃ ˧ s e ˥  
le˧hɯ˧hĩ˥əəə…qo˩ɳɯ˩	l e ˧ h ɯ ˧ h ĩ ˥ əəə… q o ˩ ɳ ɯ ˩  
le˧hɯ˩pi˩	l e ˧ h ɯ ˩ p i ˩  
le˧hɯ˩ze˩	l e ˧ h ɯ ˩ z e ˩  
le˧jo˥kv̩˩tsɯ˩mɤ˩tsɯ˩	l e ˧ jo ˥ k v̩ ˩ ts ɯ ˩ m ɤ ˩ ts ɯ ˩  
le˧jo˩ho˩	l e ˧ jo ˩ h o ˩  
le˧jo˩kv̩˩ze˩mæ˩	l e ˧ jo ˩ k v̩ ˩ z e ˩ m æ ˩  
le˧jɤ˧˥	l e ˧ jɤ ˧˥  
le˧ki˧	l e ˧ k i ˧  
le˧ki˧se˩	l e ˧ k i ˧ s e ˩  
le˧ki˧se˩dʑo˩	l e ˧ k i ˧ s e ˩ dʑ o ˩  
le˧ki˩dʑo˩	l e ˧ k i ˩ dʑ o ˩  
le˧ko˧ze˥	l e ˧ k o ˧ z e ˥  
le˧kv̩˧ɲi˥ze˩	l e ˧ k v̩ ˧ ɲ i ˥ z e ˩  
le˧kɤ˩zo˩kv̩˩	l e ˧ k ɤ ˩ z o ˩ k v̩ ˩  
le˧kʰi˥	l e ˧ kʰ i ˥  
le˧kʰi˧˥	l e ˧ kʰ i ˧˥  
le˧kʰv̩˧le˧po˧tsʰɯ˧˥	l e ˧ kʰ v̩ ˧ l e ˧ p o ˧ tsʰ ɯ ˧˥  
le˧li˧le˧li˧hɯ˧dʑo˥	l e ˧ l i ˧ l e ˧ l i ˧ h ɯ ˧ dʑ o ˥  
le˧li˧se˩	l e ˧ l i ˧ s e ˩  
le˧lo˩kʰi˩lɑ˩	l e ˧ l o ˩ kʰ i ˩ l ɑ ˩  
le˧lv̩˧˥	l e ˧ l v̩ ˧˥  
le˧lv̩˩hĩ˩qo˩	l e ˧ l v̩ ˩ h ĩ ˩ q o ˩  
le˧lv̩˩ɲi˩	l e ˧ l v̩ ˩ ɲ i ˩  
le˧lɑ˧lɑ˥	l e ˧ l ɑ ˧ l ɑ ˥  
le˧lɑ˧se˥kwɤ˩tɕɯ˩lɑ˩	l e ˧ l ɑ ˧ s e ˥ k wɤ ˩ tɕ ɯ ˩ l ɑ ˩  
le˧lɑ˧tʰi˥tɕɯ˩kv̩˩ze˩mæ˩	l e ˧ l ɑ ˧ tʰ i ˥ tɕ ɯ ˩ k v̩ ˩ z e ˩ m æ ˩  
le˧lɑ˧zo˥	l e ˧ l ɑ ˧ z o ˥  
le˧mo˩hĩ˩	l e ˧ m o ˩ h ĩ ˩  
le˧mo˩hĩ˩ʈʂʰɯ˩	l e ˧ m o ˩ h ĩ ˩ ʈʂʰ ɯ ˩  
le˧mo˩kwɤ˩tɕɯ˩lɑ˩	l e ˧ m o ˩ k wɤ ˩ tɕ ɯ ˩ l ɑ ˩  
le˧mv̩˧kʰɯ˧se˥dʑo˩	l e ˧ m v̩ ˧ kʰ ɯ ˧ s e ˥ dʑ o ˩  
le˧mv̩˧se˩dʑo˩	l e ˧ m v̩ ˧ s e ˩ dʑ o ˩  
le˧mv̩˩	l e ˧ m v̩ ˩  
le˧mv̩˩pʰæ˩tɕɯ˩kv̩˩tsɯ˩	l e ˧ m v̩ ˩ pʰ æ ˩ tɕ ɯ ˩ k v̩ ˩ ts ɯ ˩  
le˧mv̩˩ze˩tsɯ˩	l e ˧ m v̩ ˩ z e ˩ ts ɯ ˩  
le˧mv̩˩ɲi˩ze˩	l e ˧ m v̩ ˩ ɲ i ˩ z e ˩  
le˧mɤ˧tsʰɯ˧˥	l e ˧ m ɤ ˧ tsʰ ɯ ˧˥  
le˧mɤ˧tsʰɯ˩	l e ˧ m ɤ ˧ tsʰ ɯ ˩  
le˧mɤ˧tsʰɯ˩dʑo˩	l e ˧ m ɤ ˧ tsʰ ɯ ˩ dʑ o ˩  
le˧mɤ˧tsʰɯ˩pi˩	l e ˧ m ɤ ˧ tsʰ ɯ ˩ p i ˩  
le˧mɤ˧tsʰɯ˩tsɯ˩	l e ˧ m ɤ ˧ tsʰ ɯ ˩ ts ɯ ˩  
le˧mɤ˧tɑ˥zo˩	l e ˧ m ɤ ˧ t ɑ ˥ z o ˩  
le˧p	l e ˧ p  
le˧pi˥	l e ˧ p i ˥  
le˧pi˥dʑo˩	l e ˧ p i ˥ dʑ o ˩  
le˧pi˧se˥dʑo˩	l e ˧ p i ˧ s e ˥ dʑ o ˩  
le˧po˧bi˥kv̩˩	l e ˧ p o ˧ b i ˥ k v̩ ˩  
le˧po˧bi˥kv̩˩mæ˩	l e ˧ p o ˧ b i ˥ k v̩ ˩ m æ ˩  
le˧po˧hɯ˧˥	l e ˧ p o ˧ h ɯ ˧˥  
le˧po˧jo˥kv̩˩ze˩	l e ˧ p o ˧ jo ˥ k v̩ ˩ z e ˩  
le˧po˧jo˥kv̩˩ze˩mæ˩	l e ˧ p o ˧ jo ˥ k v̩ ˩ z e ˩ m æ ˩  
le˧po˧jo˥kv̩˩ze˩wɤ˩	l e ˧ p o ˧ jo ˥ k v̩ ˩ z e ˩ wɤ ˩  
le˧po˧jo˧	l e ˧ p o ˧ jo ˧  
le˧po˧kʰi˥dʑo˩	l e ˧ p o ˧ kʰ i ˥ dʑ o ˩  
le˧po˧pi˥	l e ˧ p o ˧ p i ˥  
le˧po˧tsʰɯ˧	l e ˧ p o ˧ tsʰ ɯ ˧  
le˧po˧tsʰɯ˧hĩ˥lɑ˩ɲi˩mæ˩	l e ˧ p o ˧ tsʰ ɯ ˧ h ĩ ˥ l ɑ ˩ ɲ i ˩ m æ ˩  
le˧po˧tsʰɯ˧ze˥	l e ˧ p o ˧ tsʰ ɯ ˧ z e ˥  
le˧po˧tsʰɯ˧zo˥	l e ˧ p o ˧ tsʰ ɯ ˧ z o ˥  
le˧po˧ʝi˧ʝi˧ze˩	l e ˧ p o ˧ ʝ i ˧ ʝ i ˧ z e ˩  
le˧pv̩˧hĩ˧	l e ˧ p v̩ ˧ h ĩ ˧  
le˧pv̩˧kwɤ˧tɕɯ˥lɑ˩	l e ˧ p v̩ ˧ k wɤ ˧ tɕ ɯ ˥ l ɑ ˩  
le˧pv̩˩tso˩ɲi˩ze˩	l e ˧ p v̩ ˩ ts o ˩ ɲ i ˩ z e ˩  
le˧pæ˥	l e ˧ p æ ˥  
le˧pɤ˥dʑo˩	l e ˧ p ɤ ˥ dʑ o ˩  
le˧pʰi˧kʰɯ˥	l e ˧ pʰ i ˧ kʰ ɯ ˥  
le˧pʰi˧se˩dʑo˩	l e ˧ pʰ i ˧ s e ˩ dʑ o ˩  
le˧pʰi˧˥	l e ˧ pʰ i ˧˥  
le˧pʰo˩zo˩	l e ˧ pʰ o ˩ z o ˩  
le˧pʰv̩˧po˧hɯ˧ɲi˥	l e ˧ pʰ v̩ ˧ p o ˧ h ɯ ˧ ɲ i ˥  
le˧pʰv̩˧se˥dʑo˩	l e ˧ pʰ v̩ ˧ s e ˥ dʑ o ˩  
le˧pʰæ˧˥	l e ˧ pʰ æ ˧˥  
le˧qo˥lv̩˩	l e ˧ q o ˥ l v̩ ˩  
le˧qwæ˧le˥po˩tsʰɯ˩dʑo˩	l e ˧ q wæ ˧ l e ˥ p o ˩ tsʰ ɯ ˩ dʑ o ˩  
le˧qwæ˧zo˥	l e ˧ q wæ ˧ z o ˥  
le˧qwæ˩qwæ˩	l e ˧ q wæ ˩ q wæ ˩  
le˧qwɤ˩	l e ˧ q wɤ ˩  
le˧qæ˧bi˧ho˥	l e ˧ q æ ˧ b i ˧ h o ˥  
le˧qæ˧hĩ˧bv̩˧	l e ˧ q æ ˧ h ĩ ˧ b v̩ ˧  
le˧qæ˧qæ˧	l e ˧ q æ ˧ q æ ˧  
le˧qɑ˧qɑ˩	l e ˧ q ɑ ˧ q ɑ ˩  
le˧qɑ˩	l e ˧ q ɑ ˩  
le˧qʰo˧	l e ˧ qʰ o ˧  
le˧qʰo˧le˥se˩ɲi˩mæ˩	l e ˧ qʰ o ˧ l e ˥ s e ˩ ɲ i ˩ m æ ˩  
le˧qʰo˧˥	l e ˧ qʰ o ˧˥  
le˧qʰo˩dʑo˩	l e ˧ qʰ o ˩ dʑ o ˩  
le˧qʰo˩hĩ˩	l e ˧ qʰ o ˩ h ĩ ˩  
le˧qʰwæ˩qʰwæ˩	l e ˧ qʰ wæ ˩ qʰ wæ ˩  
le˧qʰwɤ˧dʑo˩	l e ˧ qʰ wɤ ˧ dʑ o ˩  
le˧qʰwɤ˧ze˧	l e ˧ qʰ wɤ ˧ z e ˧  
le˧qʰwɤ˧ze˧tsɯ˧˥	l e ˧ qʰ wɤ ˧ z e ˧ ts ɯ ˧˥  
le˧qʰwɤ˧ɲi˥mæ˩	l e ˧ qʰ wɤ ˧ ɲ i ˥ m æ ˩  
le˧qʰwɤ˧ɲi˥tsɯ˩	l e ˧ qʰ wɤ ˧ ɲ i ˥ ts ɯ ˩  
le˧qʰwɤ˧ʝi˧	l e ˧ qʰ wɤ ˧ ʝ i ˧  
le˧qʰwɤ˧ʝi˧ze˧	l e ˧ qʰ wɤ ˧ ʝ i ˧ z e ˧  
le˧qʰæ˧ɲi˥ze˩mæ˩	l e ˧ qʰ æ ˧ ɲ i ˥ z e ˩ m æ ˩  
le˧se˥bi˩dʑo˩	l e ˧ s e ˥ b i ˩ dʑ o ˩  
le˧se˥dʑo˩	l e ˧ s e ˥ dʑ o ˩  
le˧se˥hɯ˩	l e ˧ s e ˥ h ɯ ˩  
le˧se˥jo˩ɳɯ˩	l e ˧ s e ˥ jo ˩ ɳ ɯ ˩  
le˧se˥zo˩	l e ˧ s e ˥ z o ˩  
le˧se˧se˥	l e ˧ s e ˧ s e ˥  
le˧se˧se˥kwɤ˩tɕɯ˩	l e ˧ s e ˧ s e ˥ k wɤ ˩ tɕ ɯ ˩  
le˧se˩	l e ˧ s e ˩  
le˧se˩kwɤ˩tɕɯ˩lɑ˩	l e ˧ s e ˩ k wɤ ˩ tɕ ɯ ˩ l ɑ ˩  
le˧se˩kʰɯ˩	l e ˧ s e ˩ kʰ ɯ ˩  
le˧se˩se˩	l e ˧ s e ˩ s e ˩  
le˧se˩ɲi˩tsɯ˩	l e ˧ s e ˩ ɲ i ˩ ts ɯ ˩  
le˧si˩si˩	l e ˧ s i ˩ s i ˩  
le˧so˩so˩	l e ˧ s o ˩ s o ˩  
le˧sɯ˥dʑo˩	l e ˧ s ɯ ˥ dʑ o ˩  
le˧sɯ˥ze˩	l e ˧ s ɯ ˥ z e ˩  
le˧sɯ˩hĩ˩	l e ˧ s ɯ ˩ h ĩ ˩  
le˧ti˩bi˩se˩	l e ˧ t i ˩ b i ˩ s e ˩  
le˧ti˩dʑo˩	l e ˧ t i ˩ dʑ o ˩  
le˧ti˩ɲi˩mæ˩	l e ˧ t i ˩ ɲ i ˩ m æ ˩  
le˧to˧to˧	l e ˧ t o ˧ t o ˧  
le˧tse˩	l e ˧ ts e ˩  
le˧tsɑ˩tsɑ˩se˩	l e ˧ ts ɑ ˩ ts ɑ ˩ s e ˩  
le˧tsɤ˧	l e ˧ ts ɤ ˧  
le˧tsɤ˧se˩dʑo˩	l e ˧ ts ɤ ˧ s e ˩ dʑ o ˩  
le˧tsɯ˥	l e ˧ ts ɯ ˥  
le˧tsɯ˥dʑo˩	l e ˧ ts ɯ ˥ dʑ o ˩  
le˧tsɯ˧	l e ˧ ts ɯ ˧  
le˧tsɯ˧tsɯ˧	l e ˧ ts ɯ ˧ ts ɯ ˧  
le˧tsʰi˧	l e ˧ tsʰ i ˧  
le˧tsʰi˧˥	l e ˧ tsʰ i ˧˥  
le˧tsʰo˥ze˩	l e ˧ tsʰ o ˥ z e ˩  
le˧tsʰo˧se˩	l e ˧ tsʰ o ˧ s e ˩  
le˧tsʰɤ˩	l e ˧ tsʰ ɤ ˩  
le˧tsʰɯ˧zo˥	l e ˧ tsʰ ɯ ˧ z o ˥  
le˧tsʰɯ˩kwɤ˩tɕɯ˩	l e ˧ tsʰ ɯ ˩ k wɤ ˩ tɕ ɯ ˩  
le˧tsʰɯ˩kwɤ˩tɕɯ˩lɑ˩	l e ˧ tsʰ ɯ ˩ k wɤ ˩ tɕ ɯ ˩ l ɑ ˩  
le˧tsʰɯ˩kʰɯ˩ɲi˩tsɯ˩	l e ˧ tsʰ ɯ ˩ kʰ ɯ ˩ ɲ i ˩ ts ɯ ˩  
le˧tsʰɯ˩lɑ˩	l e ˧ tsʰ ɯ ˩ l ɑ ˩  
le˧tsʰɯ˩mɤ˩ɲi˩ze˩wɤ˩	l e ˧ tsʰ ɯ ˩ m ɤ ˩ ɲ i ˩ z e ˩ wɤ ˩  
le˧tsʰɯ˩se˩	l e ˧ tsʰ ɯ ˩ s e ˩  
le˧tsʰɯ˩se˩dʑo˩	l e ˧ tsʰ ɯ ˩ s e ˩ dʑ o ˩  
le˧tsʰɯ˩se˩kwɤ˩tɕɯ˩lɑ˩	l e ˧ tsʰ ɯ ˩ s e ˩ k wɤ ˩ tɕ ɯ ˩ l ɑ ˩  
le˧tsʰɯ˩ze˩	l e ˧ tsʰ ɯ ˩ z e ˩  
le˧tsʰɯ˩zo˩	l e ˧ tsʰ ɯ ˩ z o ˩  
le˧tsʰɯ˩ə˩hɯ˩	l e ˧ tsʰ ɯ ˩ ə ˩ h ɯ ˩  
le˧tsʰɯ˩ɲi˩	l e ˧ tsʰ ɯ ˩ ɲ i ˩  
le˧tsʰɯ˩ɲi˩ze˩mæ˩	l e ˧ tsʰ ɯ ˩ ɲ i ˩ z e ˩ m æ ˩  
le˧tv̩˧hĩ˧qo˩	l e ˧ t v̩ ˧ h ĩ ˧ q o ˩  
le˧tv̩˧se˩	l e ˧ t v̩ ˧ s e ˩  
le˧tɑ˩hwɤ˩	l e ˧ t ɑ ˩ h wɤ ˩  
le˧tɕo˧	l e ˧ tɕ o ˧  
le˧tɕɯ˧le˥po˩jo˩	l e ˧ tɕ ɯ ˧ l e ˥ p o ˩ jo ˩  
le˧tɕɯ˧le˥po˩jo˩kv̩˩	l e ˧ tɕ ɯ ˧ l e ˥ p o ˩ jo ˩ k v̩ ˩  
le˧tɕɯ˧le˥po˩tsʰɯ˩dʑo˩	l e ˧ tɕ ɯ ˧ l e ˥ p o ˩ tsʰ ɯ ˩ dʑ o ˩  
le˧tɕɯ˧po˥hɯ˩	l e ˧ tɕ ɯ ˧ p o ˥ h ɯ ˩  
le˧tɕʰi˧	l e ˧ tɕʰ i ˧  
le˧tɕʰi˧hĩ˧	l e ˧ tɕʰ i ˧ h ĩ ˧  
le˧tɕʰi˧tʰv̩˧dʑo˥	l e ˧ tɕʰ i ˧ tʰ v̩ ˧ dʑ o ˥  
le˧tɕʰi˧ze˧	l e ˧ tɕʰ i ˧ z e ˧  
le˧tɕʰo˧bi˥	l e ˧ tɕʰ o ˧ b i ˥  
le˧tɕʰo˧˥	l e ˧ tɕʰ o ˧˥  
le˧tɕʰɯ˧	l e ˧ tɕʰ ɯ ˧  
le˧tɕʰɯ˩	l e ˧ tɕʰ ɯ ˩  
le˧tʰi˧	l e ˧ tʰ i ˧  
le˧tʰv̩˧kv̩˧ze˥	l e ˧ tʰ v̩ ˧ k v̩ ˧ z e ˥  
le˧tʰv̩˧kwɤ˧tɕɯ˥lɑ˩	l e ˧ tʰ v̩ ˧ k wɤ ˧ tɕ ɯ ˥ l ɑ ˩  
le˧tʰv̩˧kʰɯ˧˥	l e ˧ tʰ v̩ ˧ kʰ ɯ ˧˥  
le˧tʰv̩˧se˩	l e ˧ tʰ v̩ ˧ s e ˩  
le˧tʰv̩˧se˩kwɤ˩tɕɯ˩lɑ˩	l e ˧ tʰ v̩ ˧ s e ˩ k wɤ ˩ tɕ ɯ ˩ l ɑ ˩  
le˧tʰv̩˧zo˧kv̩˧˥	l e ˧ tʰ v̩ ˧ z o ˧ k v̩ ˧˥  
le˧tʰv̩˧ɲi˥kv̩˩tsɯ˩	l e ˧ tʰ v̩ ˧ ɲ i ˥ k v̩ ˩ ts ɯ ˩  
le˧tʰv̩˧˥	l e ˧ tʰ v̩ ˧˥  
le˧w	l e ˧ w  
le˧wo˥le˩bi˩ze˩	l e ˧ w o ˥ l e ˩ b i ˩ z e ˩  
le˧wo˧kʰɯ˥kv̩˩mæ˩	l e ˧ w o ˧ kʰ ɯ ˥ k v̩ ˩ m æ ˩  
le˧wo˧le˥tsʰɯ˩ɲi˩tsɯ˩	l e ˧ w o ˧ l e ˥ tsʰ ɯ ˩ ɲ i ˩ ts ɯ ˩  
le˧wo˧le˧ʂv̩˧le˧po˧bi˥ze˩	l e ˧ w o ˧ l e ˧ ʂ v̩ ˧ l e ˧ p o ˧ b i ˥ z e ˩  
le˧wo˧tɕɯ˥	l e ˧ w o ˧ tɕ ɯ ˥  
le˧wo˧ze˥	l e ˧ w o ˧ z e ˥  
le˧wo˧˥	l e ˧ w o ˧˥  
le˧wɤ˧tɕɤ˥zo˩	l e ˧ wɤ ˧ tɕ ɤ ˥ z o ˩  
le˧w̃æ˧	l e ˧ w̃æ ˧  
le˧w̃æ˧dʑɯ˧ɲi˥	l e ˧ w̃æ ˧ dʑ ɯ ˧ ɲ i ˥  
le˧ze˩kʰɯ˩	l e ˧ z e ˩ kʰ ɯ ˩  
le˧ŋv̩˩dʑo˩tsɯ˩	l e ˧ ŋ v̩ ˩ dʑ o ˩ ts ɯ ˩  
le˧ŋv̩˩zo˩	l e ˧ ŋ v̩ ˩ z o ˩  
le˧ɖwæ˩zo˩	l e ˧ ɖ wæ ˩ z o ˩  
le˧ɖæ˥	l e ˧ ɖ æ ˥  
le˧ɖɯ˩ho˩ze˩	l e ˧ ɖ ɯ ˩ h o ˩ z e ˩  
le˧ɖʐv̩˧	l e ˧ ɖʐ v̩ ˧  
le˧ɖʐɤ˧	l e ˧ ɖʐ ɤ ˧  
le˧ɖʐɤ˧le˥po˩tsʰɯ˩	l e ˧ ɖʐ ɤ ˧ l e ˥ p o ˩ tsʰ ɯ ˩  
le˧ɖʐɤ˧le˥po˩tsʰɯ˩dʑo˩	l e ˧ ɖʐ ɤ ˧ l e ˥ p o ˩ tsʰ ɯ ˩ dʑ o ˩  
le˧ɖʐɤ˧le˥po˩tsʰɯ˩tsɯ˩	l e ˧ ɖʐ ɤ ˧ l e ˥ p o ˩ tsʰ ɯ ˩ ts ɯ ˩  
le˧ɖʐɤ˧po˥jo˩dʑo˩	l e ˧ ɖʐ ɤ ˧ p o ˥ jo ˩ dʑ o ˩  
le˧ɣɯ˧ʂɯ˩	l e ˧ ɣ ɯ ˧ ʂ ɯ ˩  
le˧ɬi˥lɑ˩	l e ˧ ɬ i ˥ l ɑ ˩  
le˧ɬi˧ɲi˥	l e ˧ ɬ i ˧ ɲ i ˥  
le˧ɬi˩	l e ˧ ɬ i ˩  
le˧ɳæ˧se˥	l e ˧ ɳ æ ˧ s e ˥  
le˧ɻwæ˥	l e ˧ ɻ wæ ˥  
le˧ʁæ˩kwɤ˩tɕɯ˩lɑ˩	l e ˧ ʁ æ ˩ k wɤ ˩ tɕ ɯ ˩ l ɑ ˩  
le˧ʁæ˩ɲi˩	l e ˧ ʁ æ ˩ ɲ i ˩  
le˧ʁɑ˥ʂe˩pi˩	l e ˧ ʁ ɑ ˥ ʂ e ˩ p i ˩  
le˧ʂe˧po˧hɯ˥	l e ˧ ʂ e ˧ p o ˧ h ɯ ˥  
le˧ʂo˧se˥	l e ˧ ʂ o ˧ s e ˥  
le˧ʂo˧ʂo˥	l e ˧ ʂ o ˧ ʂ o ˥  
le˧ʂo˩kʰɯ˩	l e ˧ ʂ o ˩ kʰ ɯ ˩  
le˧ʂv̩˧jo˧	l e ˧ ʂ v̩ ˧ jo ˧  
le˧ʂv̩˧po˧tsʰɯ˧hĩ˥	l e ˧ ʂ v̩ ˧ p o ˧ tsʰ ɯ ˧ h ĩ ˥  
le˧ʂv̩˧ʂv̩˧	l e ˧ ʂ v̩ ˧ ʂ v̩ ˧  
le˧ʂv̩˧ʂv̩˧dʑo˧	l e ˧ ʂ v̩ ˧ ʂ v̩ ˧ dʑ o ˧  
le˧ʂæ˧ɕi˧kʰɯ˩	l e ˧ ʂ æ ˧ ɕ i ˧ kʰ ɯ ˩  
le˧ʂæ˩	l e ˧ ʂ æ ˩  
le˧ʂæ˩zo˩	l e ˧ ʂ æ ˩ z o ˩  
le˧ʂɤ˩	l e ˧ ʂ ɤ ˩  
le˧ʂɯ˧dʑo˥	l e ˧ ʂ ɯ ˧ dʑ o ˥  
le˧ʂɯ˧dʑo˧	l e ˧ ʂ ɯ ˧ dʑ o ˧  
le˧ʂɯ˧hĩ˧gi˩dʑo˩	l e ˧ ʂ ɯ ˧ h ĩ ˧ g i ˩ dʑ o ˩  
le˧ʂɯ˧hĩ˧qo˩	l e ˧ ʂ ɯ ˧ h ĩ ˧ q o ˩  
le˧ʂɯ˧hĩ˧ʁo˧to˩dʑo˩	l e ˧ ʂ ɯ ˧ h ĩ ˧ ʁ o ˧ t o ˩ dʑ o ˩  
le˧ʂɯ˧ho˧ze˩	l e ˧ ʂ ɯ ˧ h o ˧ z e ˩  
le˧ʂɯ˧hɯ˧ze˧	l e ˧ ʂ ɯ ˧ h ɯ ˧ z e ˧  
le˧ʂɯ˧mɤ˧tʰɑ˧hĩ˧	l e ˧ ʂ ɯ ˧ m ɤ ˧ tʰ ɑ ˧ h ĩ ˧  
le˧ʂɯ˧se˥	l e ˧ ʂ ɯ ˧ s e ˥  
le˧ʂɯ˧se˩	l e ˧ ʂ ɯ ˧ s e ˩  
le˧ʂɯ˧tsɯ˥	l e ˧ ʂ ɯ ˧ ts ɯ ˥  
le˧ʂɯ˧ɲi˥	l e ˧ ʂ ɯ ˧ ɲ i ˥  
le˧ʂɯ˧ɲi˥ze˩mæ˩	l e ˧ ʂ ɯ ˧ ɲ i ˥ z e ˩ m æ ˩  
le˧ʂɯ˧ʂɯ˧	l e ˧ ʂ ɯ ˧ ʂ ɯ ˧  
le˧ʈɤ˥ʈɤ˩	l e ˧ ʈ ɤ ˥ ʈ ɤ ˩  
le˧ʈɤ˧kwɤ˧tɕɯ˥lɑ˩	l e ˧ ʈ ɤ ˧ k wɤ ˧ tɕ ɯ ˥ l ɑ ˩  
le˧ʈɤ˧po˧hɯ˥tsɯ˩	l e ˧ ʈ ɤ ˧ p o ˧ h ɯ ˥ ts ɯ ˩  
le˧ʈʂæ˧	l e ˧ ʈʂ æ ˧  
le˧ʈʂɤ˧zo˩	l e ˧ ʈʂ ɤ ˧ z o ˩  
le˧ʈʂɯ˩hĩ˩	l e ˧ ʈʂ ɯ ˩ h ĩ ˩  
le˧ʈʂʰo˧se˥dʑo˩	l e ˧ ʈʂʰ o ˧ s e ˥ dʑ o ˩  
le˧ʈʂʰo˧se˩kwɤ˩tɕɯ˩lɑ˩	l e ˧ ʈʂʰ o ˧ s e ˩ k wɤ ˩ tɕ ɯ ˩ l ɑ ˩  
le˧ʈʂʰv̩˩se˩dʑo˩	l e ˧ ʈʂʰ v̩ ˩ s e ˩ dʑ o ˩  
le˧ʈʂʰwæ˧kv̩˥pʰæ˩di˩	l e ˧ ʈʂʰ wæ ˧ k v̩ ˥ pʰ æ ˩ d i ˩  
le˧ʈʂʰæ˥dʑo˩	l e ˧ ʈʂʰ æ ˥ dʑ o ˩  
le˧ʈʂʰæ˧	l e ˧ ʈʂʰ æ ˧  
le˧ʈʂʰæ˧ʈʂʰæ˧kʰɯ˩	l e ˧ ʈʂʰ æ ˧ ʈʂʰ æ ˧ kʰ ɯ ˩  
le˧ʈʂʰæ˧ʈʂʰæ˧se˥dʑo˩	l e ˧ ʈʂʰ æ ˧ ʈʂʰ æ ˧ s e ˥ dʑ o ˩  
le˧ʈʂʰɤ˩	l e ˧ ʈʂʰ ɤ ˩  
le˧ʈʰ	l e ˧ ʈʰ  
le˧ʈʰi˩	l e ˧ ʈʰ i ˩  
le˧ʈʰi˩kwɤ˩tɕɯ˩lɑ˩	l e ˧ ʈʰ i ˩ k wɤ ˩ tɕ ɯ ˩ l ɑ ˩  
le˧ʈʰæ˧po˧hɯ˥ze˩	l e ˧ ʈʰ æ ˧ p o ˧ h ɯ ˥ z e ˩  
le˧ʈʰæ˧ɲi˥	l e ˧ ʈʰ æ ˧ ɲ i ˥  
le˧ʈʰæ˧ɲi˥tsɯ˩	l e ˧ ʈʰ æ ˧ ɲ i ˥ ts ɯ ˩  
le˧ʈʰæ˧˥	l e ˧ ʈʰ æ ˧˥  
le˧ʈʰɯ˩	l e ˧ ʈʰ ɯ ˩  
le˧ʈʰɯ˩kwɤ˩tɕɯ˩lɑ˩	l e ˧ ʈʰ ɯ ˩ k wɤ ˩ tɕ ɯ ˩ l ɑ ˩  
le˧ʈʰɯ˩pi˩zo˩	l e ˧ ʈʰ ɯ ˩ p i ˩ z o ˩  
le˧ʈʰɯ˩zo˩	l e ˧ ʈʰ ɯ ˩ z o ˩  
le˧ʐv̩˧zo˥	l e ˧ ʐ v̩ ˧ z o ˥  
le˧ʐv̩˧ʐv̩˥	l e ˧ ʐ v̩ ˧ ʐ v̩ ˥  
le˧ʐv̩˧˥	l e ˧ ʐ v̩ ˧˥  
le˧ʐwæ˧se˥	l e ˧ ʐ wæ ˧ s e ˥  
le˧ʐwæ˧˥	l e ˧ ʐ wæ ˧˥  
le˧ʐwæ˩	l e ˧ ʐ wæ ˩  
le˧ʐwæ˩ze˩	l e ˧ ʐ wæ ˩ z e ˩  
le˧ʐwæ˩ʐwæ˩se˩	l e ˧ ʐ wæ ˩ ʐ wæ ˩ s e ˩  
le˧ʐwɤ˥ʐwɤ˩	l e ˧ ʐ wɤ ˥ ʐ wɤ ˩  
le˧ʐwɤ˩dʑo˩	l e ˧ ʐ wɤ ˩ dʑ o ˩  
le˧ʐwɤ˩kv̩˩ze˩tsɯ˩	l e ˧ ʐ wɤ ˩ k v̩ ˩ z e ˩ ts ɯ ˩  
le˧ʐwɤ˩zo˩	l e ˧ ʐ wɤ ˩ z o ˩  
le˧ʐɤ˧zo˩	l e ˧ ʐ ɤ ˧ z o ˩  
le˧ʑi˧po˧hɯ˥	l e ˧ ʑ i ˧ p o ˧ h ɯ ˥  
le˧ʑi˧ŋv̩˥dʑo˩	l e ˧ ʑ i ˧ ŋ v̩ ˥ dʑ o ˩  
le˧ʑi˩bi˩	l e ˧ ʑ i ˩ b i ˩  
le˧ʑi˩kwɤ˩tɕɯ˩lɑ˩	l e ˧ ʑ i ˩ k wɤ ˩ tɕ ɯ ˩ l ɑ ˩  
le˧ʑi˩ɻ̍˩	l e ˧ ʑ i ˩ ɻ̍ ˩  
le˧ʝi˥zo˩	l e ˧ ʝ i ˥ z o ˩  
le˧ʝi˧bi˧	l e ˧ ʝ i ˧ b i ˧  
le˧ʝi˧dʑɯ˧ze˩pi˩kv̩˩mæ˩	l e ˧ ʝ i ˧ dʑ ɯ ˧ z e ˩ p i ˩ k v̩ ˩ m æ ˩  
le˧ʝi˩se˩dʑo˩	l e ˧ ʝ i ˩ s e ˩ dʑ o ˩  
le˧ʝi˩ʝi˩ze˩	l e ˧ ʝ i ˩ ʝ i ˩ z e ˩  
le˩dʑo˩	l e ˩ dʑ o ˩  
le˩gv̩˩hĩ˩	l e ˩ g v̩ ˩ h ĩ ˩  
le˩hɯ˩dʑo˩	l e ˩ h ɯ ˩ dʑ o ˩  
le˩jo˩kv̩˩mæ˩	l e ˩ jo ˩ k v̩ ˩ m æ ˩  
le˩po˩jo˩	l e ˩ p o ˩ jo ˩  
le˩po˩jo˩kv̩˩mæ˩	l e ˩ p o ˩ jo ˩ k v̩ ˩ m æ ˩  
le˩po˩ʝi˩ʝi˩ze˩	l e ˩ p o ˩ ʝ i ˩ ʝ i ˩ z e ˩  
le˩tsʰɤ˩	l e ˩ tsʰ ɤ ˩  
le˩tsʰɯ˩ɲi˥ze˩mæ˩	l e ˩ tsʰ ɯ ˩ ɲ i ˥ z e ˩ m æ ˩  
le˩ʈʂʰæ˩	l e ˩ ʈʂʰ æ ˩  
le˩ʝi˩ʝi˩ze˩	l e ˩ ʝ i ˩ ʝ i ˩ z e ˩  
li	l i  
li˧hɯ˧	l i ˧ h ɯ ˧  
li˧hɯ˧ɲi˥	l i ˧ h ɯ ˧ ɲ i ˥  
li˧hɯ˧ɲi˥tsɯ˩	l i ˧ h ɯ ˧ ɲ i ˥ ts ɯ ˩  
li˧mɤ˧ɖo˧	l i ˧ m ɤ ˧ ɖ o ˧  
li˧tsʰɯ˩ze˩	l i ˧ tsʰ ɯ ˩ z e ˩  
li˩kʰɤ˧	l i ˩ kʰ ɤ ˧  
li˩læ˩˥	l i ˩ l æ ˩˥  
li˩mɤ˩dʑo˩˥	l i ˩ m ɤ ˩ dʑ o ˩˥  
li˩qʰwɤ˥	l i ˩ qʰ wɤ ˥  
li˩ʈʰɯ˩di˩	l i ˩ ʈʰ ɯ ˩ d i ˩  
ljɤljɤ	l jɤ l jɤ  
ljɤ˧qo˥ɳɯ˩	l jɤ ˧ q o ˥ ɳ ɯ ˩  
lo˧dzɑ˧	l o ˧ dz ɑ ˧  
lo˧gv̩˩hĩ˩	l o ˧ g v̩ ˩ h ĩ ˩  
lo˧gv̩˩hĩ˩bv̩˩ɲi˩tsɯ˩zo˩	l o ˧ g v̩ ˩ h ĩ ˩ b v̩ ˩ ɲ i ˩ ts ɯ ˩ z o ˩  
lo˧gv̩˩lɑ˩	l o ˧ g v̩ ˩ l ɑ ˩  
lo˧hɑ˧	l o ˧ h ɑ ˧  
lo˧lo˧ɳɯ˧	l o ˧ l o ˧ ɳ ɯ ˧  
lo˧pæ˧mv̩˧ʈʂæ˧˥	l o ˧ p æ ˧ m v̩ ˧ ʈʂ æ ˧˥  
lo˧qo˧dʑo˩	l o ˧ q o ˧ dʑ o ˩  
lo˧qo˧lɑ˧	l o ˧ q o ˧ l ɑ ˧  
lo˧qo˧mv̩˧	l o ˧ q o ˧ m v̩ ˧  
lo˧qo˧ɳɯ˧	l o ˧ q o ˧ ɳ ɯ ˧  
lo˧sæ˧	l o ˧ s æ ˧  
lo˧ʂv̩˩ɳɯ˩	l o ˧ ʂ v̩ ˩ ɳ ɯ ˩  
lo˧ʝi˧ʈʂʰɯ˧dʑo˩	l o ˧ ʝ i ˧ ʈʂʰ ɯ ˧ dʑ o ˩  
lo˩pv̩˧	l o ˩ p v̩ ˧  
lo˩pv̩˧˥	l o ˩ p v̩ ˧˥  
lo˩qʰwɤ˥	l o ˩ qʰ wɤ ˥  
lo˩qʰwɤ˧	l o ˩ qʰ wɤ ˧  
lv̩˥ɲi˩kv̩˩	l v̩ ˥ ɲ i ˩ k v̩ ˩  
lv̩˧lɑ˧	l v̩ ˧ l ɑ ˧  
lv̩˧mi˧	l v̩ ˧ m i ˧  
lv̩˧tʰɑ˧bi˧	l v̩ ˧ tʰ ɑ ˧ b i ˧  
lv̩˩hɯ˩dʑo˩	l v̩ ˩ h ɯ ˩ dʑ o ˩  
lv̩˩ɲi˥	l v̩ ˩ ɲ i ˥  
lv̩˩ʝi˥kv̩˩mæ˩	l v̩ ˩ ʝ i ˥ k v̩ ˩ m æ ˩  
læ˧	l æ ˧  
lɑ˥	l ɑ ˥  
lɑ˥lɑ˩zo˩	l ɑ ˥ l ɑ ˩ z o ˩  
lɑ˥ɲi˩mæ˩	l ɑ ˥ ɲ i ˩ m æ ˩  
lɑ˧dʑo˧	l ɑ ˧ dʑ o ˧  
lɑ˧kʰv̩˧ɲi˥	l ɑ ˧ kʰ v̩ ˧ ɲ i ˥  
lɑ˧lɑ˧	l ɑ ˧ l ɑ ˧  
lɑ˧mæ˧qv̩˩ʈʂʰɯ˩ɳɯ˩	l ɑ ˧ m æ ˧ q v̩ ˩ ʈʂʰ ɯ ˩ ɳ ɯ ˩  
lɑ˧tʰɑ˧di˧ɳɯ˥	l ɑ ˧ tʰ ɑ ˧ d i ˧ ɳ ɯ ˥  
lɑ˧tʰɑ˧mi˧ɻ̍˧pi˥	l ɑ ˧ tʰ ɑ ˧ m i ˧ ɻ̍ ˧ p i ˥  
lɑ˧ŋwɤ˧hĩ˧	l ɑ ˧ ŋ wɤ ˧ h ĩ ˧  
lɑ˧ɬɑ˧˥	l ɑ ˧ ɬ ɑ ˧˥  
lɑ˧ʈʂʰɯ˧	l ɑ ˧ ʈʂʰ ɯ ˧  
lɑ˧ʈʂʰɯ˧dʑo˩	l ɑ ˧ ʈʂʰ ɯ ˧ dʑ o ˩  
lɑ˧ʈʂʰɯ˧ɳɯ˩	l ɑ ˧ ʈʂʰ ɯ ˧ ɳ ɯ ˩  
lɑ˧ʈʂʰɯ˧ɳɯ˩dʑo˩	l ɑ ˧ ʈʂʰ ɯ ˧ ɳ ɯ ˩ dʑ o ˩  
lɑ˧˥	l ɑ ˧˥  
lɑ˩hĩ˩tʰv̩˩	l ɑ ˩ h ĩ ˩ tʰ v̩ ˩  
lɑ˩kv̩˩	l ɑ ˩ k v̩ ˩  
lɑ˩kwɤ˩tɕɯ˩lɑ˩	l ɑ ˩ k wɤ ˩ tɕ ɯ ˩ l ɑ ˩  
lɑ˩ze˩	l ɑ ˩ z e ˩  
m	m  
mi˧le˧tsʰɯ˧ɲi˥tsɯ˩	m i ˧ l e ˧ tsʰ ɯ ˧ ɲ i ˥ ts ɯ ˩  
mi˧le˧tsʰɯ˧˥	m i ˧ l e ˧ tsʰ ɯ ˧˥  
mi˧tʰv̩˧	m i ˧ tʰ v̩ ˧  
mi˩	m i ˩  
mi˩zɯ˩	m i ˩ z ɯ ˩  
mi˩zɯ˩ɳɯ˥	m i ˩ z ɯ ˩ ɳ ɯ ˥  
mmm…n	mmm… n  
mo˥hĩ˩dʑo˩	m o ˥ h ĩ ˩ dʑ o ˩  
mo˥hĩ˩ki˩	m o ˥ h ĩ ˩ k i ˩  
mo˥hĩ˩ni˩gv̩˩mæ˩	m o ˥ h ĩ ˩ n i ˩ g v̩ ˩ m æ ˩  
mo˥hĩ˩ʈʂʰɯ˩	m o ˥ h ĩ ˩ ʈʂʰ ɯ ˩  
mo˥ɻæ˩ɳɯ˩	m o ˥ ɻ æ ˩ ɳ ɯ ˩  
mo˧	m o ˧  
mo˧bv̩˥	m o ˧ b v̩ ˥  
mo˧dʑɯ˥	m o ˧ dʑ ɯ ˥  
mo˧pi˥kv̩˩mæ˩	m o ˧ p i ˥ k v̩ ˩ m æ ˩  
mo˧qʰwɤ˥	m o ˧ qʰ wɤ ˥  
mo˧qʰwɤ˧zo˥	m o ˧ qʰ wɤ ˧ z o ˥  
mo˧ɖʐv̩˥	m o ˧ ɖʐ v̩ ˥  
mo˧ɖʐv̩˥lɑ˩	m o ˧ ɖʐ v̩ ˥ l ɑ ˩  
mo˧ɖʐv̩˥ne˩ʝi˩zo˩	m o ˧ ɖʐ v̩ ˥ n e ˩ ʝ i ˩ z o ˩  
mo˧ɖʐv̩˥ʈʂʰɯ˩	m o ˧ ɖʐ v̩ ˥ ʈʂʰ ɯ ˩  
mo˧ɲi˥	m o ˧ ɲ i ˥  
mo˩kv̩˧bv̩˧	m o ˩ k v̩ ˧ b v̩ ˧  
mo˩kv̩˧tʰv̩˧dʑo˩	m o ˩ k v̩ ˧ tʰ v̩ ˧ dʑ o ˩  
mo˩kv̩˧ʈʂʰɯ˧	m o ˩ k v̩ ˧ ʈʂʰ ɯ ˧  
mo˩kv̩˧ʈʂʰɯ˧dʑo˩	m o ˩ k v̩ ˧ ʈʂʰ ɯ ˧ dʑ o ˩  
mo˩zo˧	m o ˩ z o ˧  
mo˩ɻ̍˥lɑ˩	m o ˩ ɻ̍ ˥ l ɑ ˩  
mo˩ʝi˩	m o ˩ ʝ i ˩  
mv̩˥	m v̩ ˥  
mv̩˥hĩ˩ki˩	m v̩ ˥ h ĩ ˩ k i ˩  
mv̩˥ʈʂæ˩	m v̩ ˥ ʈʂ æ ˩  
mv̩˥ʈʂæ˩kv̩˩mæ˩	m v̩ ˥ ʈʂ æ ˩ k v̩ ˩ m æ ˩  
mv̩˧d	m v̩ ˧ d  
mv̩˧di˧qo˥dʑo˩	m v̩ ˧ d i ˧ q o ˥ dʑ o ˩  
mv̩˧di˧˥	m v̩ ˧ d i ˧˥  
mv̩˧dze˧ʈʂʰɯ˧	m v̩ ˧ dz e ˧ ʈʂʰ ɯ ˧  
mv̩˧gv̩˧	m v̩ ˧ g v̩ ˧  
mv̩˧kv̩˧˥	m v̩ ˧ k v̩ ˧˥  
mv̩˧kʰɯ˧˥	m v̩ ˧ kʰ ɯ ˧˥  
mv̩˧lɯ˩	m v̩ ˧ l ɯ ˩  
mv̩˧zo	m v̩ ˧ z o  
mv̩˧ɭɯ˩dʑo˩	m v̩ ˧ ɭ ɯ ˩ dʑ o ˩  
mv̩˧ɭɯ˩lɑ˩	m v̩ ˧ ɭ ɯ ˩ l ɑ ˩  
mv̩˧ɭɯ˩sɯ˩pʰi˩bv̩˩	m v̩ ˧ ɭ ɯ ˩ s ɯ ˩ pʰ i ˩ b v̩ ˩  
mv̩˧ɭɯ˩sɯ˩pʰi˩ɳɯ˩	m v̩ ˧ ɭ ɯ ˩ s ɯ ˩ pʰ i ˩ ɳ ɯ ˩  
mv̩˧ʁo˧	m v̩ ˧ ʁ o ˧  
mv̩˧ʁo˧ɻ̍˥dʑo˩	m v̩ ˧ ʁ o ˧ ɻ̍ ˥ dʑ o ˩  
mv̩˧ʂɯ˧kwɤ˧tɕɯ˥lɑ˩	m v̩ ˧ ʂ ɯ ˧ k wɤ ˧ tɕ ɯ ˥ l ɑ ˩  
mv̩˧ʈʂæ˧kv̩˥tsɯ˩	m v̩ ˧ ʈʂ æ ˧ k v̩ ˥ ts ɯ ˩  
mv̩˧ʈʂæ˧˥	m v̩ ˧ ʈʂ æ ˧˥  
mv̩˧ʈʰæ˧ʈæ˧qo˧	m v̩ ˧ ʈʰ æ ˧ ʈ æ ˧ q o ˧  
mv̩˧ʈʰæ˧ʈʂʰɯ˧	m v̩ ˧ ʈʰ æ ˧ ʈʂʰ ɯ ˧  
mv̩˧ʈʰæ˧˥	m v̩ ˧ ʈʰ æ ˧˥  
mv̩˩do˩bi˩zo˩kv̩˥	m v̩ ˩ d o ˩ b i ˩ z o ˩ k v̩ ˥  
mv̩˩dzɤ˧	m v̩ ˩ dz ɤ ˧  
mv̩˩gɤ˧	m v̩ ˩ g ɤ ˧  
mv̩˩hĩ˩	m v̩ ˩ h ĩ ˩  
mv̩˩kʰɯ˩kv̩˩mæ˩	m v̩ ˩ kʰ ɯ ˩ k v̩ ˩ m æ ˩  
mv̩˩lo˥ʝi˩ʈʂʰɯ˩dʑo˩	m v̩ ˩ l o ˥ ʝ i ˩ ʈʂʰ ɯ ˩ dʑ o ˩  
mv̩˩mɤ˩tʰɑ˥	m v̩ ˩ m ɤ ˩ tʰ ɑ ˥  
mv̩˩pʰæ˧dʑo˩	m v̩ ˩ pʰ æ ˧ dʑ o ˩  
mv̩˩pʰæ˧pi˧	m v̩ ˩ pʰ æ ˧ p i ˧  
mv̩˩pʰæ˧ɳɯ˧	m v̩ ˩ pʰ æ ˧ ɳ ɯ ˧  
mv̩˩sɯ˧njɤ˧ki˥	m v̩ ˩ s ɯ ˧ n jɤ ˧ k i ˥  
mv̩˩sɯ˧njɤ˧ɳɯ˥	m v̩ ˩ s ɯ ˧ n jɤ ˧ ɳ ɯ ˥  
mv̩˩sɯ˧njɤ˧ʈʂʰɯ˥dʑo˩	m v̩ ˩ s ɯ ˧ n jɤ ˧ ʈʂʰ ɯ ˥ dʑ o ˩  
mv̩˩sɯ˧njɤ˧˥	m v̩ ˩ s ɯ ˧ n jɤ ˧˥  
mv̩˩tsʰo˩	m v̩ ˩ tsʰ o ˩  
mv̩˩tsʰo˩˥	m v̩ ˩ tsʰ o ˩˥  
mv̩˩tɕi˥dʑo˩	m v̩ ˩ tɕ i ˥ dʑ o ˩  
mv̩˩tʰɑ˩ze˩	m v̩ ˩ tʰ ɑ ˩ z e ˩  
mv̩˩zo˩ki˥	m v̩ ˩ z o ˩ k i ˥  
mv̩˩zo˩ɻæ˥	m v̩ ˩ z o ˩ ɻ æ ˥  
mv̩˩zo˩ɻæ˩lɑ˥	m v̩ ˩ z o ˩ ɻ æ ˩ l ɑ ˥  
mv̩˩zɯ˩	m v̩ ˩ z ɯ ˩  
mv̩˩zɯ˩mo˩nɑ˥	m v̩ ˩ z ɯ ˩ m o ˩ n ɑ ˥  
mv̩˩zɯ˩ni˥mi˩	m v̩ ˩ z ɯ ˩ n i ˥ m i ˩  
mv̩˩zɯ˩ni˥mi˩bv̩˩	m v̩ ˩ z ɯ ˩ n i ˥ m i ˩ b v̩ ˩  
mv̩˩zɯ˩ni˥mi˩ɻæ˩	m v̩ ˩ z ɯ ˩ n i ˥ m i ˩ ɻ æ ˩  
mv̩˩zɯ˩ʈʂʰɯ˥	m v̩ ˩ z ɯ ˩ ʈʂʰ ɯ ˥  
mv̩˩zɯ˩ʝi˥hĩ˩	m v̩ ˩ z ɯ ˩ ʝ i ˥ h ĩ ˩  
mv̩˩ɖɯ˩ɳɯ˥	m v̩ ˩ ɖ ɯ ˩ ɳ ɯ ˥  
mv̩˩ɖɯ˩˥	m v̩ ˩ ɖ ɯ ˩˥  
mv̩˩ɬi˧	m v̩ ˩ ɬ i ˧  
mv̩˩ɳɯ˩	m v̩ ˩ ɳ ɯ ˩  
mv̩˩ʈʂæ˩	m v̩ ˩ ʈʂ æ ˩  
mv̩˩ʈʂæ˩hĩ˩ʈʂʰɯ˩dʑo˩	m v̩ ˩ ʈʂ æ ˩ h ĩ ˩ ʈʂʰ ɯ ˩ dʑ o ˩  
mv̩˩ʈʂæ˩kv̩˩mæ˩	m v̩ ˩ ʈʂ æ ˩ k v̩ ˩ m æ ˩  
mv̩˩ʈʂæ˩kv̩˩tsɯ˩	m v̩ ˩ ʈʂ æ ˩ k v̩ ˩ ts ɯ ˩  
mv̩˩ʈʂæ˩ɲi˩	m v̩ ˩ ʈʂ æ ˩ ɲ i ˩  
mv̩˩ʈʂæ˩ɲi˩kv̩˩tsɯ˩	m v̩ ˩ ʈʂ æ ˩ ɲ i ˩ k v̩ ˩ ts ɯ ˩  
mæ˥bi˩	m æ ˥ b i ˩  
mæ˧qv̩˩	m æ ˧ q v̩ ˩  
mæ˧qv̩˩sɯ˩	m æ ˧ q v̩ ˩ s ɯ ˩  
mæ˧ɻæ˩	m æ ˧ ɻ æ ˩  
mæ˩zo˩kv̩˩	m æ ˩ z o ˩ k v̩ ˩  
mɑ˩pv̩˩ɳɯ˥	m ɑ ˩ p v̩ ˩ ɳ ɯ ˥  
mɑ˩pv̩˩˥	m ɑ ˩ p v̩ ˩˥  
mɤ˧di˥	m ɤ ˧ d i ˥  
mɤ˧di˥zo˩	m ɤ ˧ d i ˥ z o ˩  
mɤ˧di˩	m ɤ ˧ d i ˩  
mɤ˧do˧ze˥	m ɤ ˧ d o ˧ z e ˥  
mɤ˧do˩mæ˩	m ɤ ˧ d o ˩ m æ ˩  
mɤ˧do˩zo˩	m ɤ ˧ d o ˩ z o ˩  
mɤ˧dv̩˥ze˩	m ɤ ˧ d v̩ ˥ z e ˩  
mɤ˧dv̩˩	m ɤ ˧ d v̩ ˩  
mɤ˧dzɯ˧	m ɤ ˧ dz ɯ ˧  
mɤ˧dzɯ˧sɯ˥	m ɤ ˧ dz ɯ ˧ s ɯ ˥  
mɤ˧dɑ˩	m ɤ ˧ d ɑ ˩  
mɤ˧dɑ˩mi˩jɤ	m ɤ ˧ d ɑ ˩ m i ˩ jɤ  
mɤ˧dɑ˩mi˩lɑ˩	m ɤ ˧ d ɑ ˩ m i ˩ l ɑ ˩  
mɤ˧dɑ˩qʰwɤ˩hĩ˩	m ɤ ˧ d ɑ ˩ qʰ wɤ ˩ h ĩ ˩  
mɤ˧dʑo˧hĩ˥	m ɤ ˧ dʑ o ˧ h ĩ ˥  
mɤ˧dʑo˧kwɤ˧tɕɯ˥lɑ˩	m ɤ ˧ dʑ o ˧ k wɤ ˧ tɕ ɯ ˥ l ɑ ˩  
mɤ˧dʑo˧ɲi˥tskv̩˩tsɯ˩	m ɤ ˧ dʑ o ˧ ɲ i ˥ ts k v̩ ˩ ts ɯ ˩  
mɤ˧dʑo˧ɲi˥ze˩	m ɤ ˧ dʑ o ˧ ɲ i ˥ z e ˩  
mɤ˧dʑo˧ɲi˥ze˩mæ˩	m ɤ ˧ dʑ o ˧ ɲ i ˥ z e ˩ m æ ˩  
mɤ˧dʑo˩ze˩mæ˩	m ɤ ˧ dʑ o ˩ z e ˩ m æ ˩  
mɤ˧dʑo˩ɲi˩mæ˩	m ɤ ˧ dʑ o ˩ ɲ i ˩ m æ ˩  
mɤ˧dʑo˩ɲi˩ze˩mæ˩	m ɤ ˧ dʑ o ˩ ɲ i ˩ z e ˩ m æ ˩  
mɤ˧dʑɤ˩pi˩ɲi˩ze˩mæ˩	m ɤ ˧ dʑ ɤ ˩ p i ˩ ɲ i ˩ z e ˩ m æ ˩  
mɤ˧dʑɤ˩ɲi˩	m ɤ ˧ dʑ ɤ ˩ ɲ i ˩  
mɤ˧dʑɯ˧	m ɤ ˧ dʑ ɯ ˧  
mɤ˧fv̩˧zo˩	m ɤ ˧ f v̩ ˧ z o ˩  
mɤ˧fv̩˧ɲi˥kv̩˩tsɯ˩	m ɤ ˧ f v̩ ˧ ɲ i ˥ k v̩ ˩ ts ɯ ˩  
mɤ˧go˩	m ɤ ˧ g o ˩  
mɤ˧go˩tsɯ˩	m ɤ ˧ g o ˩ ts ɯ ˩  
mɤ˧gv̩˧dʑo˧	m ɤ ˧ g v̩ ˧ dʑ o ˧  
mɤ˧gv̩˧sɯ˩	m ɤ ˧ g v̩ ˧ s ɯ ˩  
mɤ˧hĩ˧˥	m ɤ ˧ h ĩ ˧˥  
mɤ˧ho˥	m ɤ ˧ h o ˥  
mɤ˧ho˩	m ɤ ˧ h o ˩  
mɤ˧hwæ˧ɲi˥	m ɤ ˧ h wæ ˧ ɲ i ˥  
mɤ˧hɤ˩ɲi˩mæ˩	m ɤ ˧ h ɤ ˩ ɲ i ˩ m æ ˩  
mɤ˧hɯ˧	m ɤ ˧ h ɯ ˧  
mɤ˧jɤ˧	m ɤ ˧ jɤ ˧  
mɤ˧jɤ˧tsɯlɑ	m ɤ ˧ jɤ ˧ ts ɯ l ɑ  
mɤ˧ki˧dʑo˧	m ɤ ˧ k i ˧ dʑ o ˧  
mɤ˧kv̩˧	m ɤ ˧ k v̩ ˧  
mɤ˧kv̩˧ze˥	m ɤ ˧ k v̩ ˧ z e ˥  
mɤ˧kv̩˩hĩ˩	m ɤ ˧ k v̩ ˩ h ĩ ˩  
mɤ˧kʰɯ˧˥	m ɤ ˧ kʰ ɯ ˧˥  
mɤ˧ni˩ni˩hĩ˩	m ɤ ˧ n i ˩ n i ˩ h ĩ ˩  
mɤ˧nɑ˩	m ɤ ˧ n ɑ ˩  
mɤ˧po˧se˥	m ɤ ˧ p o ˧ s e ˥  
mɤ˧pʰv̩˧ɖɯ˧hĩ˥	m ɤ ˧ pʰ v̩ ˧ ɖ ɯ ˧ h ĩ ˥  
mɤ˧qʰæ˧hĩ˧ʈʂʰɯ˧	m ɤ ˧ qʰ æ ˧ h ĩ ˧ ʈʂʰ ɯ ˧  
mɤ˧qʰæ˩	m ɤ ˧ qʰ æ ˩  
mɤ˧sɯ˥dʑo˩	m ɤ ˧ s ɯ ˥ dʑ o ˩  
mɤ˧sɯ˥ze˩mæ˩	m ɤ ˧ s ɯ ˥ z e ˩ m æ ˩  
mɤ˧sɯ˧hĩ˧ki˧	m ɤ ˧ s ɯ ˧ h ĩ ˧ k i ˧  
mɤ˧sɯ˧sɯ˥	m ɤ ˧ s ɯ ˧ s ɯ ˥  
mɤ˧sɯ˧ɲi˥ze˩mæ˩	m ɤ ˧ s ɯ ˧ ɲ i ˥ z e ˩ m æ ˩  
mɤ˧ti˩	m ɤ ˧ t i ˩  
mɤ˧tsɑ˧bi˥	m ɤ ˧ ts ɑ ˧ b i ˥  
mɤ˧tsʰɯ˩	m ɤ ˧ tsʰ ɯ ˩  
mɤ˧tv̩˧ɲi˥	m ɤ ˧ t v̩ ˧ ɲ i ˥  
mɤ˧tɑ˩hwɤ˩ze˩	m ɤ ˧ t ɑ ˩ h wɤ ˩ z e ˩  
mɤ˧tɕɯ˧˥	m ɤ ˧ tɕ ɯ ˧˥  
mɤ˧tɕʰi˧ze˧	m ɤ ˧ tɕʰ i ˧ z e ˧  
mɤ˧tɕʰi˧ɲi˥tsɯ˩	m ɤ ˧ tɕʰ i ˧ ɲ i ˥ ts ɯ ˩  
mɤ˧tɕʰi˧ɳɯ˧	m ɤ ˧ tɕʰ i ˧ ɳ ɯ ˧  
mɤ˧tɕʰo˧hĩ˥	m ɤ ˧ tɕʰ o ˧ h ĩ ˥  
mɤ˧tʰo˥	m ɤ ˧ tʰ o ˥  
mɤ˧tʰv̩˧	m ɤ ˧ tʰ v̩ ˧  
mɤ˧tʰv̩˧ɲi˥dʑo˩	m ɤ ˧ tʰ v̩ ˧ ɲ i ˥ dʑ o ˩  
mɤ˧tʰɑ˧hĩ˧	m ɤ ˧ tʰ ɑ ˧ h ĩ ˧  
mɤ˧tʰɑ˧ze˥	m ɤ ˧ tʰ ɑ ˧ z e ˥  
mɤ˧tʰɑ˧ɲi˥	m ɤ ˧ tʰ ɑ ˧ ɲ i ˥  
mɤ˧tʰɑ˧ɲi˥kv̩˩	m ɤ ˧ tʰ ɑ ˧ ɲ i ˥ k v̩ ˩  
mɤ˧tʰɑ˧ɲi˥wɤ˩	m ɤ ˧ tʰ ɑ ˧ ɲ i ˥ wɤ ˩  
mɤ˧tʰɑ˧ɻ̍˥	m ɤ ˧ tʰ ɑ ˧ ɻ̍ ˥  
mɤ˧ze˩	m ɤ ˧ z e ˩  
mɤ˧ŋv̩˩tsɯ˩	m ɤ ˧ ŋ v̩ ˩ ts ɯ ˩  
mɤ˧ɖwæ˩ze˩pi˩tsɯ˩	m ɤ ˧ ɖ wæ ˩ z e ˩ p i ˩ ts ɯ ˩  
mɤ˧ɖɯ˧ɲi˥tsɯ˩	m ɤ ˧ ɖ ɯ ˧ ɲ i ˥ ts ɯ ˩  
mɤ˧ɖɯ˧ɲi˥wɤ˩	m ɤ ˧ ɖ ɯ ˧ ɲ i ˥ wɤ ˩  
mɤ˧ɖʐo˧	m ɤ ˧ ɖʐ o ˧  
mɤ˧ɲi˥dʑo˩	m ɤ ˧ ɲ i ˥ dʑ o ˩  
mɤ˧ɲi˥hĩ˩	m ɤ ˧ ɲ i ˥ h ĩ ˩  
mɤ˧ɲi˥kv̩˩tsɯ˩	m ɤ ˧ ɲ i ˥ k v̩ ˩ ts ɯ ˩  
mɤ˧ɲi˥mæ˩	m ɤ ˧ ɲ i ˥ m æ ˩  
mɤ˧ɲi˩mæ˩	m ɤ ˧ ɲ i ˩ m æ ˩  
mɤ˧ɲi˩ze˩wɤ˩	m ɤ ˧ ɲ i ˩ z e ˩ wɤ ˩  
mɤ˧ɲi˩zo˩	m ɤ ˧ ɲ i ˩ z o ˩  
mɤ˧ɳv̩˥	m ɤ ˧ ɳ v̩ ˥  
mɤ˧ʁo˥pv̩˩	m ɤ ˧ ʁ o ˥ p v̩ ˩  
mɤ˧ʁɑ˧hĩ˧	m ɤ ˧ ʁ ɑ ˧ h ĩ ˧  
mɤ˧ʂɯ˥ʂɯ˩	m ɤ ˧ ʂ ɯ ˥ ʂ ɯ ˩  
mɤ˧ʂɯ˧zo˩	m ɤ ˧ ʂ ɯ ˧ z o ˩  
mɤ˧ʈwɤ˧	m ɤ ˧ ʈ wɤ ˧  
mɤ˧ʈʂɤ˥ʈʂɤ˩	m ɤ ˧ ʈʂ ɤ ˥ ʈʂ ɤ ˩  
mɤ˧ʈʂɤ˧zo˩	m ɤ ˧ ʈʂ ɤ ˧ z o ˩  
mɤ˧ʈʂɤ˧ɲi˥	m ɤ ˧ ʈʂ ɤ ˧ ɲ i ˥  
mɤ˧ʈʂʰæ˧ʈʂʰæ˧	m ɤ ˧ ʈʂʰ æ ˧ ʈʂʰ æ ˧  
mɤ˧ʐwɤ˩zo˩	m ɤ ˧ ʐ wɤ ˩ z o ˩  
mɤ˧ʝi˥	m ɤ ˧ ʝ i ˥  
mɤ˧ʝi˧wɤ˧	m ɤ ˧ ʝ i ˧ wɤ ˧  
mɤ˧ʝi˧ɲi˥	m ɤ ˧ ʝ i ˧ ɲ i ˥  
mɤ˩dʑo˩dʑo˩	m ɤ ˩ dʑ o ˩ dʑ o ˩  
mɤ˩gv̩˩pi˩	m ɤ ˩ g v̩ ˩ p i ˩  
mɤ˩ki˩	m ɤ ˩ k i ˩  
mɤ˩kv̩˥	m ɤ ˩ k v̩ ˥  
mɤ˩kv̩˩mæ˩	m ɤ ˩ k v̩ ˩ m æ ˩  
mɤ˩kv̩˩tsɯ˩pi˩	m ɤ ˩ k v̩ ˩ ts ɯ ˩ p i ˩  
mɤ˩mv̩˩ʈʂʰɯ˥	m ɤ ˩ m v̩ ˩ ʈʂʰ ɯ ˥  
mɤ˩mv̩˩˥	m ɤ ˩ m v̩ ˩˥  
mɤ˩so˩hĩ˩ɖʐɯ˩kʰɤ˩	m ɤ ˩ s o ˩ h ĩ ˩ ɖʐ ɯ ˩ kʰ ɤ ˩  
mɤ˩ɖo˩˥	m ɤ ˩ ɖ o ˩˥  
mɤ˩ɖɯ˩	m ɤ ˩ ɖ ɯ ˩  
mɤ˩ɲi˥zo˩	m ɤ ˩ ɲ i ˥ z o ˩  
mɤ˩ɲi˩mæ˩	m ɤ ˩ ɲ i ˩ m æ ˩  
mɤ˩ɲi˩zo˩	m ɤ ˩ ɲ i ˩ z o ˩  
mɤ˩ʁo˩	m ɤ ˩ ʁ o ˩  
ni˧fv̩˥	n i ˧ f v̩ ˥  
ni˧fv̩˥tʰv̩˩	n i ˧ f v̩ ˥ tʰ v̩ ˩  
ni˧mi˧	n i ˧ m i ˧  
ni˧mi˧ki˧dʑo˩	n i ˧ m i ˧ k i ˧ dʑ o ˩  
ni˧tsi˧kv̩˧˥	n i ˧ ts i ˧ k v̩ ˧˥  
ni˧ɻæ˥	n i ˧ ɻ æ ˥  
ni˧ʈʂʰɯ˥dʑo˩	n i ˧ ʈʂʰ ɯ ˥ dʑ o ˩  
ni˧ʈʂʰɯ˧dʑo˩	n i ˧ ʈʂʰ ɯ ˧ dʑ o ˩  
ni˧˥	n i ˧˥  
ni˩	n i ˩  
ni˩zo˩	n i ˩ z o ˩  
njæ˧sɯ˩kv̩˩dʑ	n jæ ˧ s ɯ ˩ k v̩ ˩ dʑ  
njæ˧sɯ˩kv̩˩ɳɯ˩	n jæ ˧ s ɯ ˩ k v̩ ˩ ɳ ɯ ˩  
njæ˧sɯ˩kv̩˩ʁwɤ˩qo˩	n jæ ˧ s ɯ ˩ k v̩ ˩ ʁ wɤ ˩ q o ˩  
njæ˧ɻæ˩	n jæ ˧ ɻ æ ˩  
njæ˧ɻæ˩dʑo˩	n jæ ˧ ɻ æ ˩ dʑ o ˩  
njæ˧ɻæ˩se˩	n jæ ˧ ɻ æ ˩ s e ˩  
njæ˧ɻ̍˩dʑo˩	n jæ ˧ ɻ̍ ˩ dʑ o ˩  
njæ˩sɯ˩kv̩˩ki˩	n jæ ˩ s ɯ ˩ k v̩ ˩ k i ˩  
njɤ˧dʑo˥	n jɤ ˧ dʑ o ˥  
njɤ˧mv̩˩	n jɤ ˧ m v̩ ˩  
njɤ˧pʰi˩	n jɤ ˧ pʰ i ˩  
njɤ˧qɑ˥	n jɤ ˧ q ɑ ˥  
njɤ˧qɑ˩	n jɤ ˧ q ɑ ˩  
njɤ˧sɯ˩kv̩˩	n jɤ ˧ s ɯ ˩ k v̩ ˩  
njɤ˧sɯ˩kv̩˩bv̩˩	n jɤ ˧ s ɯ ˩ k v̩ ˩ b v̩ ˩  
njɤ˧ə˧mɑ˧	n jɤ ˧ ə ˧ m ɑ ˧  
njɤ˧ɳɯ˧dʑo˥	n jɤ ˧ ɳ ɯ ˧ dʑ o ˥  
njɤ˩lɑ˥	n jɤ ˩ l ɑ ˥  
njɤ˩lɑ˩	n jɤ ˩ l ɑ ˩  
njɤ˩njɤ˧	n jɤ ˩ n jɤ ˧  
nn	n n  
nnn	n n n  
no	n o  
no˧ki˧dʑo˩	n o ˧ k i ˧ dʑ o ˩  
no˧ni˩zo˩	n o ˧ n i ˩ z o ˩  
no˧sɯ˩kv̩˩dʑo˩	n o ˧ s ɯ ˩ k v̩ ˩ dʑ o ˩  
no˧sɯ˩kv̩˩ki˩	n o ˧ s ɯ ˩ k v̩ ˩ k i ˩  
no˧sɯ˩kv̩˩ni˩gv̩˩	n o ˧ s ɯ ˩ k v̩ ˩ n i ˩ g v̩ ˩  
no˧tɑ˧kɤ˥	n o ˧ t ɑ ˧ k ɤ ˥  
no˧zɯ˩	n o ˧ z ɯ ˩  
no˧ɻ˩	n o ˧ ɻ ˩  
no˧ɻ̍˩ɳɯ˩	n o ˧ ɻ̍ ˩ ɳ ɯ ˩  
no˧ʁo˧to˩	n o ˧ ʁ o ˧ t o ˩  
no˩dʑo˥	n o ˩ dʑ o ˥  
no˩dʑo˧	n o ˩ dʑ o ˧  
no˩tɑ˩kɤ˥	n o ˩ t ɑ ˩ k ɤ ˥  
no˩zɯ˧tɑ˧kɤ˥	n o ˩ z ɯ ˧ t ɑ ˧ k ɤ ˥  
nv̩˧hṽ̩˩	n v̩ ˧ h ṽ̩ ˩  
nv̩˧tv̩˥ʈʂʰɯ˩	n v̩ ˧ t v̩ ˥ ʈʂʰ ɯ ˩  
nv̩˩dʑɯ˥ʈʂʰɯ˩	n v̩ ˩ dʑ ɯ ˥ ʈʂʰ ɯ ˩  
nv̩˩mi˩	n v̩ ˩ m i ˩  
nv̩˩ɭɯ˥	n v̩ ˩ ɭ ɯ ˥  
nv̩˩ɭɯ˥ʈʂʰɯ˩	n v̩ ˩ ɭ ɯ ˥ ʈʂʰ ɯ ˩  
næ˩qʰæ˥ʈʂʰe˩hĩ˩	n æ ˩ qʰ æ ˥ ʈʂʰ e ˩ h ĩ ˩  
næ˩qʰæ˥ʈʂʰe˩zo˩	n æ ˩ qʰ æ ˥ ʈʂʰ e ˩ z o ˩  
nɑ˧mi˧	n ɑ ˧ m i ˧  
nɑ˩dzi˧kwɤ˩tɕɯ˩lɑ˩	n ɑ ˩ dz i ˧ k wɤ ˩ tɕ ɯ ˩ l ɑ ˩  
nɑ˩dʑi˥dʑo˩	n ɑ ˩ dʑ i ˥ dʑ o ˩  
nɑ˩dʑi˧	n ɑ ˩ dʑ i ˧  
nɑ˩dʑi˧hṽ̩˧	n ɑ ˩ dʑ i ˧ h ṽ̩ ˧  
nɑ˩dʑo˥	n ɑ ˩ dʑ o ˥  
nɑ˩hɑ˥dʑo˩	n ɑ ˩ h ɑ ˥ dʑ o ˩  
nɑ˩hɑ˧	n ɑ ˩ h ɑ ˧  
nɑ˩nɑ˧	n ɑ ˩ n ɑ ˧  
nɑ˩ts	n ɑ ˩ ts  
nɑ˩tsʰi˩ki˥	n ɑ ˩ tsʰ i ˩ k i ˥  
nɑ˩tsʰi˩ki˥ɳɯ˩	n ɑ ˩ tsʰ i ˩ k i ˥ ɳ ɯ ˩  
nɑ˩ʈʂʰɯ˧	n ɑ ˩ ʈʂʰ ɯ ˧  
nɑ˩ʈʂʰɯ˧dʑo˩	n ɑ ˩ ʈʂʰ ɯ ˧ dʑ o ˩  
nɑ˩ʐwɤ˥pi˩dʑo˩	n ɑ ˩ ʐ wɤ ˥ p i ˩ dʑ o ˩  
õ˧go˧mi˥	õ ˧ g o ˧ m i ˥  
õ˧so˥ɳɯ˩	õ ˧ s o ˥ ɳ ɯ ˩  
õ˧tɑ˧kɤ˥	õ ˧ t ɑ ˧ k ɤ ˥  
õ˧tʰv̩˧ne˧	õ ˧ tʰ v̩ ˧ n e ˧  
õ˧tʰv̩˧so˩dʑo˩	õ ˧ tʰ v̩ ˧ s o ˩ dʑ o ˩  
õ˧tʰv̩˧ʑi˥ki˩	õ ˧ tʰ v̩ ˧ ʑ i ˥ k i ˩  
õ˧ə˧mi˥	õ ˧ ə ˧ m i ˥  
õ˧ɬi˧qʰv̩˧ɳɯ˩	õ ˧ ɬ i ˧ qʰ v̩ ˧ ɳ ɯ ˩  
õ˧ɳɯ˥	õ ˧ ɳ ɯ ˥  
õ˧ʈʂwɤ˧	õ ˧ ʈʂ wɤ ˧  
õ˧ʈʂʰɯ˧bæ˧	õ ˧ ʈʂʰ ɯ ˧ b æ ˧  
õ˧ʈʂʰɯ˧dʑo˩	õ ˧ ʈʂʰ ɯ ˧ dʑ o ˩  
õ˧ʈʂʰɯ˧lɑ˥	õ ˧ ʈʂʰ ɯ ˧ l ɑ ˥  
õ˧ʈʂʰɯ˧lɑ˩	õ ˧ ʈʂʰ ɯ ˧ l ɑ ˩  
õ˧ʈʂʰɯ˧ne˧ʝi˥kwɤ˩tɕɯ˩lɑ˩	õ ˧ ʈʂʰ ɯ ˧ n e ˧ ʝ i ˥ k wɤ ˩ tɕ ɯ ˩ l ɑ ˩  
õ˧ʈʂʰɯ˧ne˧ʝi˥zo˩	õ ˧ ʈʂʰ ɯ ˧ n e ˧ ʝ i ˥ z o ˩  
õ˧ʈʂʰɯ˧ɲi˧ʑi˩	õ ˧ ʈʂʰ ɯ ˧ ɲ i ˧ ʑ i ˩  
õ˧ʈʂʰɯ˧ɻæ˥	õ ˧ ʈʂʰ ɯ ˧ ɻ æ ˥  
õ˧ʈʂʰɯ˧ʑ	õ ˧ ʈʂʰ ɯ ˧ ʑ  
pi˥kv̩˩mæ˩	p i ˥ k v̩ ˩ m æ ˩  
pi˥ɲi˩ze˩mæ˩	p i ˥ ɲ i ˩ z e ˩ m æ ˩  
pi˧bi˧	p i ˧ b i ˧  
pi˧di˧˥	p i ˧ d i ˧˥  
pi˧hĩ˧dʑo˩	p i ˧ h ĩ ˧ dʑ o ˩  
pi˧hĩ˧tʰv̩˥dʑo˩	p i ˧ h ĩ ˧ tʰ v̩ ˥ dʑ o ˩  
pi˧hĩ˧tʰv̩˧ɳɯ˩	p i ˧ h ĩ ˧ tʰ v̩ ˧ ɳ ɯ ˩  
pi˧hĩ˩ʈʂʰɯ˩dʑo˩	p i ˧ h ĩ ˩ ʈʂʰ ɯ ˩ dʑ o ˩  
pi˧kv̩˥mæ˩	p i ˧ k v̩ ˥ m æ ˩  
pi˧kv̩˩mv̩˩	p i ˧ k v̩ ˩ m v̩ ˩  
pi˧kv̩˩ni˩	p i ˧ k v̩ ˩ n i ˩  
pi˧kv̩˩tsɯ˩mv̩˩	p i ˧ k v̩ ˩ ts ɯ ˩ m v̩ ˩  
pi˧mv̩˩	p i ˧ m v̩ ˩  
pi˧tsɯ˩mv̩˩	p i ˧ ts ɯ ˩ m v̩ ˩  
pi˧zo˩dʑo˩	p i ˧ z o ˩ dʑ o ˩  
pi˧ɲi˥tsɯ˩mv̩˩	p i ˧ ɲ i ˥ ts ɯ ˩ m v̩ ˩  
pi˧ɲi˥tsɯ˩mæ˩	p i ˧ ɲ i ˥ ts ɯ ˩ m æ ˩  
pi˧ɲi˥ze˩mæ˩	p i ˧ ɲ i ˥ z e ˩ m æ ˩  
pi˩dʑo˩	p i ˩ dʑ o ˩  
pi˩hĩ˩qo˥dʑo˩	p i ˩ h ĩ ˩ q o ˥ dʑ o ˩  
pi˩hĩ˩ʈʂʰɯ˩dʑo˩	p i ˩ h ĩ ˩ ʈʂʰ ɯ ˩ dʑ o ˩  
pi˩kv̩˩	p i ˩ k v̩ ˩  
pi˩wɤ˩	p i ˩ wɤ ˩  
pi˩ze˩	p i ˩ z e ˩  
pi˩ɲi˩ze˩	p i ˩ ɲ i ˩ z e ˩  
po	p o  
po˥bi˩kv̩˩	p o ˥ b i ˩ k v̩ ˩  
po˥jo˩kv̩˩	p o ˥ jo ˩ k v̩ ˩  
po˥jo˩kv̩˩mæ˩	p o ˥ jo ˩ k v̩ ˩ m æ ˩  
po˥ɳɯ˩	p o ˥ ɳ ɯ ˩  
po˧	p o ˧  
po˧hĩ˥	p o ˧ h ĩ ˥  
po˧hɯ˧ɲi˥	p o ˧ h ɯ ˧ ɲ i ˥  
po˧hɯ˧ɲi˥mæ˩	p o ˧ h ɯ ˧ ɲ i ˥ m æ ˩  
po˧jo˥	p o ˧ jo ˥  
po˧jo˥kv̩˩mæ˩	p o ˧ jo ˥ k v̩ ˩ m æ ˩  
po˧kʰi˥	p o ˧ kʰ i ˥  
po˧tso˧ɲi˥ze˩	p o ˧ ts o ˧ ɲ i ˥ z e ˩  
po˧tsʰɯ˧ɻ̩˥	p o ˧ tsʰ ɯ ˧ ɻ̩ ˥  
po˧ʁo˧ɲi˥tsɯ˩	p o ˧ ʁ o ˧ ɲ i ˥ ts ɯ ˩  
po˧ʂæ˧pi˧hĩ˧	p o ˧ ʂ æ ˧ p i ˧ h ĩ ˧  
po˩bi˩	p o ˩ b i ˩  
po˩tsʰɯ˩pi˩	p o ˩ tsʰ ɯ ˩ p i ˩  
po˩˥	p o ˩˥  
pv	p v  
pv̩˥mɤ˩kv̩˩	p v̩ ˥ m ɤ ˩ k v̩ ˩  
pv̩˧hĩ˧lɑ˩	p v̩ ˧ h ĩ ˧ l ɑ ˩  
pv̩˩ho˩pʰæ˩di˩	p v̩ ˩ h o ˩ pʰ æ ˩ d i ˩  
pv̩˩kʰɯ˥ɲi˩mæ˩	p v̩ ˩ kʰ ɯ ˥ ɲ i ˩ m æ ˩  
pv̩˩mɤ˩kv̩˩	p v̩ ˩ m ɤ ˩ k v̩ ˩  
pv̩˩mɤ˩ʝi˩	p v̩ ˩ m ɤ ˩ ʝ i ˩  
pæ˧pæ˧sɯ˧	p æ ˧ p æ ˧ s ɯ ˧  
pæ˧wo˧ho˥	p æ ˧ w o ˧ h o ˥  
pæ˧ɻæ˩ʈʂʰo˩	p æ ˧ ɻ æ ˩ ʈʂʰ o ˩  
pæ˧ɻæ˩ʈʂʰo˩ɳɯ˩	p æ ˧ ɻ æ ˩ ʈʂʰ o ˩ ɳ ɯ ˩  
pæ˩pʰæ˧	p æ ˩ pʰ æ ˧  
pɑ˩ʂɯ˧	p ɑ ˩ ʂ ɯ ˧  
pɑ˩ʂɯ˧tɕo˥hĩ˩	p ɑ ˩ ʂ ɯ ˧ tɕ o ˥ h ĩ ˩  
pɤ˧pɤ˥	p ɤ ˧ p ɤ ˥  
pɤ˧ʈʂʰɯ˧	p ɤ ˧ ʈʂʰ ɯ ˧  
pɤ˩jɤ˧qo˥ho˩	p ɤ ˩ jɤ ˧ q o ˥ h o ˩  
pɤ˩pɤ˩	p ɤ ˩ p ɤ ˩  
pʰe	pʰ e  
pʰi	pʰ i  
pʰi˧ʈʂæ˧	pʰ i ˧ ʈʂ æ ˧  
pʰi˩hæ˩˥	pʰ i ˩ h æ ˩˥  
pʰi˩ʈʰæ˩qʰwɤ˥lɑ˩	pʰ i ˩ ʈʰ æ ˩ qʰ wɤ ˥ l ɑ ˩  
pʰo˥	pʰ o ˥  
pʰo˥hĩ˩	pʰ o ˥ h ĩ ˩  
pʰo˥ɲi˩	pʰ o ˥ ɲ i ˩  
pʰo˧kv̩˥	pʰ o ˧ k v̩ ˥  
pʰo˧˥	pʰ o ˧˥  
pʰo˩bi˩	pʰ o ˩ b i ˩  
pʰo˩tsɯ˥	pʰ o ˩ ts ɯ ˥  
pʰo˩ɲi˥pi˩tsɯ˩	pʰ o ˩ ɲ i ˥ p i ˩ ts ɯ ˩  
pʰo˩ɲi˩	pʰ o ˩ ɲ i ˩  
pʰv̩˥kv̩˩	pʰ v̩ ˥ k v̩ ˩  
pʰv̩˧tsɯ˥	pʰ v̩ ˧ ts ɯ ˥  
pʰv̩˧tɕæ˥ɻæ˩	pʰ v̩ ˧ tɕ æ ˥ ɻ æ ˩  
pʰv̩˧tɕæ˥ɻæ˩ʈʂʰɯ˩	pʰ v̩ ˧ tɕ æ ˥ ɻ æ ˩ ʈʂʰ ɯ ˩  
pʰv̩˧ze˥tsɯ˩mæ˩	pʰ v̩ ˧ z e ˥ ts ɯ ˩ m æ ˩  
pʰv̩˧ɖɯ˧kv̩˥	pʰ v̩ ˧ ɖ ɯ ˧ k v̩ ˥  
pʰv̩˧ɖɯ˧ʝi˥kv̩˩mæ˩	pʰ v̩ ˧ ɖ ɯ ˧ ʝ i ˥ k v̩ ˩ m æ ˩  
pʰv̩˧ɖɯ˧˥	pʰ v̩ ˧ ɖ ɯ ˧˥  
pʰv̩˧ʈʂʰe˩kv̩˩ze˩	pʰ v̩ ˧ ʈʂʰ e ˩ k v̩ ˩ z e ˩  
pʰv̩˧ʈʂʰɯ˧	pʰ v̩ ˧ ʈʂʰ ɯ ˧  
pʰv̩˧˥	pʰ v̩ ˧˥  
pʰv̩˩hĩ˩tʰv̩˩ʁo˥	pʰ v̩ ˩ h ĩ ˩ tʰ v̩ ˩ ʁ o ˥  
pʰv̩˩tɕæ˥ɻæ˩gv̩˩ze˩kv̩˩ze˩mæ˩	pʰ v̩ ˩ tɕ æ ˥ ɻ æ ˩ g v̩ ˩ z e ˩ k v̩ ˩ z e ˩ m æ ˩  
pʰv̩˩tɕæ˩ɻæ˥	pʰ v̩ ˩ tɕ æ ˩ ɻ æ ˥  
pʰv̩˩tɕæ˩ɻæ˥tʰv̩˩	pʰ v̩ ˩ tɕ æ ˩ ɻ æ ˥ tʰ v̩ ˩  
pʰv̩˩ɖɯ˩	pʰ v̩ ˩ ɖ ɯ ˩  
pʰæ˧	pʰ æ ˧  
pʰæ˧qʰwɤ˩ʈʂʰɯ˩	pʰ æ ˧ qʰ wɤ ˩ ʈʂʰ ɯ ˩  
pʰæ˧tɕi˥dʑo˩	pʰ æ ˧ tɕ i ˥ dʑ o ˩  
pʰæ˧tɕi˥zo˩	pʰ æ ˧ tɕ i ˥ z o ˩  
pʰæ˧tɕi˥ɳɯ˩	pʰ æ ˧ tɕ i ˥ ɳ ɯ ˩  
pʰæ˧tɕi˥ɻæ˩	pʰ æ ˧ tɕ i ˥ ɻ æ ˩  
pʰæ˧tɕi˥ɻæ˩dʑo˩	pʰ æ ˧ tɕ i ˥ ɻ æ ˩ dʑ o ˩  
pʰɑ˩sɑ˩sɑ˩˥	pʰ ɑ ˩ s ɑ ˩ s ɑ ˩˥  
pʰɤ˩bɤ˩	pʰ ɤ ˩ b ɤ ˩  
q	q  
qi˧qi˧dʑo˧	q i ˧ q i ˧ dʑ o ˧  
qo˧bɤ˧dʑo˩	q o ˧ b ɤ ˧ dʑ o ˩  
qo˧ɻ̍˧ʁo˧qʰwɤ˥	q o ˧ ɻ̍ ˧ ʁ o ˧ qʰ wɤ ˥  
qo˩hĩ˩	q o ˩ h ĩ ˩  
qo˩ho˧˥	q o ˩ h o ˧˥  
qo˩qɑ˩ɳɯ˥	q o ˩ q ɑ ˩ ɳ ɯ ˥  
qo˩qɑ˩ʁo˥	q o ˩ q ɑ ˩ ʁ o ˥  
qo˩qɑ˩ʈʰæ˩qo˥	q o ˩ q ɑ ˩ ʈʰ æ ˩ q o ˥  
qo˩tv̩˥	q o ˩ t v̩ ˥  
qv	q v  
qv̩˧dzi˩ʈʰæ˩qo˩	q v̩ ˧ dz i ˩ ʈʰ æ ˩ q o ˩  
qv̩˧ɻ̍˧ki˧	q v̩ ˧ ɻ̍ ˧ k i ˧  
qv̩˧ɻ̍˧ʁo˧qʰwɤ˥ʈʂʰɯ˩	q v̩ ˧ ɻ̍ ˧ ʁ o ˧ qʰ wɤ ˥ ʈʂʰ ɯ ˩  
qv̩˧ɻ̍˧ʁo˧to˩	q v̩ ˧ ɻ̍ ˧ ʁ o ˧ t o ˩  
qv̩˧ɻ̍˧ʈʂʰæ˧nɑ˥dʑɯ˩	q v̩ ˧ ɻ̍ ˧ ʈʂʰ æ ˧ n ɑ ˥ dʑ ɯ ˩  
qv̩˧ɻ̍˧ʈʂʰɯ˧	q v̩ ˧ ɻ̍ ˧ ʈʂʰ ɯ ˧  
qv̩˧ʈʂæ˧qo˥	q v̩ ˧ ʈʂ æ ˧ q o ˥  
qwæ˥dʑo˩	q wæ ˥ dʑ o ˩  
qwæ˧	q wæ ˧  
qwæ˧ʁo˧	q wæ ˧ ʁ o ˧  
qwæ˩bi˩	q wæ ˩ b i ˩  
qwæ˩bi˩dʑo˩	q wæ ˩ b i ˩ dʑ o ˩  
qwæ˩bi˩kv̩˩ze˩	q wæ ˩ b i ˩ k v̩ ˩ z e ˩  
qwæ˩hĩ˩lɑ˩	q wæ ˩ h ĩ ˩ l ɑ ˩  
qwæ˩qwæ˧˥	q wæ ˩ q wæ ˧˥  
qwæ˩se˩	q wæ ˩ s e ˩  
qwæ˩ɖʐæ˩qo˥	q wæ ˩ ɖʐ æ ˩ q o ˥  
qwæ˩ʈʂæ˩qo˥	q wæ ˩ ʈʂ æ ˩ q o ˥  
qwɤ˧qo˧	q wɤ ˧ q o ˧  
qwɤ˧ɭɯ˧	q wɤ ˧ ɭ ɯ ˧  
qæ˥ɲi˩tsɯ˩	q æ ˥ ɲ i ˩ ts ɯ ˩  
qæ˧di˧	q æ ˧ d i ˧  
qæ˧do˧dʑo˥	q æ ˧ d o ˧ dʑ o ˥  
qæ˧do˧sɯ˥	q æ ˧ d o ˧ s ɯ ˥  
qæ˧ho˥	q æ ˧ h o ˥  
qæ˧kv̩˥	q æ ˧ k v̩ ˥  
qæ˧kʰɯ˩ze˩	q æ ˧ kʰ ɯ ˩ z e ˩  
qæ˧pi˥kv̩˩mæ˩	q æ ˧ p i ˥ k v̩ ˩ m æ ˩  
qæ˧qæ˧tɕɯ˩zo˩	q æ ˧ q æ ˧ tɕ ɯ ˩ z o ˩  
qæ˧qæ˧ɲi˥	q æ ˧ q æ ˧ ɲ i ˥  
qæ˧˥	q æ ˧˥  
qæ˩tsɯ˩	q æ ˩ ts ɯ ˩  
qɑ˧kv̩˥	q ɑ ˧ k v̩ ˥  
qɑ˧qɑ˥bi˩	q ɑ ˧ q ɑ ˥ b i ˩  
qɑ˧qɑ˧ɻ̍˥	q ɑ ˧ q ɑ ˧ ɻ̍ ˥  
qɑ˧ɻ˥	q ɑ ˧ ɻ ˥  
qɑ˩qɑ˧bi˧	q ɑ ˩ q ɑ ˧ b i ˧  
qɑ˩qɑ˩	q ɑ ˩ q ɑ ˩  
qʰo˧bi˧bi˧	qʰ o ˧ b i ˧ b i ˧  
qʰo˧kv̩˥	qʰ o ˧ k v̩ ˥  
qʰo˧kv̩˥ze˩mæ˩	qʰ o ˧ k v̩ ˥ z e ˩ m æ ˩  
qʰo˧se˥kwɤ˩tɕɯ˩lɑ˩	qʰ o ˧ s e ˥ k wɤ ˩ tɕ ɯ ˩ l ɑ ˩  
qʰv̩˧kv̩˥	qʰ v̩ ˧ k v̩ ˥  
qʰv̩˧kv̩˧hĩ˧tʰv̩˧	qʰ v̩ ˧ k v̩ ˧ h ĩ ˧ tʰ v̩ ˧  
qʰv̩˧kʰv̩˥ʂɯ˩kʰv̩˩	qʰ v̩ ˧ kʰ v̩ ˥ ʂ ɯ ˩ kʰ v̩ ˩  
qʰv̩˧zo˥	qʰ v̩ ˧ z o ˥  
qʰv̩˧ɬi˧mi˧kʰɤ˧ʂɯ˧	qʰ v̩ ˧ ɬ i ˧ m i ˧ kʰ ɤ ˧ ʂ ɯ ˧  
qʰv̩˧ɭɯ˥qo˩	qʰ v̩ ˧ ɭ ɯ ˥ q o ˩  
qʰv̩˧˥	qʰ v̩ ˧˥  
qʰv̩˩tsʰi˧kʰv̩˥hĩ˩bv̩˩	qʰ v̩ ˩ tsʰ i ˧ kʰ v̩ ˥ h ĩ ˩ b v̩ ˩  
qʰv̩˩tsʰi˧kʰv̩˥ʁo˩to˩	qʰ v̩ ˩ tsʰ i ˧ kʰ v̩ ˥ ʁ o ˩ t o ˩  
qʰwæ˧kʰwɤ˧	qʰ wæ ˧ kʰ wɤ ˧  
qʰwæ˧mi˧	qʰ wæ ˧ m i ˧  
qʰwæ˩	qʰ wæ ˩  
qʰwæ˩qʰwæ˩	qʰ wæ ˩ qʰ wæ ˩  
qʰwɤ˧hĩ˥	qʰ wɤ ˧ h ĩ ˥  
qʰwɤ˧pɤ˥	qʰ wɤ ˧ p ɤ ˥  
qʰwɤ˧zo˥	qʰ wɤ ˧ z o ˥  
qʰwɤ˩	qʰ wɤ ˩  
qʰwɤ˩hĩ˩˥	qʰ wɤ ˩ h ĩ ˩˥  
qʰwɤ˩ɖɯ˩˥	qʰ wɤ ˩ ɖ ɯ ˩˥  
qʰwɤ˩ɲi˥	qʰ wɤ ˩ ɲ i ˥  
qʰæ˥bi˩zo˩kv̩˩ze˩mæ˩	qʰ æ ˥ b i ˩ z o ˩ k v̩ ˩ z e ˩ m æ ˩  
qʰæ˥bi˩zo˩ʝi˩	qʰ æ ˥ b i ˩ z o ˩ ʝ i ˩  
qʰæ˥kv̩˩ze˩mæ˩	qʰ æ ˥ k v̩ ˩ z e ˩ m æ ˩  
qʰæ˥ɲi˩	qʰ æ ˥ ɲ i ˩  
qʰæ˧bi˥dʑo˩	qʰ æ ˧ b i ˥ dʑ o ˩  
qʰæ˧bi˧zo˧kv̩˩ze˩mæ˩	qʰ æ ˧ b i ˧ z o ˧ k v̩ ˩ z e ˩ m æ ˩  
qʰæ˧dʑo˧	qʰ æ ˧ dʑ o ˧  
qʰæ˧kv̩˥mæ˩	qʰ æ ˧ k v̩ ˥ m æ ˩  
qʰæ˧kv̩˥ze˩mæ˩	qʰ æ ˧ k v̩ ˥ z e ˩ m æ ˩  
qʰæ˧mo˩	qʰ æ ˧ m o ˩  
qʰæ˧mɤ˧bi˧ze˩tsɯ˩	qʰ æ ˧ m ɤ ˧ b i ˧ z e ˩ ts ɯ ˩  
qʰæ˧po˩ɳɯ˩	qʰ æ ˧ p o ˩ ɳ ɯ ˩  
qʰæ˧tsʰɯ˧˥	qʰ æ ˧ tsʰ ɯ ˧˥  
qʰæ˧tɕʰi˧hĩ˧	qʰ æ ˧ tɕʰ i ˧ h ĩ ˧  
qʰæ˧ʂæ˧ʂæ˧	qʰ æ ˧ ʂ æ ˧ ʂ æ ˧  
qʰæ˩qʰæ˩kv̩˩tsɯ˩	qʰ æ ˩ qʰ æ ˩ k v̩ ˩ ts ɯ ˩  
qʰæ˩ɲi˥ze˩	qʰ æ ˩ ɲ i ˥ z e ˩  
qʰɑ˧bæ˧	qʰ ɑ ˧ b æ ˧  
qʰɑ˧dze˧hɑ˧	qʰ ɑ ˧ dz e ˧ h ɑ ˧  
qʰɑ˧dze˧lv̩˧qo˧gɤ˧	qʰ ɑ ˧ dz e ˧ l v̩ ˧ q o ˧ g ɤ ˧  
qʰɑ˧jɤ˧	qʰ ɑ ˧ jɤ ˧  
qʰɑ˧tv̩˧	qʰ ɑ ˧ t v̩ ˧  
qʰɑ˧tɑ˧	qʰ ɑ ˧ t ɑ ˧  
qʰɑ˧tɑ˧qʰɑ˧tɑ˧	qʰ ɑ ˧ t ɑ ˧ qʰ ɑ ˧ t ɑ ˧  
qʰɑ˧ɖɯ˧gv̩˧	qʰ ɑ ˧ ɖ ɯ ˧ g v̩ ˧  
qʰɑ˧ɲi˧qʰɑ˩ɲi˩	qʰ ɑ ˧ ɲ i ˧ qʰ ɑ ˩ ɲ i ˩  
qʰɑ˧ʂwæ˧gv̩˧	qʰ ɑ ˧ ʂ wæ ˧ g v̩ ˧  
qʰɑ˧ʂæ˧ʂæ˧hĩ˧	qʰ ɑ ˧ ʂ æ ˧ ʂ æ ˧ h ĩ ˧  
qʰɑ˧ʂæ˧ʂæ˧zo˥	qʰ ɑ ˧ ʂ æ ˧ ʂ æ ˧ z o ˥  
qʰɑ˩	qʰ ɑ ˩  
qʰɑ˩hɑ̃˩pi˥	qʰ ɑ ˩ h ɑ̃ ˩ p i ˥  
qʰɑ˩hɑ̃˩˥	qʰ ɑ ˩ h ɑ̃ ˩˥  
qʰɑ˩jɤ˩˥	qʰ ɑ ˩ jɤ ˩˥  
qʰɑ˩kv̩˩	qʰ ɑ ˩ k v̩ ˩  
qʰɑ˩ne˩ʝi˥tso˩ɲi˩	qʰ ɑ ˩ n e ˩ ʝ i ˥ ts o ˩ ɲ i ˩  
se˥ze˩	s e ˥ z e ˩  
se˧	s e ˧  
se˧dʑo˩	s e ˧ dʑ o ˩  
se˧hɯ˩dʑo˩	s e ˧ h ɯ ˩ dʑ o ˩  
se˧kʰɯ˩ʈʂʰɯ˩	s e ˧ kʰ ɯ ˩ ʈʂʰ ɯ ˩  
se˧pʰɤ˧	s e ˧ pʰ ɤ ˧  
se˧se˥	s e ˧ s e ˥  
se˧tʰo˩	s e ˧ tʰ o ˩  
se˧ʁo˧ʝi˥	s e ˧ ʁ o ˧ ʝ i ˥  
se˩kv̩˥tsɯ˩	s e ˩ k v̩ ˥ ts ɯ ˩  
se˩kʰɯ˩	s e ˩ kʰ ɯ ˩  
se˩kʰɯ˩zo˩	s e ˩ kʰ ɯ ˩ z o ˩  
se˩tʰɑ˩kʰɯ˩	s e ˩ tʰ ɑ ˩ kʰ ɯ ˩  
se˩zo˩	s e ˩ z o ˩  
se˩zo˩ʈʂʰɯ˥dʑo˩	s e ˩ z o ˩ ʈʂʰ ɯ ˥ dʑ o ˩  
se˩ʁo˩to˩	s e ˩ ʁ o ˩ t o ˩  
si˧dzi˩ʈʰæ˩qo˩	s i ˧ dz i ˩ ʈʰ æ ˩ q o ˩  
si˧kʰɯ˧li˥nɑ˩	s i ˧ kʰ ɯ ˧ l i ˥ n ɑ ˩  
si˧kʰɯ˧ɭɯ˧bv̩˥	s i ˧ kʰ ɯ ˧ ɭ ɯ ˧ b v̩ ˥  
si˧kʰɯ˧ɭɯ˧bv̩˥pi˩	s i ˧ kʰ ɯ ˧ ɭ ɯ ˧ b v̩ ˥ p i ˩  
si˧kʰɯ˧ʈʂʰɯ˧	s i ˧ kʰ ɯ ˧ ʈʂʰ ɯ ˧  
si˧qo˩ɳɯ˩	s i ˧ q o ˩ ɳ ɯ ˩  
si˧qæ˧do˧	s i ˧ q æ ˧ d o ˧  
si˧tʰv̩˧dʑo˩	s i ˧ tʰ v̩ ˧ dʑ o ˩  
si˧tʰv̩˧ki˧ɳɯ˩	s i ˧ tʰ v̩ ˧ k i ˧ ɳ ɯ ˩  
si˧ɭɯ˧	s i ˧ ɭ ɯ ˧  
si˧ɭɯ˧ʑi˧qʰwɤ˥	s i ˧ ɭ ɯ ˧ ʑ i ˧ qʰ wɤ ˥  
si˧ɳɯ˩	s i ˧ ɳ ɯ ˩  
si˧ʁo˧si˧ɭɯ˧	s i ˧ ʁ o ˧ s i ˧ ɭ ɯ ˧  
sjæ˧pʰjɛ˧	s jæ ˧ pʰ j ɛ ˧  
so˥zo˩kv̩˩	s o ˥ z o ˩ k v̩ ˩  
so˧bæ˧	s o ˧ b æ ˧  
so˧hĩ˧lɑ˥	s o ˧ h ĩ ˧ l ɑ ˥  
so˧hwɤ˩dʑo˩	s o ˧ h wɤ ˩ dʑ o ˩  
so˧kɯ˧qo˧dʑo˧	s o ˧ k ɯ ˧ q o ˧ dʑ o ˧  
so˧pɤ˧	s o ˧ p ɤ ˧  
so˧tsʰi˧kʰv̩˧	s o ˧ tsʰ i ˧ kʰ v̩ ˧  
so˧tsʰi˧kʰv̩˧ɳɯ˥	s o ˧ tsʰ i ˧ kʰ v̩ ˧ ɳ ɯ ˥  
so˧tsʰi˧kʰɯ˩ʈʰæ˩qʰwɤ˩pi˩	s o ˧ tsʰ i ˧ kʰ ɯ ˩ ʈʰ æ ˩ qʰ wɤ ˩ p i ˩  
so˧tsʰi˧ʑi˩	s o ˧ tsʰ i ˧ ʑ i ˩  
so˧tɕʰi˧	s o ˧ tɕʰ i ˧  
so˧ɬi˧hĩ˧	s o ˧ ɬ i ˧ h ĩ ˧  
so˧ɬi˧mi˧dʑo˧	s o ˧ ɬ i ˧ m i ˧ dʑ o ˧  
so˧ɬi˧mi˧qo˧dʑo˧	s o ˧ ɬ i ˧ m i ˧ q o ˧ dʑ o ˧  
so˧ɬi˧qʰv̩˧ɬi˥dʑo˩	s o ˧ ɬ i ˧ qʰ v̩ ˧ ɬ i ˥ dʑ o ˩  
so˧ɭɯ˧hĩ˧ʈʂʰɯ˧dʑo˩	s o ˧ ɭ ɯ ˧ h ĩ ˧ ʈʂʰ ɯ ˧ dʑ o ˩  
so˧ɭɯ˧ki˧	s o ˧ ɭ ɯ ˧ k i ˧  
so˧ɭɯ˧lɑ˧	s o ˧ ɭ ɯ ˧ l ɑ ˧  
so˧ɲi˥dʑo˩	s o ˧ ɲ i ˥ dʑ o ˩  
so˧ɲi˧ki˧	s o ˧ ɲ i ˧ k i ˧  
so˧ʑi˧hĩ˧ʈʂʰɯ˧	s o ˧ ʑ i ˧ h ĩ ˧ ʈʂʰ ɯ ˧  
so˧ʝi˥	s o ˧ ʝ i ˥  
so˩dʑo˩	s o ˩ dʑ o ˩  
so˩hĩ˩ki˩	s o ˩ h ĩ ˩ k i ˩  
so˩hõ˩pi˩	s o ˩ h õ ˩ p i ˩  
so˩kv̩˩ki˥dʑo˩	s o ˩ k v̩ ˩ k i ˥ dʑ o ˩  
so˩kv̩˩lɑ˥	s o ˩ k v̩ ˩ l ɑ ˥  
so˩kv̩˩ɲi˥	s o ˩ k v̩ ˩ ɲ i ˥  
so˩kʰv̩˩	s o ˩ kʰ v̩ ˩  
so˩kʰv̩˩hĩ˥ʈʂʰɯ˩dʑo˩	s o ˩ kʰ v̩ ˩ h ĩ ˥ ʈʂʰ ɯ ˩ dʑ o ˩  
so˩kʰv̩˩˥	s o ˩ kʰ v̩ ˩˥  
so˩zo˥	s o ˩ z o ˥  
so˩zo˩kv̩˩	s o ˩ z o ˩ k v̩ ˩  
so˩æ˩	s o ˩ æ ˩  
so˩ɕi˩mæ˥	s o ˩ ɕ i ˩ m æ ˥  
so˩ɖʐɯ˩kʰɤ˩	s o ˩ ɖʐ ɯ ˩ kʰ ɤ ˩  
so˩ɲi˩	s o ˩ ɲ i ˩  
so˩ɲi˩lɑ˥	s o ˩ ɲ i ˩ l ɑ ˥  
so˩ɲi˩ʐv̩˩ɲi˩	s o ˩ ɲ i ˩ ʐ v̩ ˩ ɲ i ˩  
so˩ɲi˩˥	s o ˩ ɲ i ˩˥  
so˩ʈʂʰæ˩	s o ˩ ʈʂʰ æ ˩  
so˩ʈʂʰæ˩˥	s o ˩ ʈʂʰ æ ˩˥  
so˩˥	s o ˩˥  
sɑ˧bv̩˧	s ɑ ˧ b v̩ ˧  
sɑ˧bv̩˧ʈʂʰɯ˧	s ɑ ˧ b v̩ ˧ ʈʂʰ ɯ ˧  
sɑ˧lɑ˩	s ɑ ˧ l ɑ ˩  
sɑ˧tsʰv̩˩	s ɑ ˧ tsʰ v̩ ˩  
sɑ˧zo˩bv̩˧li˩qo˩	s ɑ ˧ z o ˩ b v̩ ˧ l i ˩ q o ˩  
sɑ˩tsʰi˩po˥ɳɯ˩	s ɑ ˩ tsʰ i ˩ p o ˥ ɳ ɯ ˩  
sɤ˧	s ɤ ˧  
sɤ˧sɯ˩	s ɤ ˧ s ɯ ˩  
sɯgɯ	s ɯ g ɯ  
sɯ˧hĩ˧dʑo˩	s ɯ ˧ h ĩ ˧ dʑ o ˩  
sɯ˧kʰɯ˩dʑo˩	s ɯ ˧ kʰ ɯ ˩ dʑ o ˩  
sɯ˧ljɤ˧tʰo˧	s ɯ ˧ l jɤ ˧ tʰ o ˧  
sɯ˧pʰi˧hɑ˩	s ɯ ˧ pʰ i ˧ h ɑ ˩  
sɯ˧pʰi˧lo˧	s ɯ ˧ pʰ i ˧ l o ˧  
sɯ˧pʰi˧ne˩ʝi˩hĩ˩	s ɯ ˧ pʰ i ˧ n e ˩ ʝ i ˩ h ĩ ˩  
sɯ˧sɯ˧hĩ˧	s ɯ ˧ s ɯ ˧ h ĩ ˧  
sɯ˧ɲi˥mæ˩	s ɯ ˧ ɲ i ˥ m æ ˩  
sɯ˧ʝi˧	s ɯ ˧ ʝ i ˧  
sɯ˩kʰwæj˧	s ɯ ˩ kʰ wæ j ˧  
sɯ˩sɯ˩dʑo˩	s ɯ ˩ s ɯ ˩ dʑ o ˩  
sɯ˩tʰi˩	s ɯ ˩ tʰ i ˩  
sɯ˩tʰi˩˥	s ɯ ˩ tʰ i ˩˥  
sɯ˩ɻ̍˩bi˩˥	s ɯ ˩ ɻ̍ ˩ b i ˩˥  
te	t e  
ti˥se˩ɳɯ˩	t i ˥ s e ˩ ɳ ɯ ˩  
ti˥zo˩kv̩˩	t i ˥ z o ˩ k v̩ ˩  
ti˧mv̩˧bv̩˧ɻ̍˧	t i ˧ m v̩ ˧ b v̩ ˧ ɻ̍ ˧  
ti˧tɕʰi˧	t i ˧ tɕʰ i ˧  
ti˩bi˩kv̩˩ze˩	t i ˩ b i ˩ k v̩ ˩ z e ˩  
ti˩hĩ˩	t i ˩ h ĩ ˩  
ti˩kv̩˩	t i ˩ k v̩ ˩  
ti˩kv̩˩mæ˩	t i ˩ k v̩ ˩ m æ ˩  
ti˩mɤ˩kv̩˥	t i ˩ m ɤ ˩ k v̩ ˥  
ti˩tjɛ˧	t i ˩ t j ɛ ˧  
ti˩zo˩kv̩˩tsɯ˩	t i ˩ z o ˩ k v̩ ˩ ts ɯ ˩  
tjɤ˧hwɑ˧lɑ˥di˩	t jɤ ˧ h wɑ ˧ l ɑ ˥ d i ˩  
tjɤ˧hwɑ˧˥	t jɤ ˧ h wɑ ˧˥  
tohõ	t o h õ  
to˩kʰv̩˩mi˥ʈʂʰɯ˩	t o ˩ kʰ v̩ ˩ m i ˥ ʈʂʰ ɯ ˩  
to˩mi˩bi˥sɯ˩	t o ˩ m i ˩ b i ˥ s ɯ ˩  
to˩mi˩ki˥	t o ˩ m i ˩ k i ˥  
to˩mi˩pi˥	t o ˩ m i ˩ p i ˥  
to˩mi˩˥	t o ˩ m i ˩˥  
to˩pv̩˥	t o ˩ p v̩ ˥  
tse˧bo˧	ts e ˧ b o ˧  
tse˩ʈʂʰv̩˩kʰv̩˥	ts e ˩ ʈʂʰ v̩ ˩ kʰ v̩ ˥  
tsi˥	ts i ˥  
tso˧kʰwɤ˧qo˩	ts o ˧ kʰ wɤ ˧ q o ˩  
tso˧qwɤ˧qo˧ɳɯ˧	ts o ˧ q wɤ ˧ q o ˧ ɳ ɯ ˧  
tso˧qʰwɤ˩	ts o ˧ qʰ wɤ ˩  
tso˧ɲi˥	ts o ˧ ɲ i ˥  
tso˧ɲi˩	ts o ˧ ɲ i ˩  
tso˩hõ˩	ts o ˩ h õ ˩  
tso˩qʰv̩˩ɻ̍˥	ts o ˩ qʰ v̩ ˩ ɻ̍ ˥  
tso˩qʰv̩˩ɻ̍˥dʑo˩	ts o ˩ qʰ v̩ ˩ ɻ̍ ˥ dʑ o ˩  
tso˩ɲi˩tsɯ˩	ts o ˩ ɲ i ˩ ts ɯ ˩  
tso˩ɲi˩tsɯ˩zo˩	ts o ˩ ɲ i ˩ ts ɯ ˩ z o ˩  
tso˩ʁo˩hĩ˥hĩ˩	ts o ˩ ʁ o ˩ h ĩ ˥ h ĩ ˩  
tsæ˥ɲi˩	ts æ ˥ ɲ i ˩  
tsɑ˧bi˥	ts ɑ ˧ b i ˥  
tsɑ˧bɤ˧ʈʂʰɯ˧	ts ɑ ˧ b ɤ ˧ ʈʂʰ ɯ ˧  
tsɑ˩tɕi˩pi˥	ts ɑ ˩ tɕ i ˩ p i ˥  
tsɤ˥ɲi˩	ts ɤ ˥ ɲ i ˩  
tsɤ˧	ts ɤ ˧  
tsɤ˧kv̩˧ze˥mæ˩	ts ɤ ˧ k v̩ ˧ z e ˥ m æ ˩  
tsɤ˧kv̩˧˥	ts ɤ ˧ k v̩ ˧˥  
tsɤ˧kv̩˩	ts ɤ ˧ k v̩ ˩  
tsɤ˧kwɤ˩tɕɯ˩lɑ˩	ts ɤ ˧ k wɤ ˩ tɕ ɯ ˩ l ɑ ˩  
tsɤ˧ze˧	ts ɤ ˧ z e ˧  
tsɤ˧ze˩	ts ɤ ˧ z e ˩  
tsɤ˧zo˩	ts ɤ ˧ z o ˩  
tsɤ˧ɲi˥kv̩˩tsɯ˩	ts ɤ ˧ ɲ i ˥ k v̩ ˩ ts ɯ ˩  
tsɤ˧ɲi˥ze˩wɤ˩	ts ɤ ˧ ɲ i ˥ z e ˩ wɤ ˩  
tsɤ˩tsɯ˩	ts ɤ ˩ ts ɯ ˩  
tsɯ˥	ts ɯ ˥  
tsɯ˧kv̩˩mæ˩	ts ɯ ˧ k v̩ ˩ m æ ˩  
tsɯ˧mɤ˥tsɯ˩	ts ɯ ˧ m ɤ ˥ ts ɯ ˩  
tsɯ˧tso˧ɲi˥	ts ɯ ˧ ts o ˧ ɲ i ˥  
tsɯ˧zo˧kv̩˩tsɯ˩	ts ɯ ˧ z o ˧ k v̩ ˩ ts ɯ ˩  
tsɯ˩mv̩˩	ts ɯ ˩ m v̩ ˩  
tsɯ˩mɤ˩tsɯ˩	ts ɯ ˩ m ɤ ˩ ts ɯ ˩  
tsʰe˧tʰv̩˧dʑo˧	tsʰ e ˧ tʰ v̩ ˧ dʑ o ˧  
tsʰe˧tʰv̩˧pi˧	tsʰ e ˧ tʰ v̩ ˧ p i ˧  
tsʰe˧ɲi˧	tsʰ e ˧ ɲ i ˧  
tsʰe˧ɲi˧ɬi˩	tsʰ e ˧ ɲ i ˧ ɬ i ˩  
tsʰe˧ɲi˧ɬi˩qo˩ɳɯ˩	tsʰ e ˧ ɲ i ˧ ɬ i ˩ q o ˩ ɳ ɯ ˩  
tsʰe˧ɲi˧ʑi˩	tsʰ e ˧ ɲ i ˧ ʑ i ˩  
tsʰe˧ɳɯ˧dʑo˥	tsʰ e ˧ ɳ ɯ ˧ dʑ o ˥  
tsʰe˧ʈʂʰɯ˧	tsʰ e ˧ ʈʂʰ ɯ ˧  
tsʰe˧ʝi˧dʑo˩	tsʰ e ˧ ʝ i ˧ dʑ o ˩  
tsʰe˩do˩hõ˥ɲi˩	tsʰ e ˩ d o ˩ h õ ˥ ɲ i ˩  
tsʰe˩hõ˩	tsʰ e ˩ h õ ˩  
tsʰe˩hõ˩kv̩˥	tsʰ e ˩ h õ ˩ k v̩ ˥  
tsʰe˩hõ˩ɲi˩	tsʰ e ˩ h õ ˩ ɲ i ˩  
tsʰe˩hõ˩ɲi˩˥	tsʰ e ˩ h õ ˩ ɲ i ˩˥  
tsʰe˩hɑ̃˩qo˥	tsʰ e ˩ h ɑ̃ ˩ q o ˥  
tsʰe˩hɑ̃˩ɖʐɯ˩bi˩˥	tsʰ e ˩ h ɑ̃ ˩ ɖʐ ɯ ˩ b i ˩˥  
tsʰe˩kv̩˩hĩ˥ʈʂʰɯ˩	tsʰ e ˩ k v̩ ˩ h ĩ ˥ ʈʂʰ ɯ ˩  
tsʰe˩kʰv̩˩hĩ˥	tsʰ e ˩ kʰ v̩ ˩ h ĩ ˥  
tsʰe˩pʰæ˩	tsʰ e ˩ pʰ æ ˩  
tsʰe˩qʰv̩˩hɑ̃˥	tsʰ e ˩ qʰ v̩ ˩ h ɑ̃ ˥  
tsʰe˩qʰɑ˩kʰv̩˩	tsʰ e ˩ qʰ ɑ ˩ kʰ v̩ ˩  
tsʰe˩qʰɑ˩kʰv̩˩hĩ˥	tsʰ e ˩ qʰ ɑ ˩ kʰ v̩ ˩ h ĩ ˥  
tsʰe˩so˩kʰv̩˩ʁo˥to˩dʑo˩	tsʰ e ˩ s o ˩ kʰ v̩ ˩ ʁ o ˥ t o ˩ dʑ o ˩  
tsʰe˩ŋwɤ˩hɑ̃˥ɳɯ˩	tsʰ e ˩ ŋ wɤ ˩ h ɑ̃ ˥ ɳ ɯ ˩  
tsʰe˩ŋwɤ˩kv̩˥	tsʰ e ˩ ŋ wɤ ˩ k v̩ ˥  
tsʰe˩ŋwɤ˩ɲi˩ɳɯ˥	tsʰ e ˩ ŋ wɤ ˩ ɲ i ˩ ɳ ɯ ˥  
tsʰe˩ŋwɤ˩˥	tsʰ e ˩ ŋ wɤ ˩˥  
tsʰi˥hĩ˩	tsʰ i ˥ h ĩ ˩  
tsʰi˧hĩ˧ʈʂʰɯ˧	tsʰ i ˧ h ĩ ˧ ʈʂʰ ɯ ˧  
tsʰi˧qʰæ˧se˥	tsʰ i ˧ qʰ æ ˧ s e ˥  
tsʰi˧tso˧ɲi˥	tsʰ i ˧ ts o ˧ ɲ i ˥  
tsʰi˧ɭɯ˧di˩	tsʰ i ˧ ɭ ɯ ˧ d i ˩  
tsʰi˧ɲi˥ze˩	tsʰ i ˧ ɲ i ˥ z e ˩  
tsʰi˧ʝi˧se˥	tsʰ i ˧ ʝ i ˧ s e ˥  
tsʰi˩kv̩˩	tsʰ i ˩ k v̩ ˩  
tsʰo˥hĩ˩hĩ˩	tsʰ o ˥ h ĩ ˩ h ĩ ˩  
tsʰo˧	tsʰ o ˧  
tsʰo˧pæ˧mv̩˥ʈʂæ˩ɲi˩mæ˩	tsʰ o ˧ p æ ˧ m v̩ ˥ ʈʂ æ ˩ ɲ i ˩ m æ ˩  
tsʰo˧pæ˧ɳɯ˩	tsʰ o ˧ p æ ˧ ɳ ɯ ˩  
tsʰo˧qʰwɤ˥dʑo˩	tsʰ o ˧ qʰ wɤ ˥ dʑ o ˩  
tsʰo˧tsɯ˧	tsʰ o ˧ ts ɯ ˧  
tsʰo˩mo˩ɳɯ˥	tsʰ o ˩ m o ˩ ɳ ɯ ˥  
tsʰɑ˧tɕɤ˧pi˥	tsʰ ɑ ˧ tɕ ɤ ˧ p i ˥  
tsʰɤ˧lɑ˥ɲi˩mæ˩	tsʰ ɤ ˧ l ɑ ˥ ɲ i ˩ m æ ˩  
tsʰɤ˩ne˩ʝi˩zo˩	tsʰ ɤ ˩ n e ˩ ʝ i ˩ z o ˩  
tsʰɤ˩ne˩˥	tsʰ ɤ ˩ n e ˩˥  
tsʰɤ˩ʝi˩ʈʂʰɯ˥	tsʰ ɤ ˩ ʝ i ˩ ʈʂʰ ɯ ˥  
tsʰɯ˧õ˥	tsʰ ɯ ˧ õ ˥  
tsʰɯ˧ɻ̍˧ɬɑ˩mv̩˩	tsʰ ɯ ˧ ɻ̍ ˧ ɬ ɑ ˩ m v̩ ˩  
tsʰɯ˧ɻ̍˧ɬɑ˩mv̩˩ɳɯ˩	tsʰ ɯ ˧ ɻ̍ ˧ ɬ ɑ ˩ m v̩ ˩ ɳ ɯ ˩  
tsʰɯ˩	tsʰ ɯ ˩  
tsʰɯ˩lɑ˩	tsʰ ɯ ˩ l ɑ ˩  
tsʰɯ˩pi˩	tsʰ ɯ ˩ p i ˩  
tsʰɯ˩zo˥	tsʰ ɯ ˩ z o ˥  
tsʰɯ˩ɳɯ˩	tsʰ ɯ ˩ ɳ ɯ ˩  
tsʰɯ˩ɻ̍˩	tsʰ ɯ ˩ ɻ̍ ˩  
tsʰɯ˩ʁo˩to˥dʑo˩	tsʰ ɯ ˩ ʁ o ˩ t o ˥ dʑ o ˩  
tsʰɯ˩˥	tsʰ ɯ ˩˥  
tv	t v  
tv̩˥	t v̩ ˥  
tv̩˧hĩ˧lɑ˩ɲi˩ze˩mæ˩	t v̩ ˧ h ĩ ˧ l ɑ ˩ ɲ i ˩ z e ˩ m æ ˩  
tv̩˧kv̩˥tsɯ˩mv̩˩	t v̩ ˧ k v̩ ˥ ts ɯ ˩ m v̩ ˩  
tv̩˧mɤ˧hĩ˩ɲi˩ze˩mæ˩	t v̩ ˧ m ɤ ˧ h ĩ ˩ ɲ i ˩ z e ˩ m æ ˩  
tv̩˧mɤ˧zo˧ɲi˥	t v̩ ˧ m ɤ ˧ z o ˧ ɲ i ˥  
tv̩˧qʰv̩˧qo˧	t v̩ ˧ qʰ v̩ ˧ q o ˧  
tv̩˧qʰv̩˧zo˧zo˩	t v̩ ˧ qʰ v̩ ˧ z o ˧ z o ˩  
tv̩˧tso˧	t v̩ ˧ ts o ˧  
tv̩˧zo˥kv̩˩	t v̩ ˧ z o ˥ k v̩ ˩  
tv̩˧ɲi˥	t v̩ ˧ ɲ i ˥  
tv̩˩dʑo˩	t v̩ ˩ dʑ o ˩  
tv̩˩kv̩˩tsɯ˩mæ˩	t v̩ ˩ k v̩ ˩ ts ɯ ˩ m æ ˩  
tv̩˩mɤ˩kv̩˩tsɯ˥	t v̩ ˩ m ɤ ˩ k v̩ ˩ ts ɯ ˥  
tv̩˩tv̩˩˥	t v̩ ˩ t v̩ ˩˥  
tæ˧pv̩˩	t æ ˧ p v̩ ˩  
tɑ˧	t ɑ ˧  
tɑ˧ho˧	t ɑ ˧ h o ˧  
tɑ˧kʰv̩˩	t ɑ ˧ kʰ v̩ ˩  
tɑ˧ɳɯ˥	t ɑ ˧ ɳ ɯ ˥  
tɑ˧˥sæ˧ki˥dʑo˩	t ɑ ˧˥ s æ ˧ k i ˥ dʑ o ˩  
tɑ˩hwɤ˩kv̩˥mæ˩	t ɑ ˩ h wɤ ˩ k v̩ ˥ m æ ˩  
tɑ˩kɤ˩lɑ˩	t ɑ ˩ k ɤ ˩ l ɑ ˩  
tɑ˩˥fv̩˩˥	t ɑ ˩˥ f v̩ ˩˥  
tɕi˧	tɕ i ˧  
tɕi˧dʑɯ˩ʈʂʰɯ˩	tɕ i ˧ dʑ ɯ ˩ ʈʂʰ ɯ ˩  
tɕi˧hĩ˧po˩ɳɯ˩dʑo˩	tɕ i ˧ h ĩ ˧ p o ˩ ɳ ɯ ˩ dʑ o ˩  
tɕi˧hĩ˧ʈʂʰɯ˧	tɕ i ˧ h ĩ ˧ ʈʂʰ ɯ ˧  
tɕi˧kv̩˧tsɯ˥	tɕ i ˧ k v̩ ˧ ts ɯ ˥  
tɕi˧kwɤ˧	tɕ i ˧ k wɤ ˧  
tɕi˧sɯ˧pɤ˧	tɕ i ˧ s ɯ ˧ p ɤ ˧  
tɕi˧sɯ˧pɤ˧ʈʂʰɯ˧dʑo˩	tɕ i ˧ s ɯ ˧ p ɤ ˧ ʈʂʰ ɯ ˧ dʑ o ˩  
tɕi˧wɤ˧ɳɯ˩	tɕ i ˧ wɤ ˧ ɳ ɯ ˩  
tɕi˩	tɕ i ˩  
tɕi˩hĩ˩dʑo˥	tɕ i ˩ h ĩ ˩ dʑ o ˥  
tɕi˩kʰwɤ˩lɑ˥	tɕ i ˩ kʰ wɤ ˩ l ɑ ˥  
tɕi˩sɯ˩pɤ˩	tɕ i ˩ s ɯ ˩ p ɤ ˩  
tɕæ˧hæ˩dzɑ˩qʰwɤ˩	tɕ æ ˧ h æ ˩ dz ɑ ˩ qʰ wɤ ˩  
tɕɛ˩	tɕ ɛ ˩  
tɕɤ	tɕ ɤ  
tɕɤ˥	tɕ ɤ ˥  
tɕɤ˥kv̩˩ze˩	tɕ ɤ ˥ k v̩ ˩ z e ˩  
tɕɤ˧fv̩˩	tɕ ɤ ˧ f v̩ ˩  
tɕɤ˧hĩ˧dʑo˩	tɕ ɤ ˧ h ĩ ˧ dʑ o ˩  
tɕɤ˧qʰɑ˧mo˩lɑ˩	tɕ ɤ ˧ qʰ ɑ ˧ m o ˩ l ɑ ˩  
tɕɤ˧tsɑ˥ɲi˩	tɕ ɤ ˧ ts ɑ ˥ ɲ i ˩  
tɕɤ˩dʑo˩	tɕ ɤ ˩ dʑ o ˩  
tɕɤ˩se˩hĩ˩	tɕ ɤ ˩ s e ˩ h ĩ ˩  
tɕɯ˥hĩ˩	tɕ ɯ ˥ h ĩ ˩  
tɕɯ˧di˧˥	tɕ ɯ ˧ d i ˧˥  
tɕɯ˧hõ˧	tɕ ɯ ˧ h õ ˧  
tɕɯ˧le˥po˩tsʰɯ˩kwɤ˩tɕɯ˩lɑ˩	tɕ ɯ ˧ l e ˥ p o ˩ tsʰ ɯ ˩ k wɤ ˩ tɕ ɯ ˩ l ɑ ˩  
tɕɯ˧le˧po˧tsʰɯ˧˥	tɕ ɯ ˧ l e ˧ p o ˧ tsʰ ɯ ˧˥  
tɕɯ˧mɤ˧hĩ˥	tɕ ɯ ˧ m ɤ ˧ h ĩ ˥  
tɕɯ˧pv̩˥kʰɯ˩	tɕ ɯ ˧ p v̩ ˥ kʰ ɯ ˩  
tɕɯ˧se˥dʑo˩	tɕ ɯ ˧ s e ˥ dʑ o ˩  
tɕɯ˧ɭɯ˧	tɕ ɯ ˧ ɭ ɯ ˧  
tɕɯ˧ʁɑ˧ʂe˥zo˩	tɕ ɯ ˧ ʁ ɑ ˧ ʂ e ˥ z o ˩  
tɕɯ˩bi˩ho˩	tɕ ɯ ˩ b i ˩ h o ˩  
tɕɯ˩bi˩kv̩˩	tɕ ɯ ˩ b i ˩ k v̩ ˩  
tɕɯ˩bi˩ze˩	tɕ ɯ ˩ b i ˩ z e ˩  
tɕɯ˩di˩lɑ˩ɲi˩mæ˩	tɕ ɯ ˩ d i ˩ l ɑ ˩ ɲ i ˩ m æ ˩  
tɕɯ˩hĩ˩dʑo˩	tɕ ɯ ˩ h ĩ ˩ dʑ o ˩  
tɕɯ˩hĩ˩ki˩	tɕ ɯ ˩ h ĩ ˩ k i ˩  
tɕɯ˩hɯ˩	tɕ ɯ ˩ h ɯ ˩  
tɕɯ˩hɯ˩hĩ˩	tɕ ɯ ˩ h ɯ ˩ h ĩ ˩  
tɕɯ˩hɯ˩ɲi˩	tɕ ɯ ˩ h ɯ ˩ ɲ i ˩  
tɕɯ˩hɯ˩ɲi˩mæ˩	tɕ ɯ ˩ h ɯ ˩ ɲ i ˩ m æ ˩  
tɕɯ˩kv̩˩mæ˩	tɕ ɯ ˩ k v̩ ˩ m æ ˩  
tɕɯ˩kʰɯ˩	tɕ ɯ ˩ kʰ ɯ ˩  
tɕɯ˩le˩po˩tsʰɯ˩	tɕ ɯ ˩ l e ˩ p o ˩ tsʰ ɯ ˩  
tɕɯ˩lɑ˩	tɕ ɯ ˩ l ɑ ˩  
tɕɯ˩po˩	tɕ ɯ ˩ p o ˩  
tɕɯ˩zo˩kv̩˩	tɕ ɯ ˩ z o ˩ k v̩ ˩  
tɕɯ˩zo˩ʈʂʰɯ˩ɳɯ˩	tɕ ɯ ˩ z o ˩ ʈʂʰ ɯ ˩ ɳ ɯ ˩  
tɕɯ˩ɲi˥tsɯ˩	tɕ ɯ ˩ ɲ i ˥ ts ɯ ˩  
tɕɯ˩ɲi˩tsɯ˩	tɕ ɯ ˩ ɲ i ˩ ts ɯ ˩  
tɕɯ˩˥	tɕ ɯ ˩˥  
tɕʰi˧bi˧	tɕʰ i ˧ b i ˧  
tɕʰi˧bi˧pi˧zo˥	tɕʰ i ˧ b i ˧ p i ˧ z o ˥  
tɕʰi˧bi˧pi˧ɲi˥	tɕʰ i ˧ b i ˧ p i ˧ ɲ i ˥  
tɕʰi˧bi˧tsæ˥ɲi˩ze˩	tɕʰ i ˧ b i ˧ ts æ ˥ ɲ i ˩ z e ˩  
tɕʰi˧dʑo˧	tɕʰ i ˧ dʑ o ˧  
tɕʰi˧hĩ˧	tɕʰ i ˧ h ĩ ˧  
tɕʰi˧hɯ˥dʑo˩	tɕʰ i ˧ h ɯ ˥ dʑ o ˩  
tɕʰi˧hɯ˧	tɕʰ i ˧ h ɯ ˧  
tɕʰi˧hɯ˧dʑo˩	tɕʰ i ˧ h ɯ ˧ dʑ o ˩  
tɕʰi˧mɤ˧tʰv̩˧	tɕʰ i ˧ m ɤ ˧ tʰ v̩ ˧  
tɕʰi˧mɤ˧ɖo˧	tɕʰ i ˧ m ɤ ˧ ɖ o ˧  
tɕʰi˧se˧	tɕʰ i ˧ s e ˧  
tɕʰi˧sɯ˥	tɕʰ i ˧ s ɯ ˥  
tɕʰi˧sɯ˥pi˩	tɕʰ i ˧ s ɯ ˥ p i ˩  
tɕʰi˧sɯ˥tsɯ˩	tɕʰ i ˧ s ɯ ˥ ts ɯ ˩  
tɕʰi˧sɯ˥ze˩	tɕʰ i ˧ s ɯ ˥ z e ˩  
tɕʰi˧tsæ˥ɲi˩ze˩	tɕʰ i ˧ ts æ ˥ ɲ i ˩ z e ˩  
tɕʰi˧tsæ˧ɲi˩	tɕʰ i ˧ ts æ ˧ ɲ i ˩  
tɕʰi˧ʈʂʰɯ˧	tɕʰ i ˧ ʈʂʰ ɯ ˧  
tɕʰi˩le˥wo˩tsʰɯ˩pi˩kv̩˩	tɕʰ i ˩ l e ˥ w o ˩ tsʰ ɯ ˩ p i ˩ k v̩ ˩  
tɕʰi˩tsɯ˧dʑo˧	tɕʰ i ˩ ts ɯ ˧ dʑ o ˧  
tɕʰi˩tsɯ˧qɑ˥	tɕʰ i ˩ ts ɯ ˧ q ɑ ˥  
tɕʰi˩tʰv̩˩bi˩kv̩˥mæ˩	tɕʰ i ˩ tʰ v̩ ˩ b i ˩ k v̩ ˥ m æ ˩  
tɕʰi˩tʰv̩˩kv̩˥ze˩mæ˩	tɕʰ i ˩ tʰ v̩ ˩ k v̩ ˥ z e ˩ m æ ˩  
tɕʰi˩tʰv̩˩tso˥	tɕʰ i ˩ tʰ v̩ ˩ ts o ˥  
tɕʰi˩tʰv̩˩˥	tɕʰ i ˩ tʰ v̩ ˩˥  
tɕʰi˩tʰɑ˥mɤ˩ʝi˩	tɕʰ i ˩ tʰ ɑ ˥ m ɤ ˩ ʝ i ˩  
tɕʰi˩ɻ̍˩	tɕʰ i ˩ ɻ̍ ˩  
tɕʰi˩˥	tɕʰ i ˩˥  
tɕʰo˧bi˧tso˧ɲi˥	tɕʰ o ˧ b i ˧ ts o ˧ ɲ i ˥  
tɕʰo˧bi˧˥	tɕʰ o ˧ b i ˧˥  
tɕʰo˧kʰi˥ɲi˩	tɕʰ o ˧ kʰ i ˥ ɲ i ˩  
tɕʰo˧˥	tɕʰ o ˧˥  
tɕʰo˩bi˩kv̩˩ze˩	tɕʰ o ˩ b i ˩ k v̩ ˩ z e ˩  
tɕʰo˩bi˩tsæ˥ɲi˩	tɕʰ o ˩ b i ˩ ts æ ˥ ɲ i ˩  
tɕʰo˩ʂɯ˧tɕʰo˩	tɕʰ o ˩ ʂ ɯ ˧ tɕʰ o ˩  
tɕʰo˩˥	tɕʰ o ˩˥  
tɕʰɤ˧hɑ̃˧ne˧	tɕʰ ɤ ˧ h ɑ̃ ˧ n e ˧  
tɕʰɤ˧tɕʰɤ˧˥	tɕʰ ɤ ˧ tɕʰ ɤ ˧˥  
tɕʰɯ˧	tɕʰ ɯ ˧  
tɕʰɯ˩	tɕʰ ɯ ˩  
tɤ	t ɤ  
tʰi˥hɑ̃˩kv̩˩	tʰ i ˥ h ɑ̃ ˩ k v̩ ˩  
tʰi˥hɑ̃˩ɳɯ˩	tʰ i ˥ h ɑ̃ ˩ ɳ ɯ ˩  
tʰi˥ki˩kv̩˩mæ˩	tʰ i ˥ k i ˩ k v̩ ˩ m æ ˩  
tʰi˥ki˩ɲi˩	tʰ i ˥ k i ˩ ɲ i ˩  
tʰi˥kʰɯ˩kʰɯ˩	tʰ i ˥ kʰ ɯ ˩ kʰ ɯ ˩  
tʰi˥lɑ˩	tʰ i ˥ l ɑ ˩  
tʰi˥mv̩˩dʑo˩	tʰ i ˥ m v̩ ˩ dʑ o ˩  
tʰi˥mv̩˩kʰɯ˩	tʰ i ˥ m v̩ ˩ kʰ ɯ ˩  
tʰi˥pʰv̩˩tsɯ˩	tʰ i ˥ pʰ v̩ ˩ ts ɯ ˩  
tʰi˥qæ˩zo˩kv̩˩	tʰ i ˥ q æ ˩ z o ˩ k v̩ ˩  
tʰi˥tɕɤ˩	tʰ i ˥ tɕ ɤ ˩  
tʰi˥tɕɯ˩dʑo˩	tʰ i ˥ tɕ ɯ ˩ dʑ o ˩  
tʰi˥ʈʂæ˩	tʰ i ˥ ʈʂ æ ˩  
tʰi˧bv̩˥tsɯ˩	tʰ i ˧ b v̩ ˥ ts ɯ ˩  
tʰi˧bæ˩hĩ˩	tʰ i ˧ b æ ˩ h ĩ ˩  
tʰi˧bæ˩ze˩lɑ	tʰ i ˧ b æ ˩ z e ˩ l ɑ  
tʰi˧di˥bi˩	tʰ i ˧ d i ˥ b i ˩  
tʰi˧di˥hĩ˩qo˩	tʰ i ˧ d i ˥ h ĩ ˩ q o ˩  
tʰi˧di˥kv̩˩	tʰ i ˧ d i ˥ k v̩ ˩  
tʰi˧di˥mɤ˩di˩	tʰ i ˧ d i ˥ m ɤ ˩ d i ˩  
tʰi˧di˥ɲi˩mæ˩	tʰ i ˧ d i ˥ ɲ i ˩ m æ ˩  
tʰi˧di˧	tʰ i ˧ d i ˧  
tʰi˧di˩dʑo˩	tʰ i ˧ d i ˩ dʑ o ˩  
tʰi˧di˩hĩ˩ʈʂʰɯ˩dʑo˩	tʰ i ˧ d i ˩ h ĩ ˩ ʈʂʰ ɯ ˩ dʑ o ˩  
tʰi˧di˩kv̩˩mv̩˩	tʰ i ˧ d i ˩ k v̩ ˩ m v̩ ˩  
tʰi˧di˩kʰɯ˩	tʰ i ˧ d i ˩ kʰ ɯ ˩  
tʰi˧di˩ɲi˩mæ˩	tʰ i ˧ d i ˩ ɲ i ˩ m æ ˩  
tʰi˧dzi˧kʰɯ˥	tʰ i ˧ dz i ˧ kʰ ɯ ˥  
tʰi˧dzi˩hĩ˩bv̩˩	tʰ i ˧ dz i ˩ h ĩ ˩ b v̩ ˩  
tʰi˧dzi˩kwɤ˩tɕɯ˩	tʰ i ˧ dz i ˩ k wɤ ˩ tɕ ɯ ˩  
tʰi˧dzi˩kʰɯ˩dʑo˩	tʰ i ˧ dz i ˩ kʰ ɯ ˩ dʑ o ˩  
tʰi˧dzi˩mɤ˩dzi˩	tʰ i ˧ dz i ˩ m ɤ ˩ dz i ˩  
tʰi˧dzi˩se˩dʑo˩	tʰ i ˧ dz i ˩ s e ˩ dʑ o ˩  
tʰi˧dzi˩tʰɑ˩ɲi˩ze˩	tʰ i ˧ dz i ˩ tʰ ɑ ˩ ɲ i ˩ z e ˩  
tʰi˧dzi˩zo˩	tʰ i ˧ dz i ˩ z o ˩  
tʰi˧dzi˩ɲi˩ʝi˩mæ˩	tʰ i ˧ dz i ˩ ɲ i ˩ ʝ i ˩ m æ ˩  
tʰi˧dzi˩ɳɯ˩	tʰ i ˧ dz i ˩ ɳ ɯ ˩  
tʰi˧dzɯ˥dʑo˩	tʰ i ˧ dz ɯ ˥ dʑ o ˩  
tʰi˧dzɯ˥kʰɯ˩dʑo˩	tʰ i ˧ dz ɯ ˥ kʰ ɯ ˩ dʑ o ˩  
tʰi˧dʑo˧ɲi˥ʝi˩	tʰ i ˧ dʑ o ˧ ɲ i ˥ ʝ i ˩  
tʰi˧dʑo˩hĩ˩dʑo˩	tʰ i ˧ dʑ o ˩ h ĩ ˩ dʑ o ˩  
tʰi˧dʑo˩ɲi˩	tʰ i ˧ dʑ o ˩ ɲ i ˩  
tʰi˧gv̩˩dʑo˩	tʰ i ˧ g v̩ ˩ dʑ o ˩  
tʰi˧gɤ˧dʑo˥	tʰ i ˧ g ɤ ˧ dʑ o ˥  
tʰi˧gɤ˧hĩ˧ʈʂʰɯ˧dʑo˩	tʰ i ˧ g ɤ ˧ h ĩ ˧ ʈʂʰ ɯ ˧ dʑ o ˩  
tʰi˧gɤ˧ze˧	tʰ i ˧ g ɤ ˧ z e ˧  
tʰi˧gɤ˧ɲi˥tsɯ˩	tʰ i ˧ g ɤ ˧ ɲ i ˥ ts ɯ ˩  
tʰi˧hĩ˧bi˧	tʰ i ˧ h ĩ ˧ b i ˧  
tʰi˧hĩ˧bi˧pi˧dʑo˩	tʰ i ˧ h ĩ ˧ b i ˧ p i ˧ dʑ o ˩  
tʰi˧hĩ˧kʰɯ˥	tʰ i ˧ h ĩ ˧ kʰ ɯ ˥  
tʰi˧hĩ˧tsɯ˥	tʰ i ˧ h ĩ ˧ ts ɯ ˥  
tʰi˧hĩ˧zo˥	tʰ i ˧ h ĩ ˧ z o ˥  
tʰi˧hwæ˩	tʰ i ˧ h wæ ˩  
tʰi˧hwæ˩dʑo˩	tʰ i ˧ h wæ ˩ dʑ o ˩  
tʰi˧hwæ˩kv̩˩	tʰ i ˧ h wæ ˩ k v̩ ˩  
tʰi˧hwæ˩kʰɯ˩	tʰ i ˧ h wæ ˩ kʰ ɯ ˩  
tʰi˧jɤ˩bi˩ʝi˩ze˩	tʰ i ˧ jɤ ˩ b i ˩ ʝ i ˩ z e ˩  
tʰi˧jɤ˩jɤ˩kʰɯ˩	tʰ i ˧ jɤ ˩ jɤ ˩ kʰ ɯ ˩  
tʰi˧ki˥	tʰ i ˧ k i ˥  
tʰi˧ki˧dʑo˥	tʰ i ˧ k i ˧ dʑ o ˥  
tʰi˧ki˧hɯ˧tsɯ˧˥	tʰ i ˧ k i ˧ h ɯ ˧ ts ɯ ˧˥  
tʰi˧ki˧kv̩˧˥	tʰ i ˧ k i ˧ k v̩ ˧˥  
tʰi˧ki˩kʰɯ˩	tʰ i ˧ k i ˩ kʰ ɯ ˩  
tʰi˧ki˩kʰɯ˩se˩dʑo˩	tʰ i ˧ k i ˩ kʰ ɯ ˩ s e ˩ dʑ o ˩  
tʰi˧kv̩˧spʰæ˥di˩mæ˩	tʰ i ˧ k v̩ ˧ s pʰ æ ˥ d i ˩ m æ ˩  
tʰi˧kwɤ˩dʑo˩	tʰ i ˧ k wɤ ˩ dʑ o ˩  
tʰi˧kwɤ˩kwɤ˩tɕɯ˩lɑ˩	tʰ i ˧ k wɤ ˩ k wɤ ˩ tɕ ɯ ˩ l ɑ ˩  
tʰi˧kwɤ˩mɤ˩kv̩˩	tʰ i ˧ k wɤ ˩ m ɤ ˩ k v̩ ˩  
tʰi˧kʰɤ˧ɕjɤ˧lɑ˩	tʰ i ˧ kʰ ɤ ˧ ɕ jɤ ˧ l ɑ ˩  
tʰi˧kʰɤ˧ɕjɤ˧ɻ˧	tʰ i ˧ kʰ ɤ ˧ ɕ jɤ ˧ ɻ ˧  
tʰi˧kʰɯ˧kv̩˥	tʰ i ˧ kʰ ɯ ˧ k v̩ ˥  
tʰi˧kʰɯ˩kʰɯ˩	tʰ i ˧ kʰ ɯ ˩ kʰ ɯ ˩  
tʰi˧lɑ˧kv̩˥mæ˩	tʰ i ˧ l ɑ ˧ k v̩ ˥ m æ ˩  
tʰi˧lɑ˧ze˥	tʰ i ˧ l ɑ ˧ z e ˥  
tʰi˧lɑ˧˥	tʰ i ˧ l ɑ ˧˥  
tʰi˧mv̩˧	tʰ i ˧ m v̩ ˧  
tʰi˧mv̩˧hĩ˧ʈʂʰɯ˧	tʰ i ˧ m v̩ ˧ h ĩ ˧ ʈʂʰ ɯ ˧  
tʰi˧mv̩˧kv̩˧˥	tʰ i ˧ m v̩ ˧ k v̩ ˧˥  
tʰi˧mv̩˧kʰɯ˧˥	tʰ i ˧ m v̩ ˧ kʰ ɯ ˧˥  
tʰi˧mv̩˧mv̩˧tɕɯ˧zo˥	tʰ i ˧ m v̩ ˧ m v̩ ˧ tɕ ɯ ˧ z o ˥  
tʰi˧mɤ˧dʑo˩ze˩	tʰ i ˧ m ɤ ˧ dʑ o ˩ z e ˩  
tʰi˧no˥kʰɯ˩	tʰ i ˧ n o ˥ kʰ ɯ ˩  
tʰi˧no˩	tʰ i ˧ n o ˩  
tʰi˧po˧	tʰ i ˧ p o ˧  
tʰi˧po˧kʰɯ˥kwɤ˩tɕɯ˩lɑ˩	tʰ i ˧ p o ˧ kʰ ɯ ˥ k wɤ ˩ tɕ ɯ ˩ l ɑ ˩  
tʰi˧po˧˥	tʰ i ˧ p o ˧˥  
tʰi˧pv̩˩	tʰ i ˧ p v̩ ˩  
tʰi˧pæ˩ze˩gɤ˩	tʰ i ˧ p æ ˩ z e ˩ g ɤ ˩  
tʰi˧pʰo˧hĩ˥	tʰ i ˧ pʰ o ˧ h ĩ ˥  
tʰi˧pʰv̩˧˥	tʰ i ˧ pʰ v̩ ˧˥  
tʰi˧pʰv̩˩tɕɯ˩ɲi˩tsɯ˩mv̩˩	tʰ i ˧ pʰ v̩ ˩ tɕ ɯ ˩ ɲ i ˩ ts ɯ ˩ m v̩ ˩  
tʰi˧pʰæ˧kv̩˥	tʰ i ˧ pʰ æ ˧ k v̩ ˥  
tʰi˧pʰæ˧pʰæ˧	tʰ i ˧ pʰ æ ˧ pʰ æ ˧  
tʰi˧pʰæ˧pʰæ˧ɲi˥	tʰ i ˧ pʰ æ ˧ pʰ æ ˧ ɲ i ˥  
tʰi˧pʰæ˧˥	tʰ i ˧ pʰ æ ˧˥  
tʰi˧qæ˧hĩ˥	tʰ i ˧ q æ ˧ h ĩ ˥  
tʰi˧qɑ˩	tʰ i ˧ q ɑ ˩  
tʰi˧qʰo˧	tʰ i ˧ qʰ o ˧  
tʰi˧qʰwɤ˧ɲi˥	tʰ i ˧ qʰ wɤ ˧ ɲ i ˥  
tʰi˧sɯ˧kʰɯ˧˥	tʰ i ˧ s ɯ ˧ kʰ ɯ ˧˥  
tʰi˧tsi˥	tʰ i ˧ ts i ˥  
tʰi˧tsi˥tsɯ˩	tʰ i ˧ ts i ˥ ts ɯ ˩  
tʰi˧tsi˧dʑo˥	tʰ i ˧ ts i ˧ dʑ o ˥  
tʰi˧tsi˧kv̩˧˥	tʰ i ˧ ts i ˧ k v̩ ˧˥  
tʰi˧tso˩dʑo˩mæ˩	tʰ i ˧ ts o ˩ dʑ o ˩ m æ ˩  
tʰi˧tsɯ˥dʑo˩	tʰ i ˧ ts ɯ ˥ dʑ o ˩  
tʰi˧tsɯ˥kwɤ˩tɕɯ˩lɑ˩	tʰ i ˧ ts ɯ ˥ k wɤ ˩ tɕ ɯ ˩ l ɑ ˩  
tʰi˧tsɯ˧tsɯ˧kwɤ˩tɕɯ˩zo˩	tʰ i ˧ ts ɯ ˧ ts ɯ ˧ k wɤ ˩ tɕ ɯ ˩ z o ˩  
tʰi˧tsɯ˩	tʰ i ˧ ts ɯ ˩  
tʰi˧tsʰo˥kʰɯ˩	tʰ i ˧ tsʰ o ˥ kʰ ɯ ˩  
tʰi˧tsʰɤ˧˥	tʰ i ˧ tsʰ ɤ ˧˥  
tʰi˧tv̩˧dʑo˧ze˥	tʰ i ˧ t v̩ ˧ dʑ o ˧ z e ˥  
tʰi˧tv̩˧tv̩˧zo˥	tʰ i ˧ t v̩ ˧ t v̩ ˧ z o ˥  
tʰi˧tv̩˧˥	tʰ i ˧ t v̩ ˧˥  
tʰi˧tɕ	tʰ i ˧ tɕ  
tʰi˧tɕi˥	tʰ i ˧ tɕ i ˥  
tʰi˧tɕi˥dʑo˩	tʰ i ˧ tɕ i ˥ dʑ o ˩  
tʰi˧tɕi˩ni˩	tʰ i ˧ tɕ i ˩ n i ˩  
tʰi˧tɕɤ˩	tʰ i ˧ tɕ ɤ ˩  
tʰi˧tɕɤ˩dʑo˩	tʰ i ˧ tɕ ɤ ˩ dʑ o ˩  
tʰi˧tɕɤ˩kv̩˩mv̩˩	tʰ i ˧ tɕ ɤ ˩ k v̩ ˩ m v̩ ˩  
tʰi˧tɕɯ˥dʑo˩	tʰ i ˧ tɕ ɯ ˥ dʑ o ˩  
tʰi˧tɕɯ˥dʑo˩ɲi˩	tʰ i ˧ tɕ ɯ ˥ dʑ o ˩ ɲ i ˩  
tʰi˧tɕɯ˥kv̩˩	tʰ i ˧ tɕ ɯ ˥ k v̩ ˩  
tʰi˧tɕɯ˥kv̩˩mv̩˩	tʰ i ˧ tɕ ɯ ˥ k v̩ ˩ m v̩ ˩  
tʰi˧tɕɯ˥kv̩˩mæ˩	tʰ i ˧ tɕ ɯ ˥ k v̩ ˩ m æ ˩  
tʰi˧tɕɯ˥kv̩˩ze˩	tʰ i ˧ tɕ ɯ ˥ k v̩ ˩ z e ˩  
tʰi˧tɕɯ˧hĩ˧ʈʂʰɯ˥	tʰ i ˧ tɕ ɯ ˧ h ĩ ˧ ʈʂʰ ɯ ˥  
tʰi˧tɕɯ˧se˥	tʰ i ˧ tɕ ɯ ˧ s e ˥  
tʰi˧tɕɯ˧se˥kwɤ˩tɕɯ˩lɑ˩	tʰ i ˧ tɕ ɯ ˧ s e ˥ k wɤ ˩ tɕ ɯ ˩ l ɑ ˩  
tʰi˧tɕɯ˧tsʰɯ˧˥	tʰ i ˧ tɕ ɯ ˧ tsʰ ɯ ˧˥  
tʰi˧tɕɯ˧zo˧ɲi˥	tʰ i ˧ tɕ ɯ ˧ z o ˧ ɲ i ˥  
tʰi˧tɕɯ˧ɲi˥tsɯ˩	tʰ i ˧ tɕ ɯ ˧ ɲ i ˥ ts ɯ ˩  
tʰi˧tɕʰi˧	tʰ i ˧ tɕʰ i ˧  
tʰi˧tɕʰo˩ɲi˩ze˩	tʰ i ˧ tɕʰ o ˩ ɲ i ˩ z e ˩  
tʰi˧tʰv̩˧dʑo˧	tʰ i ˧ tʰ v̩ ˧ dʑ o ˧  
tʰi˧wɤ˥wɤ˩	tʰ i ˧ wɤ ˥ wɤ ˩  
tʰi˧wɤ˧	tʰ i ˧ wɤ ˧  
tʰi˧ɕjɤ˧˥	tʰ i ˧ ɕ jɤ ˧˥  
tʰi˧ɖwæ˧˥	tʰ i ˧ ɖ wæ ˧˥  
tʰi˧ɖʐɤ˧˥	tʰ i ˧ ɖʐ ɤ ˧˥  
tʰi˧ɲi˥ho˩mæ˩	tʰ i ˧ ɲ i ˥ h o ˩ m æ ˩  
tʰi˧ɲi˥mæ˩	tʰ i ˧ ɲ i ˥ m æ ˩  
tʰi˧ɲi˩	tʰ i ˧ ɲ i ˩  
tʰi˧ɳæ˧˥	tʰ i ˧ ɳ æ ˧˥  
tʰi˧ʁo˥ʐv̩˩dʑo˩ʝi˩	tʰ i ˧ ʁ o ˥ ʐ v̩ ˩ dʑ o ˩ ʝ i ˩  
tʰi˧ʁwɤ˧	tʰ i ˧ ʁ wɤ ˧  
tʰi˧ʂɯ˧tsɯ˥	tʰ i ˧ ʂ ɯ ˧ ts ɯ ˥  
tʰi˧ʂɯ˧ze˧tsɯ˥	tʰ i ˧ ʂ ɯ ˧ z e ˧ ts ɯ ˥  
tʰi˧ʂɯ˧ɲi˥ze˩mæ˩	tʰ i ˧ ʂ ɯ ˧ ɲ i ˥ z e ˩ m æ ˩  
tʰi˧ʂɻ̍˧˥	tʰ i ˧ ʂ ɻ̍ ˧˥  
tʰi˧ʂɻ̩˧kʰɯ˥	tʰ i ˧ ʂ ɻ̩ ˧ kʰ ɯ ˥  
tʰi˧ʈwæ˧tsɯ˥	tʰ i ˧ ʈ wæ ˧ ts ɯ ˥  
tʰi˧ʈæ˩	tʰ i ˧ ʈ æ ˩  
tʰi˧ʈʂwæ˧˥	tʰ i ˧ ʈʂ wæ ˧˥  
tʰi˧ʈʂʰɻ̍˧kv̩˥tsɯ˩	tʰ i ˧ ʈʂʰ ɻ̍ ˧ k v̩ ˥ ts ɯ ˩  
tʰi˧ʈʂʰɻ̍˧˥	tʰ i ˧ ʈʂʰ ɻ̍ ˧˥  
tʰi˧ʈʰi˩kwɤ˩tɕɯ˩lɑ˩	tʰ i ˧ ʈʰ i ˩ k wɤ ˩ tɕ ɯ ˩ l ɑ ˩  
tʰi˧ʈʰi˩ɲi˩tsɯ˩	tʰ i ˧ ʈʰ i ˩ ɲ i ˩ ts ɯ ˩  
tʰi˧ʈʰæ˧di˧˥	tʰ i ˧ ʈʰ æ ˧ d i ˧˥  
tʰi˧ʈʰæ˧kʰɯ˥	tʰ i ˧ ʈʰ æ ˧ kʰ ɯ ˥  
tʰi˧ʈʰæ˧˥	tʰ i ˧ ʈʰ æ ˧˥  
tʰi˧ʈʰɤ˩ʈʰɤ˩hĩ˩	tʰ i ˧ ʈʰ ɤ ˩ ʈʰ ɤ ˩ h ĩ ˩  
tʰi˧ʈʰɯ˧kʰɯ˥	tʰ i ˧ ʈʰ ɯ ˧ kʰ ɯ ˥  
tʰi˧ʈʰɯ˩kʰɯ˩	tʰ i ˧ ʈʰ ɯ ˩ kʰ ɯ ˩  
tʰi˧ʐwɤ˩bi˩	tʰ i ˧ ʐ wɤ ˩ b i ˩  
tʰi˧ʑi˥kv̩˩mæ˩	tʰ i ˧ ʑ i ˥ k v̩ ˩ m æ ˩  
tʰi˧ʑi˧hĩ˧	tʰ i ˧ ʑ i ˧ h ĩ ˧  
tʰi˧ʑi˧kʰɯ˥zo˩	tʰ i ˧ ʑ i ˧ kʰ ɯ ˥ z o ˩  
tʰi˧ʑi˧ŋv̩˥dʑo˩	tʰ i ˧ ʑ i ˧ ŋ v̩ ˥ dʑ o ˩  
tʰi˧ʑi˧ɲi˥ze˩	tʰ i ˧ ʑ i ˧ ɲ i ˥ z e ˩  
tʰi˧ʑi˧˥	tʰ i ˧ ʑ i ˧˥  
tʰi˩bæ˩	tʰ i ˩ b æ ˩  
tʰi˩di˥ze˩	tʰ i ˩ d i ˥ z e ˩  
tʰi˩di˥zo˩	tʰ i ˩ d i ˥ z o ˩  
tʰi˩di˩kv̩˩	tʰ i ˩ d i ˩ k v̩ ˩  
tʰi˩dzi˩ɲi˩	tʰ i ˩ dz i ˩ ɲ i ˩  
tʰi˩kʰɯ˩kʰɯ˩	tʰ i ˩ kʰ ɯ ˩ kʰ ɯ ˩  
tʰi˩kʰɯ˩ɲi˩	tʰ i ˩ kʰ ɯ ˩ ɲ i ˩  
tʰi˩kʰɯ˩˥	tʰ i ˩ kʰ ɯ ˩˥  
tʰi˩lɑ˩ɻ̍˩	tʰ i ˩ l ɑ ˩ ɻ̍ ˩  
tʰi˩mv̩˩	tʰ i ˩ m v̩ ˩  
tʰi˩mɤ˩di˩hĩ˩	tʰ i ˩ m ɤ ˩ d i ˩ h ĩ ˩  
tʰi˩no˩	tʰ i ˩ n o ˩  
tʰi˩po˩	tʰ i ˩ p o ˩  
tʰi˩po˩˥	tʰ i ˩ p o ˩˥  
tʰi˩qæ˩	tʰ i ˩ q æ ˩  
tʰi˩qɑ˥kwɤ˩tɕɯ˩lɑ˩	tʰ i ˩ q ɑ ˥ k wɤ ˩ tɕ ɯ ˩ l ɑ ˩  
tʰi˩tɕɯ˩bi˩	tʰ i ˩ tɕ ɯ ˩ b i ˩  
tʰi˩ʈɯ˩	tʰ i ˩ ʈ ɯ ˩  
tʰo˧dzi˩	tʰ o ˧ dz i ˩  
tʰo˧mo˩	tʰ o ˧ m o ˩  
tʰo˧mo˩pi˩	tʰ o ˧ m o ˩ p i ˩  
tʰo˧mo˩ʈʂʰɯ˩	tʰ o ˧ m o ˩ ʈʂʰ ɯ ˩  
tʰo˩fv̩˩qɑ˩	tʰ o ˩ f v̩ ˩ q ɑ ˩  
tʰo˩lo˥	tʰ o ˩ l o ˥  
tʰo˩lo˧bv̩˧	tʰ o ˩ l o ˧ b v̩ ˧  
tʰo˩zo˩	tʰ o ˩ z o ˩  
tʰv̩˥	tʰ v̩ ˥  
tʰv̩˥ho˩ze˩	tʰ v̩ ˥ h o ˩ z e ˩  
tʰv̩˧gi˧ɳɯ˥	tʰ v̩ ˧ g i ˧ ɳ ɯ ˥  
tʰv̩˧gɤ˧li˧	tʰ v̩ ˧ g ɤ ˧ l i ˧  
tʰv̩˧ho˩	tʰ v̩ ˧ h o ˩  
tʰv̩˧ho˩hĩ˩	tʰ v̩ ˧ h o ˩ h ĩ ˩  
tʰv̩˧jɤ˩	tʰ v̩ ˧ jɤ ˩  
tʰv̩˧ki˧	tʰ v̩ ˧ k i ˧  
tʰv̩˧kv̩˧ze˥mæ˩	tʰ v̩ ˧ k v̩ ˧ z e ˥ m æ ˩  
tʰv̩˧kv̩˩ze˩	tʰ v̩ ˧ k v̩ ˩ z e ˩  
tʰv̩˧kv̩˩ɲi˩ze˩	tʰ v̩ ˧ k v̩ ˩ ɲ i ˩ z e ˩  
tʰv̩˧kwɤ˧tɕɯ˥lɑ˥	tʰ v̩ ˧ k wɤ ˧ tɕ ɯ ˥ l ɑ ˥  
tʰv̩˧kʰv̩˩dʑo˩	tʰ v̩ ˧ kʰ v̩ ˩ dʑ o ˩  
tʰv̩˧kʰwɤ˥dʑo˩	tʰ v̩ ˧ kʰ wɤ ˥ dʑ o ˩  
tʰv̩˧kʰwɤ˥lɑ˩	tʰ v̩ ˧ kʰ wɤ ˥ l ɑ ˩  
tʰv̩˧kʰwɤ˧bi˥	tʰ v̩ ˧ kʰ wɤ ˧ b i ˥  
tʰv̩˧lɑ˩	tʰ v̩ ˧ l ɑ ˩  
tʰv̩˧mv̩˧	tʰ v̩ ˧ m v̩ ˧  
tʰv̩˧mɤ˧kv̩˧˥	tʰ v̩ ˧ m ɤ ˧ k v̩ ˧˥  
tʰv̩˧mɤ˧ɲi˥	tʰ v̩ ˧ m ɤ ˧ ɲ i ˥  
tʰv̩˧neʝi˥	tʰ v̩ ˧ n e ʝ i ˥  
tʰv̩˧ni˧	tʰ v̩ ˧ n i ˧  
tʰv̩˧pv̩˧pv̩˥qo˩	tʰ v̩ ˧ p v̩ ˧ p v̩ ˥ q o ˩  
tʰv̩˧pʰæ˧qo˩	tʰ v̩ ˧ pʰ æ ˧ q o ˩  
tʰv̩˧qo˥	tʰ v̩ ˧ q o ˥  
tʰv̩˧qo˧ki˧	tʰ v̩ ˧ q o ˧ k i ˧  
tʰv̩˧se˩gɤ˩	tʰ v̩ ˧ s e ˩ g ɤ ˩  
tʰv̩˧sɯ˩kv̩˩	tʰ v̩ ˧ s ɯ ˩ k v̩ ˩  
tʰv̩˧sɯ˩kv̩˩dʑo˩	tʰ v̩ ˧ s ɯ ˩ k v̩ ˩ dʑ o ˩  
tʰv̩˧tsɯ˧˥	tʰ v̩ ˧ ts ɯ ˧˥  
tʰv̩˧v̩˧ki˥	tʰ v̩ ˧ v̩ ˧ k i ˥  
tʰv̩˧v̩˧ki˧sɯ˩	tʰ v̩ ˧ v̩ ˧ k i ˧ s ɯ ˩  
tʰv̩˧v̩˧ɳɯ˧	tʰ v̩ ˧ v̩ ˧ ɳ ɯ ˧  
tʰv̩˧ze˩	tʰ v̩ ˧ z e ˩  
tʰv̩˧zo˥	tʰ v̩ ˧ z o ˥  
tʰv̩˧ɭɯ˧dʑo˩	tʰ v̩ ˧ ɭ ɯ ˧ dʑ o ˩  
tʰv̩˧ɭɯ˧ki˧	tʰ v̩ ˧ ɭ ɯ ˧ k i ˧  
tʰv̩˧ɲi˥mæ˩	tʰ v̩ ˧ ɲ i ˥ m æ ˩  
tʰv̩˧ɲi˥tsɯ˩	tʰ v̩ ˧ ɲ i ˥ ts ɯ ˩  
tʰv̩˧ɻæ˥dʑo˩	tʰ v̩ ˧ ɻ æ ˥ dʑ o ˩  
tʰv̩˧ɻæ˧qo˥	tʰ v̩ ˧ ɻ æ ˧ q o ˥  
tʰv̩˧ɻæ˧qo˥ɳɯ˩	tʰ v̩ ˧ ɻ æ ˧ q o ˥ ɳ ɯ ˩  
tʰv̩˧ɻ̍˧dʑo˥	tʰ v̩ ˧ ɻ̍ ˧ dʑ o ˥  
tʰv̩˧ʁo˥ʈʰæ˩qo˩dʑo˩	tʰ v̩ ˧ ʁ o ˥ ʈʰ æ ˩ q o ˩ dʑ o ˩  
tʰv̩˧ʁo˧dɑ˧dʑo˩	tʰ v̩ ˧ ʁ o ˧ d ɑ ˧ dʑ o ˩  
tʰv̩˧ʈʂæ˩qo˩	tʰ v̩ ˧ ʈʂ æ ˩ q o ˩  
tʰv̩˧ʈʂʰæ˩dʑo˩	tʰ v̩ ˧ ʈʂʰ æ ˩ dʑ o ˩  
tʰv̩˧ʑi˧ɻ̍˥	tʰ v̩ ˧ ʑ i ˧ ɻ̍ ˥  
tʰv̩˧ʑi˧˥	tʰ v̩ ˧ ʑ i ˧˥  
tʰv̩˧˥	tʰ v̩ ˧˥  
tʰv̩˩bi˩	tʰ v̩ ˩ b i ˩  
tʰv̩˩hɯ˩˥	tʰ v̩ ˩ h ɯ ˩˥  
tʰv̩˩kv̩˥	tʰ v̩ ˩ k v̩ ˥  
tʰv̩˩kv̩˩	tʰ v̩ ˩ k v̩ ˩  
tʰv̩˩kwɤ˩	tʰ v̩ ˩ k wɤ ˩  
tʰv̩˩kʰwɤ˩	tʰ v̩ ˩ kʰ wɤ ˩  
tʰv̩˩kʰwɤ˩dʑo˩	tʰ v̩ ˩ kʰ wɤ ˩ dʑ o ˩  
tʰv̩˩kʰɯ˩dʑo˩	tʰ v̩ ˩ kʰ ɯ ˩ dʑ o ˩  
tʰv̩˩mo˩ki˩dʑo˩	tʰ v̩ ˩ m o ˩ k i ˩ dʑ o ˩  
tʰv̩˩nɑ˥	tʰ v̩ ˩ n ɑ ˥  
tʰv̩˩pi˥	tʰ v̩ ˩ p i ˥  
tʰv̩˩qo˩	tʰ v̩ ˩ q o ˩  
tʰv̩˩qo˩dʑo˩	tʰ v̩ ˩ q o ˩ dʑ o ˩  
tʰv̩˩v̩˩ɳɯ˥	tʰ v̩ ˩ v̩ ˩ ɳ ɯ ˥  
tʰv̩˩ɭɯ˩ʁo˩to˥	tʰ v̩ ˩ ɭ ɯ ˩ ʁ o ˩ t o ˥  
tʰv̩˩ɲi˥tsɯ˩	tʰ v̩ ˩ ɲ i ˥ ts ɯ ˩  
tʰv̩˩ɲi˩ho˩	tʰ v̩ ˩ ɲ i ˩ h o ˩  
tʰv̩˩ɲi˩ze˩	tʰ v̩ ˩ ɲ i ˩ z e ˩  
tʰv̩˩ɳɯ˩	tʰ v̩ ˩ ɳ ɯ ˩  
tʰv̩˩ʁo˩	tʰ v̩ ˩ ʁ o ˩  
tʰv̩˩˥	tʰ v̩ ˩˥  
tʰææ˧	tʰ æ æ ˧  
tʰææ̃˧dʑo˩	tʰ æ æ̃ ˧ dʑ o ˩  
tʰæ˧ɻæ˩bi˩	tʰ æ ˧ ɻ æ ˩ b i ˩  
tʰɑ˧	tʰ ɑ ˧  
tʰɑ˧dzɯ˥	tʰ ɑ ˧ dz ɯ ˥  
tʰɑ˧dzɯ˥ze˩	tʰ ɑ ˧ dz ɯ ˥ z e ˩  
tʰɑ˧kv̩˧kv̩˥	tʰ ɑ ˧ k v̩ ˧ k v̩ ˥  
tʰɑ˧kv̩˩	tʰ ɑ ˧ k v̩ ˩  
tʰɑ˧kwɤ˩	tʰ ɑ ˧ k wɤ ˩  
tʰɑ˧lɑ˧˥	tʰ ɑ ˧ l ɑ ˧˥  
tʰɑ˧mv̩˧	tʰ ɑ ˧ m v̩ ˧  
tʰɑ˧mɤ˧ʝi˧ze˩	tʰ ɑ ˧ m ɤ ˧ ʝ i ˧ z e ˩  
tʰɑ˧sɯ˧kɤ˧ʈʂɯ˥	tʰ ɑ ˧ s ɯ ˧ k ɤ ˧ ʈʂ ɯ ˥  
tʰɑ˧ti˧ti˥	tʰ ɑ ˧ t i ˧ t i ˥  
tʰɑ˧tʰv̩˧	tʰ ɑ ˧ tʰ v̩ ˧  
tʰɑ˧ŋv̩˩	tʰ ɑ ˧ ŋ v̩ ˩  
tʰɑ˧ɲi˥	tʰ ɑ ˧ ɲ i ˥  
tʰɑ˧ɲi˥ze˩	tʰ ɑ ˧ ɲ i ˥ z e ˩  
tʰɑ˧ʂv̩˧ɖv̩˧	tʰ ɑ ˧ ʂ v̩ ˧ ɖ v̩ ˧  
tʰɑ˧ʝi˧ɻ̍˥	tʰ ɑ ˧ ʝ i ˧ ɻ̍ ˥  
tʰɑ˧˥	tʰ ɑ ˧˥  
tʰɑ˩kv̩˩	tʰ ɑ ˩ k v̩ ˩  
tʰɑ˩tʰɑ˩ʈʂʰɯ˥	tʰ ɑ ˩ tʰ ɑ ˩ ʈʂʰ ɯ ˥  
tʰɑ˩ʝi˩ze˩	tʰ ɑ ˩ ʝ i ˩ z e ˩  
uɻ˩	u ɻ ˩  
v̩˧dʑo˧	v̩ ˧ dʑ o ˧  
v̩˧lɑ˩ʝi˩	v̩ ˧ l ɑ ˩ ʝ i ˩  
v̩˧lɑ˩ʝi˩ɲi˩ho˩	v̩ ˧ l ɑ ˩ ʝ i ˩ ɲ i ˩ h o ˩  
v̩˧pɤ˩kʰwɤ˩	v̩ ˧ p ɤ ˩ kʰ wɤ ˩  
v̩˩	v̩ ˩  
v̩˩dze˩	v̩ ˩ dz e ˩  
v̩˩dʑɯ˩kʰɯ˥di˩	v̩ ˩ dʑ ɯ ˩ kʰ ɯ ˥ d i ˩  
v̩˩dʑɯ˩˥	v̩ ˩ dʑ ɯ ˩˥  
v̩˩tsʰɤ˧tsʰɑ˧nɑ˥	v̩ ˩ tsʰ ɤ ˧ tsʰ ɑ ˧ n ɑ ˥  
v̩˩tsʰɤ˧tæ˧pv̩˥ʈʂʰɯ˩	v̩ ˩ tsʰ ɤ ˧ t æ ˧ p v̩ ˥ ʈʂʰ ɯ ˩  
v̩˩tsʰɤ˧ɻæ˥	v̩ ˩ tsʰ ɤ ˧ ɻ æ ˥  
v̩˩tsʰɤ˩	v̩ ˩ tsʰ ɤ ˩  
w	w  
we˩˥	w e ˩˥  
wo˩	w o ˩  
wo˩lɑ˧	w o ˩ l ɑ ˧  
wo˩mi˥	w o ˩ m i ˥  
wo˩tɕæ˩ɻæ˥	w o ˩ tɕ æ ˩ ɻ æ ˥  
wo˩v̩˥tsʰɤ˩	w o ˩ v̩ ˥ tsʰ ɤ ˩  
wo˩ɻæ˥ʈʂʰɯ˩	w o ˩ ɻ æ ˥ ʈʂʰ ɯ ˩  
wwo	w w o  
wɤɕjɤɕjɤ	wɤ ɕ jɤ ɕ jɤ  
wɤɕjɤɕjɤɕjɤɕjɤɕjɤɕjɤ	wɤ ɕ jɤ ɕ jɤ ɕ jɤ ɕ jɤ ɕ jɤ ɕ jɤ  
wɤ˧	wɤ ˧  
wɤ˧mɤ˧kv̩˩lɑ˩	wɤ ˧ m ɤ ˧ k v̩ ˩ l ɑ ˩  
wɤ˩hĩ˩zo˩ho˥ze˩	wɤ ˩ h ĩ ˩ z o ˩ h o ˥ z e ˩  
wɤ˩tsʰɯ˩hĩ˩ʈʂʰɯ˩	wɤ ˩ tsʰ ɯ ˩ h ĩ ˩ ʈʂʰ ɯ ˩  
wɤ˩zo˩kv̩˩	wɤ ˩ z o ˩ k v̩ ˩  
ze˩gɤ˧	z e ˩ g ɤ ˧  
ze˩kɯ˥qo˩	z e ˩ k ɯ ˥ q o ˩  
ze˩mi˩	z e ˩ m i ˩  
ze˩v̩˩ze˥mi˩ki˩dʑo˩	z e ˩ v̩ ˩ z e ˥ m i ˩ k i ˩ dʑ o ˩  
ze˩ɲi˧	z e ˩ ɲ i ˧  
zo	z o  
zo˧bæ˩ɳɯ˩	z o ˧ b æ ˩ ɳ ɯ ˩  
zo˧dʑo˩	z o ˧ dʑ o ˩  
zo˧hṽ˧˥	z o ˧ h ṽ ˧˥  
zo˧hṽ̩˧ki˥	z o ˧ h ṽ̩ ˧ k i ˥  
zo˧hṽ̩˧ɳɯ˥	z o ˧ h ṽ̩ ˧ ɳ ɯ ˥  
zo˧ki˧	z o ˧ k i ˧  
zo˧lɑ˩	z o ˧ l ɑ ˩  
zo˧mv̩˥hɤ˩	z o ˧ m v̩ ˥ h ɤ ˩  
zo˧mv̩˥zo˩	z o ˧ m v̩ ˥ z o ˩  
zo˧mv̩˥zo˩ɻæ˩ki˩	z o ˧ m v̩ ˥ z o ˩ ɻ æ ˩ k i ˩  
zo˧mv̩˥ɳɯ˩	z o ˧ m v̩ ˥ ɳ ɯ ˩  
zo˧mv̩˥ɻæ˩	z o ˧ m v̩ ˥ ɻ æ ˩  
zo˧mv̩˥ʈʂʰɯ˩dʑo˩	z o ˧ m v̩ ˥ ʈʂʰ ɯ ˩ dʑ o ˩  
zo˧ɖɯ˥	z o ˧ ɖ ɯ ˥  
zo˧ʈʂʰɯ˧dʑo˩	z o ˧ ʈʂʰ ɯ ˧ dʑ o ˩  
zo˩bv̩˥ɭɯ˩	z o ˩ b v̩ ˥ ɭ ɯ ˩  
zo˩dʑo˩dʑo˩	z o ˩ dʑ o ˩ dʑ o ˩  
zo˩kv̩˩˥	z o ˩ k v̩ ˩˥  
zo˩no˧se˥	z o ˩ n o ˧ s e ˥  
zo˩no˧ɳhĩ˧	z o ˩ n o ˧ ɳ h ĩ ˧  
zo˩no˧ɳɯ˧	z o ˩ n o ˧ ɳ ɯ ˧  
zo˩qo˥	z o ˩ q o ˥  
zo˩qo˧dʑo˩	z o ˩ q o ˧ dʑ o ˩  
zɑ˩bɑ˧lɑ˩dʑo˩	z ɑ ˩ b ɑ ˧ l ɑ ˩ dʑ o ˩  
zɑ˩tsʰɯ˩dʑo˩	z ɑ ˩ tsʰ ɯ ˩ dʑ o ˩  
zɑ˩tsʰɯ˩zo˩	z ɑ ˩ tsʰ ɯ ˩ z o ˩  
zɯ	z ɯ  
zɯbvzɯbv	z ɯ b v z ɯ b v  
zɯ˧qʰɑ˧mi˧	z ɯ ˧ qʰ ɑ ˧ m i ˧  
zɯ˧qʰɑ˧mi˧kʰɯ˧ʈɯ˥	z ɯ ˧ qʰ ɑ ˧ m i ˧ kʰ ɯ ˧ ʈ ɯ ˥  
zɯ˧ʈʂʰɯ˧	z ɯ ˧ ʈʂʰ ɯ ˧  
æ	æ  
æ˧bv̩˧	æ ˧ b v̩ ˧  
æ˧bv̩˧ʈʂʰɯ˧	æ ˧ b v̩ ˧ ʈʂʰ ɯ ˧  
æ˧mv̩˥tɕi˩hĩ˩	æ ˧ m v̩ ˥ tɕ i ˩ h ĩ ˩  
æ˧mv̩˥tɕi˩kʰwɤ˩lɑ˩	æ ˧ m v̩ ˥ tɕ i ˩ kʰ wɤ ˩ l ɑ ˩  
æ˧mv̩˩	æ ˧ m v̩ ˩  
æ˧ʂæ˧bv̩˧	æ ˧ ʂ æ ˧ b v̩ ˧  
æ˧ʂæ˧dʑɯ˩	æ ˧ ʂ æ ˧ dʑ ɯ ˩  
æ˧ʂæ˧dʑɯ˩ʈʰæ˩qo˩ɳɯ˩	æ ˧ ʂ æ ˧ dʑ ɯ ˩ ʈʰ æ ˩ q o ˩ ɳ ɯ ˩  
æ˧ʂæ˧lɑ˧	æ ˧ ʂ æ ˧ l ɑ ˧  
æ˧ʂæ˧qʰwɤ˧ʈʂʰɯ˥	æ ˧ ʂ æ ˧ qʰ wɤ ˧ ʈʂʰ ɯ ˥  
æ˧ʂæ˧tɑ˩mv̩˩ʈʂʰɯ˩dʑo˩	æ ˧ ʂ æ ˧ t ɑ ˩ m v̩ ˩ ʈʂʰ ɯ ˩ dʑ o ˩  
æ˧ʂæ˧ɳɯ˩	æ ˧ ʂ æ ˧ ɳ ɯ ˩  
æ˧ʂæ˧ʈʂʰɯ˥dʑo˩	æ ˧ ʂ æ ˧ ʈʂʰ ɯ ˥ dʑ o ˩  
æ˩pʰæ˧ni˧˥	æ ˩ pʰ æ ˧ n i ˧˥  
æ˩qʰv̩˧	æ ˩ qʰ v̩ ˧  
æ˩qʰv̩˧qo˧	æ ˩ qʰ v̩ ˧ q o ˧  
æ˩ʈv̩˥ki˩	æ ˩ ʈ v̩ ˥ k i ˩  
æ˩ʈv̩˥qo˩ɳɯ˩	æ ˩ ʈ v̩ ˥ q o ˩ ɳ ɯ ˩  
æ˩˥	æ ˩˥  
æ̃˧tsɯ˥kʰɯ˩ʈʂɤ˩mo˩	æ̃ ˧ ts ɯ ˥ kʰ ɯ ˩ ʈʂ ɤ ˩ m o ˩  
æ̃˧tsɯ˥kʰɯ˩ʈʂɤ˩mo˩pi˩	æ̃ ˧ ts ɯ ˥ kʰ ɯ ˩ ʈʂ ɤ ˩ m o ˩ p i ˩  
æ̃˩go˧	æ̃ ˩ g o ˧  
æ̃˩ʁv̩˩pɤ˥jɤ˩	æ̃ ˩ ʁ v̩ ˩ p ɤ ˥ jɤ ˩  
æ̃˩ʂe˧li˥mo˩	æ̃ ˩ ʂ e ˧ l i ˥ m o ˩  
æ̃˩ʂe˧li˥mo˩pi˩	æ̃ ˩ ʂ e ˧ l i ˥ m o ˩ p i ˩  
æ̃˩ʂe˧li˥mo˩pi˩hĩ˩	æ̃ ˩ ʂ e ˧ l i ˥ m o ˩ p i ˩ h ĩ ˩  
æ̃˩ʂe˧li˥mo˩ʈʂʰɯ˩dʑo˩	æ̃ ˩ ʂ e ˧ l i ˥ m o ˩ ʈʂʰ ɯ ˩ dʑ o ˩  
æ̃˩ʂe˧v̩˥dʑɯ˩	æ̃ ˩ ʂ e ˧ v̩ ˥ dʑ ɯ ˩  
æ̃˩ʈʂʰɯ˥	æ̃ ˩ ʈʂʰ ɯ ˥  
õ	õ  
ŋv̩˧ki˧	ŋ v̩ ˧ k i ˧  
ŋv̩˩kv̩˩ze˩mæ˩	ŋ v̩ ˩ k v̩ ˩ z e ˩ m æ ˩  
ŋv̩˩kv̩˩˥	ŋ v̩ ˩ k v̩ ˩˥  
ŋv̩˩lo˩dʑo˥	ŋ v̩ ˩ l o ˩ dʑ o ˥  
ŋv̩˩lo˩pv̩˩pi˥	ŋ v̩ ˩ l o ˩ p v̩ ˩ p i ˥  
ŋv̩˩lo˩pv̩˩˥	ŋ v̩ ˩ l o ˩ p v̩ ˩˥  
ŋv̩˩mɤ˩ʝi˩ze˥	ŋ v̩ ˩ m ɤ ˩ ʝ i ˩ z e ˥  
ŋv̩˩zo˩kv̩˥mæ˩	ŋ v̩ ˩ z o ˩ k v̩ ˥ m æ ˩  
ŋv̩˩zo˩kv̩˩	ŋ v̩ ˩ z o ˩ k v̩ ˩  
ŋv̩˩ɲi˥pi˩tsɯ˩	ŋ v̩ ˩ ɲ i ˥ p i ˩ ts ɯ ˩  
ŋv̩˩ʂe˩bæ˩pi˥	ŋ v̩ ˩ ʂ e ˩ b æ ˩ p i ˥  
ŋwɤ˧hɑ̃˩pi˩hĩ˩ʈʂʰɯ˩dʑo˩	ŋ wɤ ˧ h ɑ̃ ˩ p i ˩ h ĩ ˩ ʈʂʰ ɯ ˩ dʑ o ˩  
ŋwɤ˧hɑ̃˩ʁo˩	ŋ wɤ ˧ h ɑ̃ ˩ ʁ o ˩  
ŋwɤ˧hɑ̃˩ʁo˩gɤ˩	ŋ wɤ ˧ h ɑ̃ ˩ ʁ o ˩ g ɤ ˩  
ŋwɤ˧hɑ̃˩ʈʂʰɯ˩	ŋ wɤ ˧ h ɑ̃ ˩ ʈʂʰ ɯ ˩  
ŋwɤ˧hɑ̃˩ʈʂʰɯ˩dʑo˩	ŋ wɤ ˧ h ɑ̃ ˩ ʈʂʰ ɯ ˩ dʑ o ˩  
ŋwɤ˧kʰv̩˩	ŋ wɤ ˧ kʰ v̩ ˩  
ŋwɤ˧tsʰi˩	ŋ wɤ ˧ tsʰ i ˩  
ŋwɤ˧tsʰi˩kʰv̩˩	ŋ wɤ ˧ tsʰ i ˩ kʰ v̩ ˩  
ŋwɤ˧tsʰi˩kʰv̩˩ɳɯ˩	ŋ wɤ ˧ tsʰ i ˩ kʰ v̩ ˩ ɳ ɯ ˩  
ŋwɤ˧tsʰi˩kʰɯ˩ʈʰæ˩qʰwɤ˩pi˩	ŋ wɤ ˧ tsʰ i ˩ kʰ ɯ ˩ ʈʰ æ ˩ qʰ wɤ ˩ p i ˩  
ŋwɤ˧ɕi˧mæ˥	ŋ wɤ ˧ ɕ i ˧ m æ ˥  
ŋwɤ˩bæ˩hĩ˥ʈʂʰɯ˩	ŋ wɤ ˩ b æ ˩ h ĩ ˥ ʈʂʰ ɯ ˩  
ŋwɤ˩bæ˩sɯ˥	ŋ wɤ ˩ b æ ˩ s ɯ ˥  
ŋwɤ˩ɬi˩ŋwɤ˥ɬi˩	ŋ wɤ ˩ ɬ i ˩ ŋ wɤ ˥ ɬ i ˩  
ŋwɤ˩ɭɯ˩qo˥	ŋ wɤ ˩ ɭ ɯ ˩ q o ˥  
ŋæ˧ʝi˩	ŋ æ ˧ ʝ i ˩  
ŋɲi˩	ŋ ɲ i ˩  
ɑ˩pʰo˩hĩ˩ɳɯ˥dʑo˩	ɑ ˩ pʰ o ˩ h ĩ ˩ ɳ ɯ ˥ dʑ o ˩  
ɑ˩ʁ	ɑ ˩ ʁ  
ɑ˩ʁo˧gɤ˧	ɑ ˩ ʁ o ˧ g ɤ ˧  
ɑ˩ʁo˧hĩ˧ɻæ˥	ɑ ˩ ʁ o ˧ h ĩ ˧ ɻ æ ˥  
ɑ˩ʁo˧kʰi˧	ɑ ˩ ʁ o ˧ kʰ i ˧  
ɑ˩ʁo˧lo˧	ɑ ˩ ʁ o ˧ l o ˧  
ɑ˩ʁo˧ʐwæ˧ni˧˥	ɑ ˩ ʁ o ˧ ʐ wæ ˧ n i ˧˥  
ɑ˩ʁo˧ʑi˧dv̩˧	ɑ ˩ ʁ o ˧ ʑ i ˧ d v̩ ˧  
ɑ̃	ɑ̃  
ɔɔ	ɔ ɔ  
ɕi˧tjɤ˧	ɕ i ˧ t jɤ ˧  
ɕi˧ɕjẽ˧	ɕ i ˧ ɕ j ẽ ˧  
ɕi˧ʈʂʰwæ˧bi˩	ɕ i ˧ ʈʂʰ wæ ˧ b i ˩  
ɕi˧ʈʂʰwæ˧hɑ˧ni˧˥	ɕ i ˧ ʈʂʰ wæ ˧ h ɑ ˧ n i ˧˥  
ɕi˧ʈʂʰwæ˧pɤ˩jɤ˩	ɕ i ˧ ʈʂʰ wæ ˧ p ɤ ˩ jɤ ˩  
ɕi˧ʈʂʰwæ˧ʁo˩	ɕ i ˧ ʈʂʰ wæ ˧ ʁ o ˩  
ɕi˩ɻ˩	ɕ i ˩ ɻ ˩  
ɕjo˩li˧	ɕ jo ˩ l i ˧  
ɕjo˩ɕjɑ˩˥	ɕ jo ˩ ɕ j ɑ ˩˥  
ɕjɑ˧tɕo˧ki˧	ɕ j ɑ ˧ tɕ o ˧ k i ˧  
ɕjɤ˧kv̩˥mæ˩	ɕ jɤ ˧ k v̩ ˥ m æ ˩  
ɕjɤ˩tʰv̩˧kv̩˥	ɕ jɤ ˩ tʰ v̩ ˧ k v̩ ˥  
ɕjɤ˩tʰv̩˩kv̩˥mæ˩	ɕ jɤ ˩ tʰ v̩ ˩ k v̩ ˥ m æ ˩  
ɖwæ	ɖ wæ  
ɖwæ˧kv̩˥	ɖ wæ ˧ k v̩ ˥  
ɖwæ˩mɤ˧zo˧ze˧	ɖ wæ ˩ m ɤ ˧ z o ˧ z e ˧  
ɖæ˧	ɖ æ ˧  
ɖæ˩	ɖ æ ˩  
ɖæ˩dʑo˩	ɖ æ ˩ dʑ o ˩  
ɖæ˩mi˧hĩ˧ni˧gv̩˧	ɖ æ ˩ m i ˧ h ĩ ˧ n i ˧ g v̩ ˧  
ɖæ˩mi˧qo˧	ɖ æ ˩ m i ˧ q o ˧  
ɖæ˩mi˧qo˧ɳ	ɖ æ ˩ m i ˧ q o ˧ ɳ  
ɖæ˩mi˧sɯ˩pʰi˩ɻ̍˩ɳɯ˩dʑo˩	ɖ æ ˩ m i ˧ s ɯ ˩ pʰ i ˩ ɻ̍ ˩ ɳ ɯ ˩ dʑ o ˩  
ɖæ˩mi˧sɯ˩pʰi˩ʈʂʰɯ˩dʑo˩	ɖ æ ˩ m i ˧ s ɯ ˩ pʰ i ˩ ʈʂʰ ɯ ˩ dʑ o ˩  
ɖæ˩mi˧z	ɖ æ ˩ m i ˧ z  
ɖæ˩mi˧ɳɯ˧qo˧	ɖ æ ˩ m i ˧ ɳ ɯ ˧ q o ˧  
ɖæ˩mi˧ɻ̍˩ɳɯ˩	ɖ æ ˩ m i ˧ ɻ̍ ˩ ɳ ɯ ˩  
ɖæ˩ze˩tsɯ˩	ɖ æ ˩ z e ˩ ts ɯ ˩  
ɖɯ˥kv̩˩	ɖ ɯ ˥ k v̩ ˩  
ɖɯ˥kv̩˩ze˩	ɖ ɯ ˥ k v̩ ˩ z e ˩  
ɖɯ˥ʈʂɤ˩kv̩˩mæ˩	ɖ ɯ ˥ ʈʂ ɤ ˩ k v̩ ˩ m æ ˩  
ɖɯ˧bi˧	ɖ ɯ ˧ b i ˧  
ɖɯ˧bv̩˧ʈʂɯ˥	ɖ ɯ ˧ b v̩ ˧ ʈʂ ɯ ˥  
ɖɯ˧bv̩˧ʈʂɯ˥ɖɯ˩bv̩˩ʈʂɯ˩	ɖ ɯ ˧ b v̩ ˧ ʈʂ ɯ ˥ ɖ ɯ ˩ b v̩ ˩ ʈʂ ɯ ˩  
ɖɯ˧bæ˧lɑ˧	ɖ ɯ ˧ b æ ˧ l ɑ ˧  
ɖɯ˧bæ˧qo˧ɳɯ˧	ɖ ɯ ˧ b æ ˧ q o ˧ ɳ ɯ ˧  
ɖɯ˧bɤ˧	ɖ ɯ ˧ b ɤ ˧  
ɖɯ˧di˩	ɖ ɯ ˧ d i ˩  
ɖɯ˧di˩qo˩	ɖ ɯ ˧ d i ˩ q o ˩  
ɖɯ˧di˩qo˩dʑo˩	ɖ ɯ ˧ d i ˩ q o ˩ dʑ o ˩  
ɖɯ˧di˩qo˩tʰv̩˩dʑo˩	ɖ ɯ ˧ d i ˩ q o ˩ tʰ v̩ ˩ dʑ o ˩  
ɖɯ˧di˩ɻ̍˩qo˩	ɖ ɯ ˧ d i ˩ ɻ̍ ˩ q o ˩  
ɖɯ˧dv̩˩ɖɯ˩dv̩˩	ɖ ɯ ˧ d v̩ ˩ ɖ ɯ ˩ d v̩ ˩  
ɖɯ˧dzi˧hĩ˧tʰv̩˧dʑo˩	ɖ ɯ ˧ dz i ˧ h ĩ ˧ tʰ v̩ ˧ dʑ o ˩  
ɖɯ˧dzi˩ɳɯ˩	ɖ ɯ ˧ dz i ˩ ɳ ɯ ˩  
ɖɯ˧dzi˩ɻ̩˩	ɖ ɯ ˧ dz i ˩ ɻ̩ ˩  
ɖɯ˧gɤ˧ɳɯ˥	ɖ ɯ ˧ g ɤ ˧ ɳ ɯ ˥  
ɖɯ˧ho˩	ɖ ɯ ˧ h o ˩  
ɖɯ˧hɑ̃˧	ɖ ɯ ˧ h ɑ̃ ˧  
ɖɯ˧hɑ̃˧ɳɯ˥	ɖ ɯ ˧ h ɑ̃ ˧ ɳ ɯ ˥  
ɖɯ˧hɑ̃˧˥	ɖ ɯ ˧ h ɑ̃ ˧˥  
ɖɯ˧k	ɖ ɯ ˧ k  
ɖɯ˧ki˩ɻ̍˩	ɖ ɯ ˧ k i ˩ ɻ̍ ˩  
ɖɯ˧kv̩˧ze˥mv̩˩	ɖ ɯ ˧ k v̩ ˧ z e ˥ m v̩ ˩  
ɖɯ˧kv̩˧˥	ɖ ɯ ˧ k v̩ ˧˥  
ɖɯ˧kɤ˧	ɖ ɯ ˧ k ɤ ˧  
ɖɯ˧kɤ˧ɖɯ˥kɤ˩	ɖ ɯ ˧ k ɤ ˧ ɖ ɯ ˥ k ɤ ˩  
ɖɯ˧kɤ˩ɖɯ˩kɤ˩	ɖ ɯ ˧ k ɤ ˩ ɖ ɯ ˩ k ɤ ˩  
ɖɯ˧kʰv̩˥	ɖ ɯ ˧ kʰ v̩ ˥  
ɖɯ˧kʰv̩˥dʑo˩	ɖ ɯ ˧ kʰ v̩ ˥ dʑ o ˩  
ɖɯ˧kʰv̩˧	ɖ ɯ ˧ kʰ v̩ ˧  
ɖɯ˧kʰv̩˧hĩ˧bv̩˧	ɖ ɯ ˧ kʰ v̩ ˧ h ĩ ˧ b v̩ ˧  
ɖɯ˧kʰv̩˧hĩ˥	ɖ ɯ ˧ kʰ v̩ ˧ h ĩ ˥  
ɖɯ˧kʰv̩˧lɑ˥	ɖ ɯ ˧ kʰ v̩ ˧ l ɑ ˥  
ɖɯ˧kʰwɤ˥sɯ˩	ɖ ɯ ˧ kʰ wɤ ˥ s ɯ ˩  
ɖɯ˧kʰwɤ˥ɖɯ˩kʰwɤ˩lɑ˩	ɖ ɯ ˧ kʰ wɤ ˥ ɖ ɯ ˩ kʰ wɤ ˩ l ɑ ˩  
ɖɯ˧kʰɤ˧ɖɯ˥kʰɤ˩	ɖ ɯ ˧ kʰ ɤ ˧ ɖ ɯ ˥ kʰ ɤ ˩  
ɖɯ˧kʰɯ˥bi˩	ɖ ɯ ˧ kʰ ɯ ˥ b i ˩  
ɖɯ˧kʰɯ˩lɑ˩	ɖ ɯ ˧ kʰ ɯ ˩ l ɑ ˩  
ɖɯ˧kʰɯ˩qo˩	ɖ ɯ ˧ kʰ ɯ ˩ q o ˩  
ɖɯ˧kʰɯ˩ɳɯ˩	ɖ ɯ ˧ kʰ ɯ ˩ ɳ ɯ ˩  
ɖɯ˧li˧ɻ̍˩	ɖ ɯ ˧ l i ˧ ɻ̍ ˩  
ɖɯ˧li˧ɻ̍˩dʑo˩	ɖ ɯ ˧ l i ˧ ɻ̍ ˩ dʑ o ˩  
ɖɯ˧lv̩˩ɻ̍˩ki˩	ɖ ɯ ˧ l v̩ ˩ ɻ̍ ˩ k i ˩  
ɖɯ˧mi˩	ɖ ɯ ˧ m i ˩  
ɖɯ˧mɤ	ɖ ɯ ˧ m ɤ  
ɖɯ˧mɤ˧kv̩˧˥	ɖ ɯ ˧ m ɤ ˧ k v̩ ˧˥  
ɖɯ˧njɤ˥	ɖ ɯ ˧ n jɤ ˥  
ɖɯ˧pi˧	ɖ ɯ ˧ p i ˧  
ɖɯ˧po˩po˩	ɖ ɯ ˧ p o ˩ p o ˩  
ɖɯ˧pv̩˧ɻ̍˩kʰɯ˩	ɖ ɯ ˧ p v̩ ˧ ɻ̍ ˩ kʰ ɯ ˩  
ɖɯ˧pʰo˧bi˥ɳɯ˩	ɖ ɯ ˧ pʰ o ˧ b i ˥ ɳ ɯ ˩  
ɖɯ˧pʰo˧ɖɯ˥pʰo˩hĩ˩dʑo˩	ɖ ɯ ˧ pʰ o ˧ ɖ ɯ ˥ pʰ o ˩ h ĩ ˩ dʑ o ˩  
ɖɯ˧pʰv̩˧˥	ɖ ɯ ˧ pʰ v̩ ˧˥  
ɖɯ˧pʰæ˧lɑ˥	ɖ ɯ ˧ pʰ æ ˧ l ɑ ˥  
ɖɯ˧pʰæ˧qo˥	ɖ ɯ ˧ pʰ æ ˧ q o ˥  
ɖɯ˧pʰæ˧ɖɯ˥pʰæ˩	ɖ ɯ ˧ pʰ æ ˧ ɖ ɯ ˥ pʰ æ ˩  
ɖɯ˧qo˥lv̩˩ɖɯ˩qo˩lv̩˩	ɖ ɯ ˧ q o ˥ l v̩ ˩ ɖ ɯ ˩ q o ˩ l v̩ ˩  
ɖɯ˧qo˩ho˩	ɖ ɯ ˧ q o ˩ h o ˩  
ɖɯ˧qwælɑ˥ɻ̍˩kv̩˩mæ˩	ɖ ɯ ˧ q wæ l ɑ ˥ ɻ̍ ˩ k v̩ ˩ m æ ˩  
ɖɯ˧qwæ˧ɻ̍˧kv̩˥	ɖ ɯ ˧ q wæ ˧ ɻ̍ ˧ k v̩ ˥  
ɖɯ˧qæ˧qæ˧ɻ̍˥	ɖ ɯ ˧ q æ ˧ q æ ˧ ɻ̍ ˥  
ɖɯ˧qɑ˧qɑ˥bi˩	ɖ ɯ ˧ q ɑ ˧ q ɑ ˥ b i ˩  
ɖɯ˧qɑ˧ɻ̍˧	ɖ ɯ ˧ q ɑ ˧ ɻ̍ ˧  
ɖɯ˧qɑ˩	ɖ ɯ ˧ q ɑ ˩  
ɖɯ˧qʰv̩˧tʰv̩˧	ɖ ɯ ˧ qʰ v̩ ˧ tʰ v̩ ˧  
ɖɯ˧qʰwɤ˧hĩ˥	ɖ ɯ ˧ qʰ wɤ ˧ h ĩ ˥  
ɖɯ˧qʰwɤ˧tʰv̩˧	ɖ ɯ ˧ qʰ wɤ ˧ tʰ v̩ ˧  
ɖɯ˧qʰwɤ˧ɖɯ˥qʰwɤ˩ʈʂʰɯ˩	ɖ ɯ ˧ qʰ wɤ ˧ ɖ ɯ ˥ qʰ wɤ ˩ ʈʂʰ ɯ ˩  
ɖɯ˧qʰwɤ˧ɳɯ˥	ɖ ɯ ˧ qʰ wɤ ˧ ɳ ɯ ˥  
ɖɯ˧qʰwɤ˧ɻ̍˩kv̩˩tsɯ˩	ɖ ɯ ˧ qʰ wɤ ˧ ɻ̍ ˩ k v̩ ˩ ts ɯ ˩  
ɖɯ˧so˩ɻ̍˩	ɖ ɯ ˧ s o ˩ ɻ̍ ˩  
ɖɯ˧ti˧	ɖ ɯ ˧ t i ˧  
ɖɯ˧ti˧ɖɯ˥ti˩	ɖ ɯ ˧ t i ˧ ɖ ɯ ˥ t i ˩  
ɖɯ˧tso˧kʰwɤ˧	ɖ ɯ ˧ ts o ˧ kʰ wɤ ˧  
ɖɯ˧tsɑ˧˥	ɖ ɯ ˧ ts ɑ ˧˥  
ɖɯ˧tsɯ˧˥	ɖ ɯ ˧ ts ɯ ˧˥  
ɖɯ˧tsʰi˥ɖɯ˩tsʰi˩hĩ˩tʰv̩˩	ɖ ɯ ˧ tsʰ i ˥ ɖ ɯ ˩ tsʰ i ˩ h ĩ ˩ tʰ v̩ ˩  
ɖɯ˧tsʰi˥ɳɯ˩	ɖ ɯ ˧ tsʰ i ˥ ɳ ɯ ˩  
ɖɯ˧tv̩˧kʰv̩˧˥	ɖ ɯ ˧ t v̩ ˧ kʰ v̩ ˧˥  
ɖɯ˧tɑ˩ɖɯ˩tɑ˩	ɖ ɯ ˧ t ɑ ˩ ɖ ɯ ˩ t ɑ ˩  
ɖɯ˧tɕi˧tɕi˧	ɖ ɯ ˧ tɕ i ˧ tɕ i ˧  
ɖɯ˧tɕɯ˧	ɖ ɯ ˧ tɕ ɯ ˧  
ɖɯ˧tɕɯ˧ɻ˧bi˥	ɖ ɯ ˧ tɕ ɯ ˧ ɻ ˧ b i ˥  
ɖɯ˧tɕɯ˧ɻ̍˥	ɖ ɯ ˧ tɕ ɯ ˧ ɻ̍ ˥  
ɖɯ˧tɕɯ˧˥	ɖ ɯ ˧ tɕ ɯ ˧˥  
ɖɯ˧tɕʰi˧qɑ˩ɻ̍˩	ɖ ɯ ˧ tɕʰ i ˧ q ɑ ˩ ɻ̍ ˩  
ɖɯ˧tʰv̩˩	ɖ ɯ ˧ tʰ v̩ ˩  
ɖɯ˧v̩˧dʑo˩	ɖ ɯ ˧ v̩ ˧ dʑ o ˩  
ɖɯ˧v̩˧gi˧ɳɯ˥	ɖ ɯ ˧ v̩ ˧ g i ˧ ɳ ɯ ˥  
ɖɯ˧v̩˧hĩ˧se˥	ɖ ɯ ˧ v̩ ˧ h ĩ ˧ s e ˥  
ɖɯ˧v̩˧hĩ˧ʈʂʰɯ˥dʑo˩	ɖ ɯ ˧ v̩ ˧ h ĩ ˧ ʈʂʰ ɯ ˥ dʑ o ˩  
ɖɯ˧v̩˧hĩ˧ʈʂʰɯ˧	ɖ ɯ ˧ v̩ ˧ h ĩ ˧ ʈʂʰ ɯ ˧  
ɖɯ˧v̩˧hĩ˧ʈʂʰɯ˧ɳɯ˩	ɖ ɯ ˧ v̩ ˧ h ĩ ˧ ʈʂʰ ɯ ˧ ɳ ɯ ˩  
ɖɯ˧v̩˧ki˥	ɖ ɯ ˧ v̩ ˧ k i ˥  
ɖɯ˧v̩˧pʰæ˧di˧zo˩	ɖ ɯ ˧ v̩ ˧ pʰ æ ˧ d i ˧ z o ˩  
ɖɯ˧v̩˧ɖɯ˧v̩˧dʑo˧	ɖ ɯ ˧ v̩ ˧ ɖ ɯ ˧ v̩ ˧ dʑ o ˧  
ɖɯ˧v̩˧ɖɯ˧v̩˧ki˧ni˧˥	ɖ ɯ ˧ v̩ ˧ ɖ ɯ ˧ v̩ ˧ k i ˧ n i ˧˥  
ɖɯ˧v̩˧ɖɯ˧v̩˧ʈʂʰɯ˧	ɖ ɯ ˧ v̩ ˧ ɖ ɯ ˧ v̩ ˧ ʈʂʰ ɯ ˧  
ɖɯ˧v̩˧ɳɯ˧dʑo˥	ɖ ɯ ˧ v̩ ˧ ɳ ɯ ˧ dʑ o ˥  
ɖɯ˧v̩˧ɳɯ˧ʈʂʰɯ˧	ɖ ɯ ˧ v̩ ˧ ɳ ɯ ˧ ʈʂʰ ɯ ˧  
ɖɯ˧v̩˧ʈʂʰɯ˧	ɖ ɯ ˧ v̩ ˧ ʈʂʰ ɯ ˧  
ɖɯ˧v̩˧ʈʂʰɯ˧ɳɯ˩	ɖ ɯ ˧ v̩ ˧ ʈʂʰ ɯ ˧ ɳ ɯ ˩  
ɖɯ˧wɤ˩	ɖ ɯ ˧ wɤ ˩  
ɖɯ˧ze˥	ɖ ɯ ˧ z e ˥  
ɖɯ˧zɯ˧ɖɯ˧ʈʂʰæ˧˥	ɖ ɯ ˧ z ɯ ˧ ɖ ɯ ˧ ʈʂʰ æ ˧˥  
ɖɯ˧ɕi˧kʰv̩˧	ɖ ɯ ˧ ɕ i ˧ kʰ v̩ ˧  
ɖɯ˧ɕi˧kʰv̩˧˥	ɖ ɯ ˧ ɕ i ˧ kʰ v̩ ˧˥  
ɖɯ˧ɖʐɯ˥kʰɤ˩	ɖ ɯ ˧ ɖʐ ɯ ˥ kʰ ɤ ˩  
ɖɯ˧ɬi˧bv̩˧	ɖ ɯ ˧ ɬ i ˧ b v̩ ˧  
ɖɯ˧ɬi˧mi˧qo˧	ɖ ɯ ˧ ɬ i ˧ m i ˧ q o ˧  
ɖɯ˧ɬi˧mi˧qo˧ɳɯ˧	ɖ ɯ ˧ ɬ i ˧ m i ˧ q o ˧ ɳ ɯ ˧  
ɖɯ˧ɬi˧qo˧	ɖ ɯ ˧ ɬ i ˧ q o ˧  
ɖɯ˧ɬi˧ɖʐɯ˩bi˩	ɖ ɯ ˧ ɬ i ˧ ɖʐ ɯ ˩ b i ˩  
ɖɯ˧ɭ	ɖ ɯ ˧ ɭ  
ɖɯ˧ɭɯ˧hĩ˧ʈʂʰɯ˧dʑo˩	ɖ ɯ ˧ ɭ ɯ ˧ h ĩ ˧ ʈʂʰ ɯ ˧ dʑ o ˩  
ɖɯ˧ɭɯ˧kʰwɤ˥sɯ˩	ɖ ɯ ˧ ɭ ɯ ˧ kʰ wɤ ˥ s ɯ ˩  
ɖɯ˧ɭɯ˧lɑ˥	ɖ ɯ ˧ ɭ ɯ ˧ l ɑ ˥  
ɖɯ˧ɭɯ˧lɑ˧	ɖ ɯ ˧ ɭ ɯ ˧ l ɑ ˧  
ɖɯ˧ɭɯ˧qo˧sɯ˧	ɖ ɯ ˧ ɭ ɯ ˧ q o ˧ s ɯ ˧  
ɖɯ˧ɭɯ˧qo˧ɳɯ˧dʑo˥	ɖ ɯ ˧ ɭ ɯ ˧ q o ˧ ɳ ɯ ˧ dʑ o ˥  
ɖɯ˧ɭɯ˧ɖɯ˧ɭɯ˧ɖɯ˧ɭɯ˧ɖɯ˧ɭɯ˧ɖɯ˧ɭɯ˧	ɖ ɯ ˧ ɭ ɯ ˧ ɖ ɯ ˧ ɭ ɯ ˧ ɖ ɯ ˧ ɭ ɯ ˧ ɖ ɯ ˧ ɭ ɯ ˧ ɖ ɯ ˧ ɭ ɯ ˧  
ɖɯ˧ɭɯ˧ɖɯ˧ɭɯ˧ʈʂʰɯ˧	ɖ ɯ ˧ ɭ ɯ ˧ ɖ ɯ ˧ ɭ ɯ ˧ ʈʂʰ ɯ ˧  
ɖɯ˧ɭɯ˧ɳɯ˧dʑo˥	ɖ ɯ ˧ ɭ ɯ ˧ ɳ ɯ ˧ dʑ o ˥  
ɖɯ˧ɭɯ˧ʈʰæ˧qo˩	ɖ ɯ ˧ ɭ ɯ ˧ ʈʰ æ ˧ q o ˩  
ɖɯ˧ɭɯ˧ʈʰæ˧qo˩tʰv̩˩dʑo˩	ɖ ɯ ˧ ɭ ɯ ˧ ʈʰ æ ˧ q o ˩ tʰ v̩ ˩ dʑ o ˩  
ɖɯ˧ɭɯ˧˥	ɖ ɯ ˧ ɭ ɯ ˧˥  
ɖɯ˧ɲi	ɖ ɯ ˧ ɲ i  
ɖɯ˧ɲi˥tsɯ˩	ɖ ɯ ˧ ɲ i ˥ ts ɯ ˩  
ɖɯ˧ɲi˥tsɯ˩mv̩˩	ɖ ɯ ˧ ɲ i ˥ ts ɯ ˩ m v̩ ˩  
ɖɯ˧ɲi˥ɳɯ˩	ɖ ɯ ˧ ɲ i ˥ ɳ ɯ ˩  
ɖɯ˧ɲi˧kv̩˧	ɖ ɯ ˧ ɲ i ˧ k v̩ ˧  
ɖɯ˧ɲi˧ʈʂʰɯ˥dʑo˩	ɖ ɯ ˧ ɲ i ˧ ʈʂʰ ɯ ˥ dʑ o ˩  
ɖɯ˧ɲi˧ʑi˩	ɖ ɯ ˧ ɲ i ˧ ʑ i ˩  
ɖɯ˧ʁ	ɖ ɯ ˧ ʁ  
ɖɯ˧ʁo˧	ɖ ɯ ˧ ʁ o ˧  
ɖɯ˧ʁo˧kwɤ˧tɕɯ˥lɑ˩	ɖ ɯ ˧ ʁ o ˧ k wɤ ˧ tɕ ɯ ˥ l ɑ ˩  
ɖɯ˧ʁo˩dʑo˩kv̩˩	ɖ ɯ ˧ ʁ o ˩ dʑ o ˩ k v̩ ˩  
ɖɯ˧ʁæ˧bæ˧	ɖ ɯ ˧ ʁ æ ˧ b æ ˧  
ɖɯ˧ʁæ˩bæ˩	ɖ ɯ ˧ ʁ æ ˩ b æ ˩  
ɖɯ˧ʂv̩˧ɻ˥lɑ˩	ɖ ɯ ˧ ʂ v̩ ˧ ɻ ˥ l ɑ ˩  
ɖɯ˧ʂwæ˧	ɖ ɯ ˧ ʂ wæ ˧  
ɖɯ˧ʂɯ˩hĩ˩	ɖ ɯ ˧ ʂ ɯ ˩ h ĩ ˩  
ɖɯ˧ʂɯ˩ɖɯ˩ʂɯ˩	ɖ ɯ ˧ ʂ ɯ ˩ ɖ ɯ ˩ ʂ ɯ ˩  
ɖɯ˧ʈv̩˧mæ˩	ɖ ɯ ˧ ʈ v̩ ˧ m æ ˩  
ɖɯ˧ʈv̩˩ɖɯ˩ʈv̩˩	ɖ ɯ ˧ ʈ v̩ ˩ ɖ ɯ ˩ ʈ v̩ ˩  
ɖɯ˧ʈʂwæ˥	ɖ ɯ ˧ ʈʂ wæ ˥  
ɖɯ˧ʈʂwɤ˧ɖɯ˧ʈʂwɤ˧	ɖ ɯ ˧ ʈʂ wɤ ˧ ɖ ɯ ˧ ʈʂ wɤ ˧  
ɖɯ˧ʈʂʰæ˧qo˥	ɖ ɯ ˧ ʈʂʰ æ ˧ q o ˥  
ɖɯ˧ʈʂʰɻ̍˧ɖɯ˥ʈʂʰɻ̍˩	ɖ ɯ ˧ ʈʂʰ ɻ̍ ˧ ɖ ɯ ˥ ʈʂʰ ɻ̍ ˩  
ɖɯ˧ʈʰɤ˥ɳɯ˩	ɖ ɯ ˧ ʈʰ ɤ ˥ ɳ ɯ ˩  
ɖɯ˧ʑi˧ɳɯ˧	ɖ ɯ ˧ ʑ i ˧ ɳ ɯ ˧  
ɖɯ˧ʑi˧ɻ̍˩	ɖ ɯ ˧ ʑ i ˧ ɻ̍ ˩  
ɖɯ˧ʑi˩hĩ˩tʰv̩˩	ɖ ɯ ˧ ʑ i ˩ h ĩ ˩ tʰ v̩ ˩  
ɖɯ˧ʑi˩hĩ˩ʈʂʰɯ˩dʑo˩	ɖ ɯ ˧ ʑ i ˩ h ĩ ˩ ʈʂʰ ɯ ˩ dʑ o ˩  
ɖɯ˧ʑi˩lɑ˩	ɖ ɯ ˧ ʑ i ˩ l ɑ ˩  
ɖɯ˧ʑi˩pi˩tsɯ˩	ɖ ɯ ˧ ʑ i ˩ p i ˩ ts ɯ ˩  
ɖɯ˧ʑi˩ɖɯ˩ʑi˩dʑo˩	ɖ ɯ ˧ ʑ i ˩ ɖ ɯ ˩ ʑ i ˩ dʑ o ˩  
ɖɯ˧ʑi˩ɖɯ˩ʑi˩ki˩ni˩	ɖ ɯ ˧ ʑ i ˩ ɖ ɯ ˩ ʑ i ˩ k i ˩ n i ˩  
ɖɯ˩hĩ˥	ɖ ɯ ˩ h ĩ ˥  
ɖɯ˩hĩ˩bv̩˩˥	ɖ ɯ ˩ h ĩ ˩ b v̩ ˩˥  
ɖɯ˩hĩ˩ki˥dʑo˩	ɖ ɯ ˩ h ĩ ˩ k i ˥ dʑ o ˩  
ɖɯ˩hĩ˩qo˥	ɖ ɯ ˩ h ĩ ˩ q o ˥  
ɖɯ˩hĩ˩ɳɯ˥	ɖ ɯ ˩ h ĩ ˩ ɳ ɯ ˥  
ɖɯ˩hɑ̃˩dʑo˩	ɖ ɯ ˩ h ɑ̃ ˩ dʑ o ˩  
ɖɯ˩kv̩˩	ɖ ɯ ˩ k v̩ ˩  
ɖɯ˩kʰv̩˩	ɖ ɯ ˩ kʰ v̩ ˩  
ɖɯ˩kʰv̩˩dʑo˩	ɖ ɯ ˩ kʰ v̩ ˩ dʑ o ˩  
ɖɯ˩lo˥ɳɯ˩	ɖ ɯ ˩ l o ˥ ɳ ɯ ˩  
ɖɯ˩lo˧hĩ˧ʈʂʰɯ˧	ɖ ɯ ˩ l o ˧ h ĩ ˧ ʈʂʰ ɯ ˧  
ɖɯ˩lo˧ʈʂʰɯ˧	ɖ ɯ ˩ l o ˧ ʈʂʰ ɯ ˧  
ɖɯ˩mɑ˧ɬɑ˩tsʰo˩	ɖ ɯ ˩ m ɑ ˧ ɬ ɑ ˩ tsʰ o ˩  
ɖɯ˩so˩dʑo˩	ɖ ɯ ˩ s o ˩ dʑ o ˩  
ɖɯ˩zo˥	ɖ ɯ ˩ z o ˥  
ɖɯ˩zo˩	ɖ ɯ ˩ z o ˩  
ɖɯ˩ɖʐɯ˧	ɖ ɯ ˩ ɖʐ ɯ ˧  
ɖɯ˩ɲi˥mæ˩	ɖ ɯ ˩ ɲ i ˥ m æ ˩  
ɖɯ˩ɲi˩kv̩˩tsɯ˩	ɖ ɯ ˩ ɲ i ˩ k v̩ ˩ ts ɯ ˩  
ɖɯ˩ɲi˩tsɯ˩	ɖ ɯ ˩ ɲ i ˩ ts ɯ ˩  
ɖɯ˩ɲi˩tsɯ˩mv̩˩	ɖ ɯ ˩ ɲ i ˩ ts ɯ ˩ m v̩ ˩  
ɖɯ˩ʈʂɤ˩kv̩˥tsɯ˩	ɖ ɯ ˩ ʈʂ ɤ ˩ k v̩ ˥ ts ɯ ˩  
ɖɯ˩ʝi˩	ɖ ɯ ˩ ʝ i ˩  
ɖɯ˩˥	ɖ ɯ ˩˥  
ɖʐe˧ki˧	ɖʐ e ˧ k i ˧  
ɖʐo˩	ɖʐ o ˩  
ɖʐv	ɖʐ v  
ɖʐv̩˧nɑ˥mi˩gi˩ɳɯ˩	ɖʐ v̩ ˧ n ɑ ˥ m i ˩ g i ˩ ɳ ɯ ˩  
ɖʐv̩˧nɑ˥mi˩ʁæ˩ʈv̩˩ni˩zo˩	ɖʐ v̩ ˧ n ɑ ˥ m i ˩ ʁ æ ˩ ʈ v̩ ˩ n i ˩ z o ˩  
ɖʐv̩˧qɑ˧	ɖʐ v̩ ˧ q ɑ ˧  
ɖʐv̩˧ɳɯ˧	ɖʐ v̩ ˧ ɳ ɯ ˧  
ɖʐv̩˧ɻæ˩	ɖʐ v̩ ˧ ɻ æ ˩  
ɖʐv̩˧ʈʂʰɯ˧	ɖʐ v̩ ˧ ʈʂʰ ɯ ˧  
ɖʐv̩˧ʐv̩˧ɖʐv̩˧mi˧dʑo˩	ɖʐ v̩ ˧ ʐ v̩ ˧ ɖʐ v̩ ˧ m i ˧ dʑ o ˩  
ɖʐwæ˧ɖʐwæ˥	ɖʐ wæ ˧ ɖʐ wæ ˥  
ɖʐæ˧	ɖʐ æ ˧  
ɖʐɤ˧	ɖʐ ɤ ˧  
ɖʐɤ˧hɯ˧ɲi˥tsɯ˩	ɖʐ ɤ ˧ h ɯ ˧ ɲ i ˥ ts ɯ ˩  
ɖʐɤ˧˥	ɖʐ ɤ ˧˥  
ɖʐɤ˩bi˩ze˩	ɖʐ ɤ ˩ b i ˩ z e ˩  
ɖʐɤ˩ɖʐɤ˧˥	ɖʐ ɤ ˩ ɖʐ ɤ ˧˥  
ɖʐɯ˥ɖʐɯ˩	ɖʐ ɯ ˥ ɖʐ ɯ ˩  
ɖʐɯ˩kʰɤ˥	ɖʐ ɯ ˩ kʰ ɤ ˥  
ɖʐɯ˩kʰɤ˥qo˩	ɖʐ ɯ ˩ kʰ ɤ ˥ q o ˩  
ə˥bi˩	ə ˥ b i ˩  
ə˧	ə ˧  
ə˧dzɤ˥	ə ˧ dz ɤ ˥  
ə˧dzɤ˧dzɤ˥	ə ˧ dz ɤ ˧ dz ɤ ˥  
ə˧dzɤ˧le˧tsɤ˧kv̩˧˥	ə ˧ dz ɤ ˧ l e ˧ ts ɤ ˧ k v̩ ˧˥  
ə˧dɑ˥ki˩	ə ˧ d ɑ ˥ k i ˩  
ə˧dɑ˧ə˧mi˧ɻæ˧ɳɯ˥	ə ˧ d ɑ ˧ ə ˧ m i ˧ ɻ æ ˧ ɳ ɯ ˥  
ə˧dɑ˧ɻ̍˧ɳɯ˥	ə ˧ d ɑ ˧ ɻ̍ ˧ ɳ ɯ ˥  
ə˧hĩ˥	ə ˧ h ĩ ˥  
ə˧lɑ˧	ə ˧ l ɑ ˧  
ə˧lɑ˧ʁwɤ˧hĩ˧	ə ˧ l ɑ ˧ ʁ wɤ ˧ h ĩ ˧  
ə˧mi˧dʑo˥	ə ˧ m i ˧ dʑ o ˥  
ə˧mi˧gi˧˥	ə ˧ m i ˧ g i ˧˥  
ə˧mi˧ki˧ʈʂʰɯ˧	ə ˧ m i ˧ k i ˧ ʈʂʰ ɯ ˧  
ə˧mi˧mv̩˩	ə ˧ m i ˧ m v̩ ˩  
ə˧mi˧qv̩˧ʈʂæ˧	ə ˧ m i ˧ q v̩ ˧ ʈʂ æ ˧  
ə˧mi˧ɖɯ˩	ə ˧ m i ˧ ɖ ɯ ˩  
ə˧mi˧ɻæ˩bv̩˩	ə ˧ m i ˧ ɻ æ ˩ b v̩ ˩  
ə˧mi˧ʁæ˧ʈv̩˥	ə ˧ m i ˧ ʁ æ ˧ ʈ v̩ ˥  
ə˧mi˧ʈʂʰɯ˧	ə ˧ m i ˧ ʈʂʰ ɯ ˧  
ə˧mmm…	ə ˧ mmm…  
ə˧mv̩˥	ə ˧ m v̩ ˥  
ə˧mv̩˥tɕi˩hĩ˩	ə ˧ m v̩ ˥ tɕ i ˩ h ĩ ˩  
ə˧mv̩˧gi˥zɯ˩ni˩	ə ˧ m v̩ ˧ g i ˥ z ɯ ˩ n i ˩  
ə˧mv̩˧ɳɯ˥	ə ˧ m v̩ ˧ ɳ ɯ ˥  
ə˧mv̩˩dʑo˩	ə ˧ m v̩ ˩ dʑ o ˩  
ə˧mv̩˩go	ə ˧ m v̩ ˩ g o  
ə˧mv̩˩ɳɯ˩dʑo˩	ə ˧ m v̩ ˩ ɳ ɯ ˩ dʑ o ˩  
ə˧mv̩˩ʈʂʰɯ˩	ə ˧ m v̩ ˩ ʈʂʰ ɯ ˩  
ə˧mɑ˧ki˩	ə ˧ m ɑ ˧ k i ˩  
ə˧mɑ˧qɑ˧	ə ˧ m ɑ ˧ q ɑ ˧  
ə˧pʰv̩˧lɑ˧	ə ˧ pʰ v̩ ˧ l ɑ ˧  
ə˧pʰv̩˧ʈæ˧bɤ˧	ə ˧ pʰ v̩ ˧ ʈ æ ˧ b ɤ ˧  
ə˧si˧bv̩˧	ə ˧ s i ˧ b v̩ ˧  
ə˧si˧ɻæ˩	ə ˧ s i ˧ ɻ æ ˩  
ə˧sɯ˩kv̩˩ki˩	ə ˧ s ɯ ˩ k v̩ ˩ k i ˩  
ə˧ti˥dzi˩pi˩	ə ˧ t i ˥ dz i ˩ p i ˩  
ə˧ti˧bɑ˧lɑ˥	ə ˧ t i ˧ b ɑ ˧ l ɑ ˥  
ə˧ti˧dʑɯ˩ki˩	ə ˧ t i ˧ dʑ ɯ ˩ k i ˩  
ə˧tse˧ɲi˥hɯ˩	ə ˧ ts e ˧ ɲ i ˥ h ɯ ˩  
ə˧tse˧ʝi˧	ə ˧ ts e ˧ ʝ i ˧  
ə˧tse˧ʝi˧zo˥	ə ˧ ts e ˧ ʝ i ˧ z o ˥  
ə˧tse˧ʝi˧ɲi˥hɯ˩hɯ˩	ə ˧ ts e ˧ ʝ i ˧ ɲ i ˥ h ɯ ˩ h ɯ ˩  
ə˧tso˧ni˩	ə ˧ ts o ˧ n i ˩  
ə˧tsɯ˧	ə ˧ ts ɯ ˧  
ə˧v̩˧tɕi˥	ə ˧ v̩ ˧ tɕ i ˥  
ə˧v̩˧ɖɯ˧˥	ə ˧ v̩ ˧ ɖ ɯ ˧˥  
ə˧v̩˧ɻæ˥	ə ˧ v̩ ˧ ɻ æ ˥  
ə˧v̩˧ɻ̍˥dʑo˩	ə ˧ v̩ ˧ ɻ̍ ˥ dʑ o ˩  
ə˧v̩˧ʈʂʰɯ˧	ə ˧ v̩ ˧ ʈʂʰ ɯ ˧  
ə˧zɯ	ə ˧ z ɯ  
ə˧zɯ˩mv̩˩lɑ˩	ə ˧ z ɯ ˩ m v̩ ˩ l ɑ ˩  
ə˧zɯ˩ɖɯ	ə ˧ z ɯ ˩ ɖ ɯ  
ə˧ɲi˥lɑ˩	ə ˧ ɲ i ˥ l ɑ ˩  
ə˧ʂɯ˧ɲi˥	ə ˧ ʂ ɯ ˧ ɲ i ˥  
ə˧ʑi˧bv̩˧	ə ˧ ʑ i ˧ b v̩ ˧  
ə˧ʑi˧mmm…no˧	ə ˧ ʑ i ˧ mmm… n o ˧  
ə˧ʑi˧mo˥ɻæ˩	ə ˧ ʑ i ˧ m o ˥ ɻ æ ˩  
ə˧ʑi˧no˧sɯ˧kv̩˥ɳɯ˩	ə ˧ ʑ i ˧ n o ˧ s ɯ ˧ k v̩ ˥ ɳ ɯ ˩  
ə˧ʑi˧zo˧mv̩˥	ə ˧ ʑ i ˧ z o ˧ m v̩ ˥  
ə˧ʑi˧ə˧pʰv̩˧˥	ə ˧ ʑ i ˧ ə ˧ pʰ v̩ ˧˥  
ə˧ʑi˧ɻæ˥	ə ˧ ʑ i ˧ ɻ æ ˥  
ə˧ʝi	ə ˧ ʝ i  
ə˧ʝi˥dʑo˩	ə ˧ ʝ i ˥ dʑ o ˩  
ə˧ʝi˧	ə ˧ ʝ i ˧  
ə˧ʝi˧tsʰi˧ʝi˧bv̩˧ni˧˥	ə ˧ ʝ i ˧ tsʰ i ˧ ʝ i ˧ b v̩ ˧ n i ˧˥  
ə˧ʝi˧tsʰi˧ʝi˧ne˧˥	ə ˧ ʝ i ˧ tsʰ i ˧ ʝ i ˧ n e ˧˥  
ə˧ʝi˧tsʰi˧ʝi˧ni˧˥	ə ˧ ʝ i ˧ tsʰ i ˧ ʝ i ˧ n i ˧˥  
ə˧ʝi˧tsʰi˧ʝi˧se˥	ə ˧ ʝ i ˧ tsʰ i ˧ ʝ i ˧ s e ˥  
ə˧ʝi˧ʂ	ə ˧ ʝ i ˧ ʂ  
ə˧ʝi˧ʂɯ˥ʑi˩	ə ˧ ʝ i ˧ ʂ ɯ ˥ ʑ i ˩  
ə˧ʝi˧ʂɯ˥ʝi˩se˩	ə ˧ ʝ i ˧ ʂ ɯ ˥ ʝ i ˩ s e ˩  
ə˧ʝi˧ʂɯ˥ʝi˩ə˧ʝi˧ʂɯ˥ʝi˩	ə ˧ ʝ i ˧ ʂ ɯ ˥ ʝ i ˩ ə ˧ ʝ i ˧ ʂ ɯ ˥ ʝ i ˩  
ə˩bi˩	ə ˩ b i ˩  
ə˩do˩˥	ə ˩ d o ˩˥  
ə˩dɑ˩	ə ˩ d ɑ ˩  
ə˩dʑo˧	ə ˩ dʑ o ˧  
ə˩gɤ˩	ə ˩ g ɤ ˩  
ə˩hɯ˩	ə ˩ h ɯ ˩  
ə˩kʰɯ˩bv̩˥	ə ˩ kʰ ɯ ˩ b v̩ ˥  
ə˩kʰɯ˩pi˥	ə ˩ kʰ ɯ ˩ p i ˥  
ə˩kʰɯ˩pi˥zo˩	ə ˩ kʰ ɯ ˩ p i ˥ z o ˩  
ə˩kʰɯ˩ʈʂʰɯ˥	ə ˩ kʰ ɯ ˩ ʈʂʰ ɯ ˥  
ə˩ljɤ˩hæ̃˩ʂɯ˥mo˩pi˩	ə ˩ l jɤ ˩ h æ̃ ˩ ʂ ɯ ˥ m o ˩ p i ˩  
ə˩ljɤ˩hæ̃˩ʂɯ˥mo˩pi˩hĩ˩	ə ˩ l jɤ ˩ h æ̃ ˩ ʂ ɯ ˥ m o ˩ p i ˩ h ĩ ˩  
ə˩ljɤ˩hæ̃˩ʂɯ˥mo˩ʈʂʰɯ˩	ə ˩ l jɤ ˩ h æ̃ ˩ ʂ ɯ ˥ m o ˩ ʈʂʰ ɯ ˩  
ə˩ljɤ˩hæ̃˩ʂɯ˥mo˩ʈʂʰɯ˩dʑo˩	ə ˩ l jɤ ˩ h æ̃ ˩ ʂ ɯ ˥ m o ˩ ʈʂʰ ɯ ˩ dʑ o ˩  
ə˩mi˩	ə ˩ m i ˩  
ə˩pʰo˩	ə ˩ pʰ o ˩  
ə˩pʰo˩hĩ˩˥	ə ˩ pʰ o ˩ h ĩ ˩˥  
ə˩pʰo˩˥	ə ˩ pʰ o ˩˥  
ə˩qo˥bi˩kv̩˩tsɯ˩	ə ˩ q o ˥ b i ˩ k v̩ ˩ ts ɯ ˩  
ə˩sɯ˧kv̩˥di˩qo˩	ə ˩ s ɯ ˧ k v̩ ˥ d i ˩ q o ˩  
ɣɯ˧dzo˩	ɣ ɯ ˧ dz o ˩  
ɣɯ˩dzɑ˩qʰwɤ˥	ɣ ɯ ˩ dz ɑ ˩ qʰ wɤ ˥  
ɣɯ˩kɯ˧ʈʂʰɯ˥	ɣ ɯ ˩ k ɯ ˧ ʈʂʰ ɯ ˥  
ɣɯ˩ʈʂʰɯ˥	ɣ ɯ ˩ ʈʂʰ ɯ ˥  
ɬ	ɬ  
ɬi˧di˩lɑ˩	ɬ i ˧ d i ˩ l ɑ ˩  
ɬi˧gv̩˧	ɬ i ˧ g v̩ ˧  
ɬi˧ki˥	ɬ i ˧ k i ˥  
ɬi˧ki˥zo˩	ɬ i ˧ k i ˥ z o ˩  
ɬi˧qo˧ɳɯ˧	ɬ i ˧ q o ˧ ɳ ɯ ˧  
ɬi˧qʰwɤ˧	ɬ i ˧ qʰ wɤ ˧  
ɬi˧ʈv̩˥dʑo˩	ɬ i ˧ ʈ v̩ ˥ dʑ o ˩  
ɬi˩bi˩lɑ˥	ɬ i ˩ b i ˩ l ɑ ˥  
ɬi˩di˩di˩mi˩qo˩	ɬ i ˩ d i ˩ d i ˩ m i ˩ q o ˩  
ɬi˩mi˩˥	ɬ i ˩ m i ˩˥  
ɬi˩qʰwɤ˩˥	ɬ i ˩ qʰ wɤ ˩˥  
ɬi˩ʈɯ˩mæ˥pi˩	ɬ i ˩ ʈ ɯ ˩ m æ ˥ p i ˩  
ɬi˩ʈɯ˩mæ˥tʰv̩˩	ɬ i ˩ ʈ ɯ ˩ m æ ˥ tʰ v̩ ˩  
ɬo	ɬ o  
ɬv̩˧gv̩˧	ɬ v̩ ˧ g v̩ ˧  
ɬɑ˧sɑ˧bv̩˧	ɬ ɑ ˧ s ɑ ˧ b v̩ ˧  
ɭɯ˧ɭɯ˧	ɭ ɯ ˧ ɭ ɯ ˧  
ɲi	ɲ i  
ɲi˥ho˩mæ˩	ɲ i ˥ h o ˩ m æ ˩  
ɲi˥hɯ˩	ɲ i ˥ h ɯ ˩  
ɲi˥kv̩˩mɤ˩ho˩	ɲ i ˥ k v̩ ˩ m ɤ ˩ h o ˩  
ɲi˥kv̩˩ɳɯ˩	ɲ i ˥ k v̩ ˩ ɳ ɯ ˩  
ɲi˥pi˩	ɲ i ˥ p i ˩  
ɲi˥pi˩bi˩bi˩	ɲ i ˥ p i ˩ b i ˩ b i ˩  
ɲi˥pi˩dʑo˩	ɲ i ˥ p i ˩ dʑ o ˩  
ɲi˥wɤ˩	ɲ i ˥ wɤ ˩  
ɲi˥ze˩se˩	ɲ i ˥ z e ˩ s e ˩  
ɲi˧	ɲ i ˧  
ɲi˧bæ˧ʈʰæ˧qo˥	ɲ i ˧ b æ ˧ ʈʰ æ ˧ q o ˥  
ɲi˧dzi˧	ɲ i ˧ dz i ˧  
ɲi˧dzi˩ɲi˩dzi˩	ɲ i ˧ dz i ˩ ɲ i ˩ dz i ˩  
ɲi˧ho˥ze˩	ɲ i ˧ h o ˥ z e ˩  
ɲi˧hɯ˧	ɲ i ˧ h ɯ ˧  
ɲi˧kv̩˧bi˧	ɲ i ˧ k v̩ ˧ b i ˧  
ɲi˧kv̩˧hĩ˧tʰv̩˧	ɲ i ˧ k v̩ ˧ h ĩ ˧ tʰ v̩ ˧  
ɲi˧kv̩˧lɑ˥	ɲ i ˧ k v̩ ˧ l ɑ ˥  
ɲi˧kʰv̩˥	ɲ i ˧ kʰ v̩ ˥  
ɲi˧kʰwɤ˥ɲi˩kʰwɤ˩	ɲ i ˧ kʰ wɤ ˥ ɲ i ˩ kʰ wɤ ˩  
ɲi˧kʰɯ˩	ɲ i ˧ kʰ ɯ ˩  
ɲi˧mi˧kʰɯ˧ʂɯ˧tʰv̩˧	ɲ i ˧ m i ˧ kʰ ɯ ˧ ʂ ɯ ˧ tʰ v̩ ˧  
ɲi˧mi˧qo˧	ɲ i ˧ m i ˧ q o ˧  
ɲi˧mɤ˧tʰɑ˧˥	ɲ i ˧ m ɤ ˧ tʰ ɑ ˧˥  
ɲi˧pɤ˧	ɲ i ˧ p ɤ ˧  
ɲi˧pʰo˧˥	ɲ i ˧ pʰ o ˧˥  
ɲi˧pʰæ˧lɑ˥ɲi˩	ɲ i ˧ pʰ æ ˧ l ɑ ˥ ɲ i ˩  
ɲi˧qʰv̩˧qo˧	ɲ i ˧ qʰ v̩ ˧ q o ˧  
ɲi˧to˧	ɲ i ˧ t o ˧  
ɲi˧to˧bi˩	ɲ i ˧ t o ˧ b i ˩  
ɲi˧tsi˧kv̩˧	ɲ i ˧ ts i ˧ k v̩ ˧  
ɲi˧tsi˧kv̩˧hĩ˧tʰv̩˧	ɲ i ˧ ts i ˧ k v̩ ˧ h ĩ ˧ tʰ v̩ ˧  
ɲi˧tsi˧kv̩˧˥	ɲ i ˧ ts i ˧ k v̩ ˧˥  
ɲi˧tsi˧kʰv̩˧	ɲ i ˧ ts i ˧ kʰ v̩ ˧  
ɲi˧tsi˧kʰv̩˧ɳɯ˥	ɲ i ˧ ts i ˧ kʰ v̩ ˧ ɳ ɯ ˥  
ɲi˧tsi˧ŋwɤ˧ɲi˧	ɲ i ˧ ts i ˧ ŋ wɤ ˧ ɲ i ˧  
ɲi˧tsi˧ʑi˩dʑo˩	ɲ i ˧ ts i ˧ ʑ i ˩ dʑ o ˩  
ɲi˧tsʰi˥ɳɯ˩	ɲ i ˧ tsʰ i ˥ ɳ ɯ ˩  
ɲi˧tʰv̩˩	ɲ i ˧ tʰ v̩ ˩  
ɲi˧ze˧	ɲ i ˧ z e ˧  
ɲi˧ɬi˧	ɲ i ˧ ɬ i ˧  
ɲi˧ɬi˧mi˧qo˧	ɲ i ˧ ɬ i ˧ m i ˧ q o ˧  
ɲi˧ɬi˧mi˧qo˧gɤ˧	ɲ i ˧ ɬ i ˧ m i ˧ q o ˧ g ɤ ˧  
ɲi˧ɭɯ˧ʈʂʰɯ˧	ɲ i ˧ ɭ ɯ ˧ ʈʂʰ ɯ ˧  
ɲi˧ɲi˧dʑo˩	ɲ i ˧ ɲ i ˧ dʑ o ˩  
ɲi˧ɲi˧hĩ˧ʈʂʰɯ˧	ɲ i ˧ ɲ i ˧ h ĩ ˧ ʈʂʰ ɯ ˧  
ɲi˧ɻ̍˥	ɲ i ˧ ɻ̍ ˥  
ɲi˧ʂ	ɲ i ˧ ʂ  
ɲi˧ʑi˩	ɲ i ˧ ʑ i ˩  
ɲi˩bi˧bi˧	ɲ i ˩ b i ˧ b i ˧  
ɲi˩bi˩	ɲ i ˩ b i ˩  
ɲi˩bi˩bi˩	ɲ i ˩ b i ˩ b i ˩  
ɲi˩dʑo˩	ɲ i ˩ dʑ o ˩  
ɲi˩ho˥	ɲ i ˩ h o ˥  
ɲi˩ho˩ze˩	ɲ i ˩ h o ˩ z e ˩  
ɲi˩jɤ˩˥	ɲ i ˩ jɤ ˩˥  
ɲi˩kv̩˥	ɲ i ˩ k v̩ ˥  
ɲi˩kv̩˥ɲi˩	ɲ i ˩ k v̩ ˥ ɲ i ˩  
ɲi˩kv̩˩	ɲ i ˩ k v̩ ˩  
ɲi˩kv̩˩hɯ˩	ɲ i ˩ k v̩ ˩ h ɯ ˩  
ɲi˩mæ˩	ɲ i ˩ m æ ˩  
ɲi˩pi˩hĩ˩tʰv̩˩v̩˩	ɲ i ˩ p i ˩ h ĩ ˩ tʰ v̩ ˩ v̩ ˩  
ɲi˩pi˩ʝi˩	ɲ i ˩ p i ˩ ʝ i ˩  
ɲi˩tsɯ˩zo˩	ɲ i ˩ ts ɯ ˩ z o ˩  
ɲi˩ze˩dʑo˩	ɲ i ˩ z e ˩ dʑ o ˩  
ɲi˩ze˩ho˩	ɲ i ˩ z e ˩ h o ˩  
ɲi˩ze˩tsɯ˩	ɲ i ˩ z e ˩ ts ɯ ˩  
ɲi˩ze˩wɤ˩	ɲ i ˩ z e ˩ wɤ ˩  
ɲi˩ə˩di˩pʰæ˩di˩ze˩	ɲ i ˩ ə ˩ d i ˩ pʰ æ ˩ d i ˩ z e ˩  
ɲi˩ə˩di˩wɤ˩	ɲ i ˩ ə ˩ d i ˩ wɤ ˩  
ɲi˩ɲi˩	ɲ i ˩ ɲ i ˩  
ɲi˩ɲi˩tsɯ˩	ɲ i ˩ ɲ i ˩ ts ɯ ˩  
ɲi˩ɳɯ˥	ɲ i ˩ ɳ ɯ ˥  
ɲi˩ɻ̍˥	ɲ i ˩ ɻ̍ ˥  
ɲi˩ɻ̍˥ɳɯ˩	ɲ i ˩ ɻ̍ ˥ ɳ ɯ ˩  
ɳ	ɳ  
ɳv̩˧pʰæ˧di˥tsɯ˩	ɳ v̩ ˧ pʰ æ ˧ d i ˥ ts ɯ ˩  
ɳæ˧	ɳ æ ˧  
ɳæ˧mɤ˥kv̩˩	ɳ æ ˧ m ɤ ˥ k v̩ ˩  
ɳæ˧po˧ɳɯ˧	ɳ æ ˧ p o ˧ ɳ ɯ ˧  
ɳæ˧ɻæ˥dʑo˩	ɳ æ ˧ ɻ æ ˥ dʑ o ˩  
ɳæ˧ɻ̩˩se˩	ɳ æ ˧ ɻ̩ ˩ s e ˩  
ɳæ˩hĩ˩	ɳ æ ˩ h ĩ ˩  
ɳæ˩kv̩˩ze˩	ɳ æ ˩ k v̩ ˩ z e ˩  
ɳɯ˧go˧˥	ɳ ɯ ˧ g o ˧˥  
ɻwæ˩	ɻ wæ ˩  
ɻ̍˧lo˩	ɻ̍ ˧ l o ˩  
ɻ̍˧ɻ̃˧	ɻ̍ ˧ ɻ̃ ˧  
ɻ̍˩ɻ̍˧lo˩	ɻ̍ ˩ ɻ̍ ˧ l o ˩  
ɻ̍˩ɻ̍˧lo˩di˩kʰɯ˩	ɻ̍ ˩ ɻ̍ ˧ l o ˩ d i ˩ kʰ ɯ ˩  
ɻ̍˩ɻ̍˧lo˩pi˩kv̩˩mæ˩	ɻ̍ ˩ ɻ̍ ˧ l o ˩ p i ˩ k v̩ ˩ m æ ˩  
ʁo	ʁ o  
ʁo˧	ʁ o ˧  
ʁo˧hṽ˧qo˥ʈʂʰɯ˩	ʁ o ˧ h ṽ ˧ q o ˥ ʈʂʰ ɯ ˩  
ʁo˧pv̩˩	ʁ o ˧ p v̩ ˩  
ʁo˧ʐv̩˩	ʁ o ˧ ʐ v̩ ˩  
ʁo˩ʁo˥	ʁ o ˩ ʁ o ˥  
ʁo˩˥	ʁ o ˩˥  
ʁwæ˧lo˥	ʁ wæ ˧ l o ˥  
ʁwɤ˧qo˧dʑo˥	ʁ wɤ ˧ q o ˧ dʑ o ˥  
ʁwɤ˧qo˧dʑo˧	ʁ wɤ ˧ q o ˧ dʑ o ˧  
ʁwɤ˧qo˧hĩ˧	ʁ wɤ ˧ q o ˧ h ĩ ˧  
ʁwɤ˧qo˧pʰæ˧tɕi˥tʰv̩˩	ʁ wɤ ˧ q o ˧ pʰ æ ˧ tɕ i ˥ tʰ v̩ ˩  
ʁwɤ˧qo˧ɳɯ˧	ʁ wɤ ˧ q o ˧ ɳ ɯ ˧  
ʁwɤ˧qo˧ʈʂʰɯ˧	ʁ wɤ ˧ q o ˧ ʈʂʰ ɯ ˧  
ʁwɤ˧ʈʂʰɯ˧	ʁ wɤ ˧ ʈʂʰ ɯ ˧  
ʁwɤ˧ʐv̩˧lo˩mæ˩	ʁ wɤ ˧ ʐ v̩ ˧ l o ˩ m æ ˩  
ʁæ˧bi˧	ʁ æ ˧ b i ˧  
ʁæ˧bæ˧ʈʂʰɯ˧	ʁ æ ˧ b æ ˧ ʈʂʰ ɯ ˧  
ʁæ˧mɤ˧kv̩˧˥	ʁ æ ˧ m ɤ ˧ k v̩ ˧˥  
ʁæ˧ɻ̍˥	ʁ æ ˧ ɻ̍ ˥  
ʁæ˧ʈv̩˥	ʁ æ ˧ ʈ v̩ ˥  
ʁæ˧ʈv̩˥pi˩	ʁ æ ˧ ʈ v̩ ˥ p i ˩  
ʁɑ˧dʑo˥	ʁ ɑ ˧ dʑ o ˥  
ʁɑ˧kwɤ˧tɕɯ˥lɑ˩	ʁ ɑ ˧ k wɤ ˧ tɕ ɯ ˥ l ɑ ˩  
ʁɑ˧ze˧	ʁ ɑ ˧ z e ˧  
ʁɑ˧z˧	ʁ ɑ ˧ z ˧  
ʁɑ˧ʂ	ʁ ɑ ˧ ʂ  
ʁɑ˧ʂe˥ɲi˩	ʁ ɑ ˧ ʂ e ˥ ɲ i ˩  
ʁɑ˧ʂe˩bi˩	ʁ ɑ ˧ ʂ e ˩ b i ˩  
ʁɑ˧ʂe˩hɯ˩tsɯ˩	ʁ ɑ ˧ ʂ e ˩ h ɯ ˩ ts ɯ ˩  
ʁɑ˧ʂe˩kv̩˩tsɯ˩	ʁ ɑ ˧ ʂ e ˩ k v̩ ˩ ts ɯ ˩  
ʁɑ˧ʂe˩kv̩˩ze˩	ʁ ɑ ˧ ʂ e ˩ k v̩ ˩ z e ˩  
ʁɑ˧ʂe˩se˩kwɤ˩tɕɯ˩lɑ˩	ʁ ɑ ˧ ʂ e ˩ s e ˩ k wɤ ˩ tɕ ɯ ˩ l ɑ ˩  
ʁɑ˧ʂe˩tso˩ɲi˩	ʁ ɑ ˧ ʂ e ˩ ts o ˩ ɲ i ˩  
ʁɑ˧ʂe˩zo˩	ʁ ɑ ˧ ʂ e ˩ z o ˩  
ʁɑ˩	ʁ ɑ ˩  
ʁɑ˩mi˧ze˩	ʁ ɑ ˩ m i ˧ z e ˩  
ʁɑ˩pi˩	ʁ ɑ ˩ p i ˩  
ʁɑ˩ʂe˥	ʁ ɑ ˩ ʂ e ˥  
ʁɑ˩ʂe˩se˩kwɤ˩tɕɯ˩lɑ˩	ʁ ɑ ˩ ʂ e ˩ s e ˩ k wɤ ˩ tɕ ɯ ˩ l ɑ ˩  
ʂe˥	ʂ e ˥  
ʂe˧bi˧pi˧dʑo˩	ʂ e ˧ b i ˧ p i ˧ dʑ o ˩  
ʂe˧bi˧zo˧	ʂ e ˧ b i ˧ z o ˧  
ʂe˧hɯ˧dʑo˧	ʂ e ˧ h ɯ ˧ dʑ o ˧  
ʂe˧kv̩˧˥	ʂ e ˧ k v̩ ˧˥  
ʂe˧mɤ˧ʈʂʰɯ˥	ʂ e ˧ m ɤ ˧ ʈʂʰ ɯ ˥  
ʂe˧sɯ˩	ʂ e ˧ s ɯ ˩  
ʂe˧ʂe˧	ʂ e ˧ ʂ e ˧  
ʂe˧ʈʂe˩lɑ˩	ʂ e ˧ ʈʂ e ˩ l ɑ ˩  
ʂe˧ʈʂe˩ʈʂʰɯ˩	ʂ e ˧ ʈʂ e ˩ ʈʂʰ ɯ ˩  
ʂe˧ʈʂe˩ʈʰæ˩qʰwɤ˩	ʂ e ˧ ʈʂ e ˩ ʈʰ æ ˩ qʰ wɤ ˩  
ʂe˩mo˧pi˥	ʂ e ˩ m o ˧ p i ˥  
ʂe˩zo˩kv̩˩mæ˩	ʂ e ˩ z o ˩ k v̩ ˩ m æ ˩  
ʂe˩ʂe˩gv̩˩bi˩	ʂ e ˩ ʂ e ˩ g v̩ ˩ b i ˩  
ʂo˧kv̩˥	ʂ o ˧ k v̩ ˥  
ʂo˧qo˧tʰɑ˩	ʂ o ˧ q o ˧ tʰ ɑ ˩  
ʂo˩qæ˩ɻæ˥	ʂ o ˩ q æ ˩ ɻ æ ˥  
ʂo˩ʂo˥	ʂ o ˩ ʂ o ˥  
ʂo˩˥	ʂ o ˩˥  
ʂv̩˧	ʂ v̩ ˧  
ʂv̩˧di˧˥	ʂ v̩ ˧ d i ˧˥  
ʂv̩˧ɖv̩˧ze˩tsɯ˩	ʂ v̩ ˧ ɖ v̩ ˧ z e ˩ ts ɯ ˩  
ʂv̩˧ʂv̩˧kv̩˧ze˥mæ˩	ʂ v̩ ˧ ʂ v̩ ˧ k v̩ ˧ z e ˥ m æ ˩  
ʂv̩˩ɖv̩˩	ʂ v̩ ˩ ɖ v̩ ˩  
ʂwæ˧bæ˩	ʂ wæ ˧ b æ ˩  
ʂwæ˧gv̩˧bi˥	ʂ wæ ˧ g v̩ ˧ b i ˥  
ʂwæ˧gv̩˧ʁo˧	ʂ wæ ˧ g v̩ ˧ ʁ o ˧  
ʂwæ˧hĩ˧qo˩dʑo˩	ʂ wæ ˧ h ĩ ˧ q o ˩ dʑ o ˩  
ʂwæ˧hĩ˧qo˩ɳɯ˩	ʂ wæ ˧ h ĩ ˧ q o ˩ ɳ ɯ ˩  
ʂwæ˧zo˧	ʂ wæ ˧ z o ˧  
ʂwæ˧ʂwæ˧hĩ˧qo˧	ʂ wæ ˧ ʂ wæ ˧ h ĩ ˧ q o ˧  
ʂwæ˩gv̩˩ki˥	ʂ wæ ˩ g v̩ ˩ k i ˥  
ʂwæ˩gv̩˩ki˥ɳɯ˩	ʂ wæ ˩ g v̩ ˩ k i ˥ ɳ ɯ ˩  
ʂwɤ˧ljɤ˧kwɤ˩	ʂ wɤ ˧ l jɤ ˧ k wɤ ˩  
ʂæ˥ʂæ˩	ʂ æ ˥ ʂ æ ˩  
ʂæ˧dʑo˧	ʂ æ ˧ dʑ o ˧  
ʂæ˧tsɯ˧	ʂ æ ˧ ts ɯ ˧  
ʂæ˧tsɯ˧˥	ʂ æ ˧ ts ɯ ˧˥  
ʂæ˧ɕi˧ɲi˥ze˩	ʂ æ ˧ ɕ i ˧ ɲ i ˥ z e ˩  
ʂæ˧ɲi˥pi˩	ʂ æ ˧ ɲ i ˥ p i ˩  
ʂæ˧ʂæ˩	ʂ æ ˧ ʂ æ ˩  
ʂæ˩	ʂ æ ˩  
ʂæ˩ɻ̃˩	ʂ æ ˩ ɻ̃ ˩  
ʂæ˩ɻ̃˩lɑ˥	ʂ æ ˩ ɻ̃ ˩ l ɑ ˥  
ʂæ˩ɻ̩̃˩v̩˥dʑɯ˩	ʂ æ ˩ ɻ̩̃ ˩ v̩ ˥ dʑ ɯ ˩  
ʂæ˩ɻ̩̃˩˥	ʂ æ ˩ ɻ̩̃ ˩˥  
ʂɑ˩tʰɑ˧dze˧pi˧zo˥	ʂ ɑ ˩ tʰ ɑ ˧ dz e ˧ p i ˧ z o ˥  
ʂɑ˩tʰɑ˧dze˧ʈʂʰɯ˧	ʂ ɑ ˩ tʰ ɑ ˧ dz e ˧ ʈʂʰ ɯ ˧  
ʂɯ˥pi˩dʑo˩	ʂ ɯ ˥ p i ˩ dʑ o ˩  
ʂɯ˧bi˧bi˧	ʂ ɯ ˧ b i ˧ b i ˧  
ʂɯ˧bi˧dʑo˧	ʂ ɯ ˧ b i ˧ dʑ o ˧  
ʂɯ˧dʑo˧	ʂ ɯ ˧ dʑ o ˧  
ʂɯ˧dʑɯ˧	ʂ ɯ ˧ dʑ ɯ ˧  
ʂɯ˧hĩ˧tʰv̩˧	ʂ ɯ ˧ h ĩ ˧ tʰ v̩ ˧  
ʂɯ˧hĩ˧ʈʂʰɯ˧	ʂ ɯ ˧ h ĩ ˧ ʈʂʰ ɯ ˧  
ʂɯ˧ho˥ɲi˩	ʂ ɯ ˧ h o ˥ ɲ i ˩  
ʂɯ˧hõ˧ɲi˧	ʂ ɯ ˧ h õ ˧ ɲ i ˧  
ʂɯ˧hɑ̃˧	ʂ ɯ ˧ h ɑ̃ ˧  
ʂɯ˧kv̩˧˥	ʂ ɯ ˧ k v̩ ˧˥  
ʂɯ˧kwɤ˧tɕɯ˥lɑ˩	ʂ ɯ ˧ k wɤ ˧ tɕ ɯ ˥ l ɑ ˩  
ʂɯ˧kʰɯ˧zo˧kv̩˩mæ˩	ʂ ɯ ˧ kʰ ɯ ˧ z o ˧ k v̩ ˩ m æ ˩  
ʂɯ˧mɤ˧kv̩˧	ʂ ɯ ˧ m ɤ ˧ k v̩ ˧  
ʂɯ˧mɤ˧kv̩˩	ʂ ɯ ˧ m ɤ ˧ k v̩ ˩  
ʂɯ˧pi˩	ʂ ɯ ˧ p i ˩  
ʂɯ˧tsʰi˩	ʂ ɯ ˧ tsʰ i ˩  
ʂɯ˧ze˧pi˧	ʂ ɯ ˧ z e ˧ p i ˧  
ʂɯ˧ze˩	ʂ ɯ ˧ z e ˩  
ʂɯ˧ɬi˧mi˧qo˧gɤ˧dʑo˥	ʂ ɯ ˧ ɬ i ˧ m i ˧ q o ˧ g ɤ ˧ dʑ o ˥  
ʂɯ˧ɲi˥dʑo˩	ʂ ɯ ˧ ɲ i ˥ dʑ o ˩  
ʂɯ˧ɲi˥tsɯ˩	ʂ ɯ ˧ ɲ i ˥ ts ɯ ˩  
ʂɯ˧ɳɯ˧	ʂ ɯ ˧ ɳ ɯ ˧  
ʂɯ˧ʁo˧to˩dʑo˩	ʂ ɯ ˧ ʁ o ˧ t o ˩ dʑ o ˩  
ʂɯ˧ʂɯ˧ʂɯ˧ʂɯ˧	ʂ ɯ ˧ ʂ ɯ ˧ ʂ ɯ ˧ ʂ ɯ ˧  
ʂɯ˧ʈʂʰɯ˧dʑo˩	ʂ ɯ ˧ ʈʂʰ ɯ ˧ dʑ o ˩  
ʂɯ˩hṽ	ʂ ɯ ˩ h ṽ  
ʂɯ˩kʰɯ˩	ʂ ɯ ˩ kʰ ɯ ˩  
ʂɯ˩qo˥ɻæ˩zo˩	ʂ ɯ ˩ q o ˥ ɻ æ ˩ z o ˩  
ʂɯ˩ze˥mæ˩	ʂ ɯ ˩ z e ˥ m æ ˩  
ʈv̩˩bi˩ze˩	ʈ v̩ ˩ b i ˩ z e ˩  
ʈwɤ˧kwɤ˧tɕɯ˥lɑ˩	ʈ wɤ ˧ k wɤ ˧ tɕ ɯ ˥ l ɑ ˩  
ʈæ	ʈ æ  
ʈæ˧	ʈ æ ˧  
ʈæ˧bɤ˧ki˧	ʈ æ ˧ b ɤ ˧ k i ˧  
ʈæ˧ʂɯ˧	ʈ æ ˧ ʂ ɯ ˧  
ʈæ˧ʂɯ˧go˧mi˧ʈʂʰɯ˧	ʈ æ ˧ ʂ ɯ ˧ g o ˧ m i ˧ ʈʂʰ ɯ ˧  
ʈæ˧ʂɯ˧pæ˩pʰæ˩	ʈ æ ˧ ʂ ɯ ˧ p æ ˩ pʰ æ ˩  
ʈæ˧ʂɯ˧ɬɑ˩mv̩˩ɳɯ˩	ʈ æ ˧ ʂ ɯ ˧ ɬ ɑ ˩ m v̩ ˩ ɳ ɯ ˩  
ʈæ˧ʂɯ˧ʈʂʰɯ˧	ʈ æ ˧ ʂ ɯ ˧ ʈʂʰ ɯ ˧  
ʈɤ˧bi˧	ʈ ɤ ˧ b i ˧  
ʈɤ˧tso˧ɲi˥	ʈ ɤ ˧ ts o ˧ ɲ i ˥  
ʈɤ˧tʰɑ˧kv̩˥ze˩	ʈ ɤ ˧ tʰ ɑ ˧ k v̩ ˥ z e ˩  
ʈɤ˧ɲi˥tsɯ˩	ʈ ɤ ˧ ɲ i ˥ ts ɯ ˩  
ʈʂe˧lɑ˩	ʈʂ e ˧ l ɑ ˩  
ʈʂe˧ʈv̩˥	ʈʂ e ˧ ʈ v̩ ˥  
ʈʂe˧ʈʂʰɯ˧	ʈʂ e ˧ ʈʂʰ ɯ ˧  
ʈʂo˧hĩ˧	ʈʂ o ˧ h ĩ ˧  
ʈʂo˧kʰɯ˩	ʈʂ o ˧ kʰ ɯ ˩  
ʈʂo˧pi˩zo˩kv̩˩pi˩zo˩	ʈʂ o ˧ p i ˩ z o ˩ k v̩ ˩ p i ˩ z o ˩  
ʈʂo˧ɭɯ˧	ʈʂ o ˧ ɭ ɯ ˧  
ʈʂo˧ɭɯ˧qo˩	ʈʂ o ˧ ɭ ɯ ˧ q o ˩  
ʈʂo˧ʂɯ˧hĩ˧	ʈʂ o ˧ ʂ ɯ ˧ h ĩ ˧  
ʈʂo˩bo˧	ʈʂ o ˩ b o ˧  
ʈʂo˩bo˩ʈʂʰɯ˥	ʈʂ o ˩ b o ˩ ʈʂʰ ɯ ˥  
ʈʂo˩bo˩˥	ʈʂ o ˩ b o ˩˥  
ʈʂo˩ɲi˥mæ˩	ʈʂ o ˩ ɲ i ˥ m æ ˩  
ʈʂv̩˥	ʈʂ v̩ ˥  
ʈʂv̩˥pi˩	ʈʂ v̩ ˥ p i ˩  
ʈʂv̩˥tsʰɯ˩dʑo˩	ʈʂ v̩ ˥ tsʰ ɯ ˩ dʑ o ˩  
ʈʂv̩˥tsʰɯ˩ze˩	ʈʂ v̩ ˥ tsʰ ɯ ˩ z e ˩  
ʈʂv̩˧ʝɤ˩	ʈʂ v̩ ˧ ʝ ɤ ˩  
ʈʂwæ˧ʈʂwæ˧ɻ˥	ʈʂ wæ ˧ ʈʂ wæ ˧ ɻ ˥  
ʈʂwæ˧˥	ʈʂ wæ ˧˥  
ʈʂwæ˩	ʈʂ wæ ˩  
ʈʂwɑ˧ʈʂwɑ˧lɑ˧lɑ˧hĩ˥	ʈʂ wɑ ˧ ʈʂ wɑ ˧ l ɑ ˧ l ɑ ˧ h ĩ ˥  
ʈʂæ˥	ʈʂ æ ˥  
ʈʂæ˧mo˧kʰi˧tɕʰɯ˩mo˩	ʈʂ æ ˧ m o ˧ kʰ i ˧ tɕʰ ɯ ˩ m o ˩  
ʈʂæ˧ʈʂɯ˧	ʈʂ æ ˧ ʈʂ ɯ ˧  
ʈʂæ˧ʈʂɯ˧dʑo˥	ʈʂ æ ˧ ʈʂ ɯ ˧ dʑ o ˥  
ʈʂæ˧˥pʰo˩	ʈʂ æ ˧˥ pʰ o ˩  
ʈʂæ˩tʰɑ˩hõ˩	ʈʂ æ ˩ tʰ ɑ ˩ h õ ˩  
ʈʂæ˩ɲi˩tsɯ˩	ʈʂ æ ˩ ɲ i ˩ ts ɯ ˩  
ʈʂɤ˧bi˧dʑo˥	ʈʂ ɤ ˧ b i ˧ dʑ o ˥  
ʈʂɤ˧bi˧kv̩˧ze˥	ʈʂ ɤ ˧ b i ˧ k v̩ ˧ z e ˥  
ʈʂɤ˩ɲi˩tsɯ˩	ʈʂ ɤ ˩ ɲ i ˩ ts ɯ ˩  
ʈʂʰo˥	ʈʂʰ o ˥  
ʈʂʰo˥ɲi˩mæ˩	ʈʂʰ o ˥ ɲ i ˩ m æ ˩  
ʈʂʰo˧bi˧	ʈʂʰ o ˧ b i ˧  
ʈʂʰo˧bɤ˧	ʈʂʰ o ˧ b ɤ ˧  
ʈʂʰo˧kv̩˥	ʈʂʰ o ˧ k v̩ ˥  
ʈʂʰo˧kv̩˧ze˥mæ˩	ʈʂʰ o ˧ k v̩ ˧ z e ˥ m æ ˩  
ʈʂʰo˧lɑ˧	ʈʂʰ o ˧ l ɑ ˧  
ʈʂʰo˧lɑ˧kv̩˥	ʈʂʰ o ˧ l ɑ ˧ k v̩ ˥  
ʈʂʰo˩kv̩˥	ʈʂʰ o ˩ k v̩ ˥  
ʈʂʰo˩pi˩	ʈʂʰ o ˩ p i ˩  
ʈʂʰwæ˧kv̩˥pʰæ˩di˩	ʈʂʰ wæ ˧ k v̩ ˥ pʰ æ ˩ d i ˩  
ʈʂʰwæ˧zo˥	ʈʂʰ wæ ˧ z o ˥  
ʈʂʰwæ˧˥	ʈʂʰ wæ ˧˥  
ʈʂʰwæ˩kv̩˩	ʈʂʰ wæ ˩ k v̩ ˩  
ʈʂʰwæ˩ni˩˥	ʈʂʰ wæ ˩ n i ˩˥  
ʈʂʰwæ˩tsʰɯ˩ɲi˥tsɯ˩	ʈʂʰ wæ ˩ tsʰ ɯ ˩ ɲ i ˥ ts ɯ ˩  
ʈʂʰwæ˩ɲi˥tsɯ˩	ʈʂʰ wæ ˩ ɲ i ˥ ts ɯ ˩  
ʈʂʰwæ˩ʈʂʰɯ˥	ʈʂʰ wæ ˩ ʈʂʰ ɯ ˥  
ʈʂʰæ˧	ʈʂʰ æ ˧  
ʈʂʰæ˧pv̩˩to˧	ʈʂʰ æ ˧ p v̩ ˩ t o ˧  
ʈʂʰæ˧ɣɯ˧ki˩hĩ˩	ʈʂʰ æ ˧ ɣ ɯ ˧ k i ˩ h ĩ ˩  
ʈʂʰæ˧ɣɯ˧ʈʂʰɯ˧	ʈʂʰ æ ˧ ɣ ɯ ˧ ʈʂʰ ɯ ˧  
ʈʂʰæ˧ʈʂʰæ˧kv̩˩	ʈʂʰ æ ˧ ʈʂʰ æ ˧ k v̩ ˩  
ʈʂʰæ˧ʈʂʰæ˧kv̩˩mæ˩	ʈʂʰ æ ˧ ʈʂʰ æ ˧ k v̩ ˩ m æ ˩  
ʈʂʰæ˧ʈʂʰɯ˥	ʈʂʰ æ ˧ ʈʂʰ ɯ ˥  
ʈʂʰæ˧˥	ʈʂʰ æ ˧˥  
ʈʂʰæ˩ʈʂʰæ˩qo˥	ʈʂʰ æ ˩ ʈʂʰ æ ˩ q o ˥  
ʈʂʰɤ˧tsɯ˧	ʈʂʰ ɤ ˧ ts ɯ ˧  
ʈʂʰɤ˧tsɯ˧lɑ˧	ʈʂʰ ɤ ˧ ts ɯ ˧ l ɑ ˧  
ʈʂʰɤ˧tsɯ˧po˧ɳɯ˧	ʈʂʰ ɤ ˧ ts ɯ ˧ p o ˧ ɳ ɯ ˧  
ʈʂʰɯ	ʈʂʰ ɯ  
ʈʂʰɯ˥	ʈʂʰ ɯ ˥  
ʈʂʰɯ˥tɕi˩ki˩	ʈʂʰ ɯ ˥ tɕ i ˩ k i ˩  
ʈʂʰɯ˧bv̩˧mi˧	ʈʂʰ ɯ ˧ b v̩ ˧ m i ˧  
ʈʂʰɯ˧bv̩˩	ʈʂʰ ɯ ˧ b v̩ ˩  
ʈʂʰɯ˧gɤ˧li˧	ʈʂʰ ɯ ˧ g ɤ ˧ l i ˧  
ʈʂʰɯ˧hĩ˧	ʈʂʰ ɯ ˧ h ĩ ˧  
ʈʂʰɯ˧hwɤ˧hĩ˧	ʈʂʰ ɯ ˧ h wɤ ˧ h ĩ ˧  
ʈʂʰɯ˧hwɤ˧hwɤ˧	ʈʂʰ ɯ ˧ h wɤ ˧ h wɤ ˧  
ʈʂʰɯ˧hwɤ˧hwɤ˧hĩ˧	ʈʂʰ ɯ ˧ h wɤ ˧ h wɤ ˧ h ĩ ˧  
ʈʂʰɯ˧hwɤ˧hwɤ˧lɑ˩	ʈʂʰ ɯ ˧ h wɤ ˧ h wɤ ˧ l ɑ ˩  
ʈʂʰɯ˧jɤ˩dʑo˩	ʈʂʰ ɯ ˧ jɤ ˩ dʑ o ˩  
ʈʂʰɯ˧ki˧	ʈʂʰ ɯ ˧ k i ˧  
ʈʂʰɯ˧ki˧ki˩	ʈʂʰ ɯ ˧ k i ˧ k i ˩  
ʈʂʰɯ˧kʰv̩˥mi˩	ʈʂʰ ɯ ˧ kʰ v̩ ˥ m i ˩  
ʈʂʰɯ˧kʰwɤ˥	ʈʂʰ ɯ ˧ kʰ wɤ ˥  
ʈʂʰɯ˧kʰwɤ˥dʑo˩	ʈʂʰ ɯ ˧ kʰ wɤ ˥ dʑ o ˩  
ʈʂʰɯ˧kʰwɤ˥lɑ˩	ʈʂʰ ɯ ˧ kʰ wɤ ˥ l ɑ ˩  
ʈʂʰɯ˧kʰwɤ˧bi˥	ʈʂʰ ɯ ˧ kʰ wɤ ˧ b i ˥  
ʈʂʰɯ˧ne˧ʝi˥kwɤ˩tɕɯ˩lɑ˩	ʈʂʰ ɯ ˧ n e ˧ ʝ i ˥ k wɤ ˩ tɕ ɯ ˩ l ɑ ˩  
ʈʂʰɯ˧ne˧ʝi˥se˩dʑo˩	ʈʂʰ ɯ ˧ n e ˧ ʝ i ˥ s e ˩ dʑ o ˩  
ʈʂʰɯ˧ne˧ʝi˥zo˩	ʈʂʰ ɯ ˧ n e ˧ ʝ i ˥ z o ˩  
ʈʂʰɯ˧ne˧˥	ʈʂʰ ɯ ˧ n e ˧˥  
ʈʂʰɯ˧ni˧˥	ʈʂʰ ɯ ˧ n i ˧˥  
ʈʂʰɯ˧po˧	ʈʂʰ ɯ ˧ p o ˧  
ʈʂʰɯ˧pɤ˥	ʈʂʰ ɯ ˧ p ɤ ˥  
ʈʂʰɯ˧pʰo˥bi˩	ʈʂʰ ɯ ˧ pʰ o ˥ b i ˩  
ʈʂʰɯ˧pʰo˩bi˩	ʈʂʰ ɯ ˧ pʰ o ˩ b i ˩  
ʈʂʰɯ˧qo˧pi˧	ʈʂʰ ɯ ˧ q o ˧ p i ˧  
ʈʂʰɯ˧qɑ˧	ʈʂʰ ɯ ˧ q ɑ ˧  
ʈʂʰɯ˧qʰwɤ˩	ʈʂʰ ɯ ˧ qʰ wɤ ˩  
ʈʂʰɯ˧qʰwɤ˩dʑo˩	ʈʂʰ ɯ ˧ qʰ wɤ ˩ dʑ o ˩  
ʈʂʰɯ˧qʰɑ˧ʂæ˧ʂæ˧hĩ˧	ʈʂʰ ɯ ˧ qʰ ɑ ˧ ʂ æ ˧ ʂ æ ˧ h ĩ ˧  
ʈʂʰɯ˧si˥	ʈʂʰ ɯ ˧ s i ˥  
ʈʂʰɯ˧so˧bæ˥dʑo˩	ʈʂʰ ɯ ˧ s o ˧ b æ ˥ dʑ o ˩  
ʈʂʰɯ˧so˧bæ˧lɑ˧	ʈʂʰ ɯ ˧ s o ˧ b æ ˧ l ɑ ˧  
ʈʂʰɯ˧sɯ˩kv̩˩bv̩˩	ʈʂʰ ɯ ˧ s ɯ ˩ k v̩ ˩ b v̩ ˩  
ʈʂʰɯ˧sɯ˩kv̩˩dʑo˩	ʈʂʰ ɯ ˧ s ɯ ˩ k v̩ ˩ dʑ o ˩  
ʈʂʰɯ˧tɕi˥ɳɯ˩	ʈʂʰ ɯ ˧ tɕ i ˥ ɳ ɯ ˩  
ʈʂʰɯ˧tɕi˩bi˩	ʈʂʰ ɯ ˧ tɕ i ˩ b i ˩  
ʈʂʰɯ˧tɕi˩dʑo˩	ʈʂʰ ɯ ˧ tɕ i ˩ dʑ o ˩  
ʈʂʰɯ˧tɕo˧	ʈʂʰ ɯ ˧ tɕ o ˧  
ʈʂʰɯ˧v̩˧bi˥	ʈʂʰ ɯ ˧ v̩ ˧ b i ˥  
ʈʂʰɯ˧v̩˧lɑ˩	ʈʂʰ ɯ ˧ v̩ ˧ l ɑ ˩  
ʈʂʰɯ˧ɖɯ˧mi˧	ʈʂʰ ɯ ˧ ɖ ɯ ˧ m i ˧  
ʈʂʰɯ˧ɖɯ˧mi˧hĩ˧	ʈʂʰ ɯ ˧ ɖ ɯ ˧ m i ˧ h ĩ ˧  
ʈʂʰɯ˧ɖɯ˧ɖɯ˧gv̩˧hĩ˧ʈʂʰɯ˧	ʈʂʰ ɯ ˧ ɖ ɯ ˧ ɖ ɯ ˧ g v̩ ˧ h ĩ ˧ ʈʂʰ ɯ ˧  
ʈʂʰɯ˧ɖʐɯ˧ɖʐɯ˥	ʈʂʰ ɯ ˧ ɖʐ ɯ ˧ ɖʐ ɯ ˥  
ʈʂʰɯ˧ɭɯ˧dʑo˩	ʈʂʰ ɯ ˧ ɭ ɯ ˧ dʑ o ˩  
ʈʂʰɯ˧ɭɯ˧ɳɯ˧	ʈʂʰ ɯ ˧ ɭ ɯ ˧ ɳ ɯ ˧  
ʈʂʰɯ˧ɲi˥vkv̩˩qo˩	ʈʂʰ ɯ ˧ ɲ i ˥ v k v̩ ˩ q o ˩  
ʈʂʰɯ˧ɲi˥ʑi˩ɳɯ˩	ʈʂʰ ɯ ˧ ɲ i ˥ ʑ i ˩ ɳ ɯ ˩  
ʈʂʰɯ˧ɲi˧dʑo˩	ʈʂʰ ɯ ˧ ɲ i ˧ dʑ o ˩  
ʈʂʰɯ˧ɲi˧ʑi˩dʑo˩	ʈʂʰ ɯ ˧ ɲ i ˧ ʑ i ˩ dʑ o ˩  
ʈʂʰɯ˧ɳɯ˧dʑo˥	ʈʂʰ ɯ ˧ ɳ ɯ ˧ dʑ o ˥  
ʈʂʰɯ˧ɳɯ˩	ʈʂʰ ɯ ˧ ɳ ɯ ˩  
ʈʂʰɯ˧ɳɯ˩dʑo˩	ʈʂʰ ɯ ˧ ɳ ɯ ˩ dʑ o ˩  
ʈʂʰɯ˧ɻæ˥dʑo˩	ʈʂʰ ɯ ˧ ɻ æ ˥ dʑ o ˩  
ʈʂʰɯ˧ɻæ˧	ʈʂʰ ɯ ˧ ɻ æ ˧  
ʈʂʰɯ˧ɻæ˧pi˥	ʈʂʰ ɯ ˧ ɻ æ ˧ p i ˥  
ʈʂʰɯ˧ɻæ˧se˥	ʈʂʰ ɯ ˧ ɻ æ ˧ s e ˥  
ʈʂʰɯ˧ɻæ˧ɳɯ˥	ʈʂʰ ɯ ˧ ɻ æ ˧ ɳ ɯ ˥  
ʈʂʰɯ˧ɻ˩	ʈʂʰ ɯ ˧ ɻ ˩  
ʈʂʰɯ˧ʁ	ʈʂʰ ɯ ˧ ʁ  
ʈʂʰɯ˧ʁo˥dʑo˩	ʈʂʰ ɯ ˧ ʁ o ˥ dʑ o ˩  
ʈʂʰɯ˧ʁo˥lɑ˩	ʈʂʰ ɯ ˧ ʁ o ˥ l ɑ ˩  
ʈʂʰɯ˧ʁo˥pi˩	ʈʂʰ ɯ ˧ ʁ o ˥ p i ˩  
ʈʂʰɯ˧ʁo˥qo˩	ʈʂʰ ɯ ˧ ʁ o ˥ q o ˩  
ʈʂʰɯ˧ʁo˧dɑ˧	ʈʂʰ ɯ ˧ ʁ o ˧ d ɑ ˧  
ʈʂʰɯ˧ʂ	ʈʂʰ ɯ ˧ ʂ  
ʈʂʰɯ˧ʂwæ˧mi˧hĩ˧	ʈʂʰ ɯ ˧ ʂ wæ ˧ m i ˧ h ĩ ˧  
ʈʂʰɯ˧ʂwæ˧mi˧zo˥	ʈʂʰ ɯ ˧ ʂ wæ ˧ m i ˧ z o ˥  
ʈʂʰɯ˧ʂwæ˧ʂwæ˧gv̩˧kv̩˩	ʈʂʰ ɯ ˧ ʂ wæ ˧ ʂ wæ ˧ g v̩ ˧ k v̩ ˩  
ʈʂʰɯ˧ʂwæ˧ʂwæ˧hĩ˧qo˩	ʈʂʰ ɯ ˧ ʂ wæ ˧ ʂ wæ ˧ h ĩ ˧ q o ˩  
ʈʂʰɯ˧ʂæ˧ʂæ˧gv̩˧ɲi˥mæ˩	ʈʂʰ ɯ ˧ ʂ æ ˧ ʂ æ ˧ g v̩ ˧ ɲ i ˥ m æ ˩  
ʈʂʰɯ˧ʂæ˧ʂæ˧zo˥	ʈʂʰ ɯ ˧ ʂ æ ˧ ʂ æ ˧ z o ˥  
ʈʂʰɯ˧ʂɯ˥dʑo˩	ʈʂʰ ɯ ˧ ʂ ɯ ˥ dʑ o ˩  
ʈʂʰɯ˧ʈʂæ˧qo˩	ʈʂʰ ɯ ˧ ʈʂ æ ˧ q o ˩  
ʈʂʰɯ˧ʈʰɤ˥	ʈʂʰ ɯ ˧ ʈʰ ɤ ˥  
ʈʂʰɯ˧ʑi˧ɻɳɯ˥	ʈʂʰ ɯ ˧ ʑ i ˧ ɻ ɳ ɯ ˥  
ʈʂʰɯ˧ʑi˧˥	ʈʂʰ ɯ ˧ ʑ i ˧˥  
ʈʂʰɯ˩	ʈʂʰ ɯ ˩  
ʈʂʰɯ˩kʰwɤ˩	ʈʂʰ ɯ ˩ kʰ wɤ ˩  
ʈʂʰɯ˩qo˥dʑo˩	ʈʂʰ ɯ ˩ q o ˥ dʑ o ˩  
ʈʂʰɯ˩qo˩	ʈʂʰ ɯ ˩ q o ˩  
ʈʂʰɯ˩qo˩dʑo˩	ʈʂʰ ɯ ˩ q o ˩ dʑ o ˩  
ʈʂʰɯ˩tɕi˥	ʈʂʰ ɯ ˩ tɕ i ˥  
ʈʂʰɯ˩v̩˩ɳɯ˥	ʈʂʰ ɯ ˩ v̩ ˩ ɳ ɯ ˥  
ʈʂʰɯ˩ɭɯ˩	ʈʂʰ ɯ ˩ ɭ ɯ ˩  
ʈʂʰɯ˩ʁo˩	ʈʂʰ ɯ ˩ ʁ o ˩  
ʈʂʰɻ	ʈʂʰ ɻ  
ʈʂʰɻ̍˧	ʈʂʰ ɻ̍ ˧  
ʈʰ	ʈʰ  
ʈʰv̩˧kʰɯ˧qo˥ɳɯ˩dʑo˩	ʈʰ v̩ ˧ kʰ ɯ ˧ q o ˥ ɳ ɯ ˩ dʑ o ˩  
ʈʰææ̃˧ɳɯ˩	ʈʰ æ æ̃ ˧ ɳ ɯ ˩  
ʈʰææ̃˧˥	ʈʰ æ æ̃ ˧˥  
ʈʰæ˥ki˩ɲi˩	ʈʰ æ ˥ k i ˩ ɲ i ˩  
ʈʰæ˧mɤ˥kv̩˩tsɯ˩	ʈʰ æ ˧ m ɤ ˥ k v̩ ˩ ts ɯ ˩  
ʈʰæ˧q	ʈʰ æ ˧ q  
ʈʰæ˧qo˩	ʈʰ æ ˧ q o ˩  
ʈʰæ˧qʰwɤ˥	ʈʰ æ ˧ qʰ wɤ ˥  
ʈʰæ˧qʰwɤ˧dʑi˧hṽ˧	ʈʰ æ ˧ qʰ wɤ ˧ dʑ i ˧ h ṽ ˧  
ʈʰæ˧ʈʰæ˧˥	ʈʰ æ ˧ ʈʰ æ ˧˥  
ʈʰæ˩ho˩	ʈʰ æ ˩ h o ˩  
ʈʰæ˩ho˩pi˩	ʈʰ æ ˩ h o ˩ p i ˩  
ʈʰæ˩ho˩ze˩	ʈʰ æ ˩ h o ˩ z e ˩  
ʈʰæ˩ki˩	ʈʰ æ ˩ k i ˩  
ʈʰɯ˧bi˧pi˥bi˩	ʈʰ ɯ ˧ b i ˧ p i ˥ b i ˩  
ʈʰɯ˧gi˧bi˥	ʈʰ ɯ ˧ g i ˧ b i ˥  
ʈʰɯ˧kwɤ˧tɕɯ˥lɑ˩	ʈʰ ɯ ˧ k wɤ ˧ tɕ ɯ ˥ l ɑ ˩  
ʈʰɯ˧se˥gɤ˩dʑo˩	ʈʰ ɯ ˧ s e ˥ g ɤ ˩ dʑ o ˩  
ʈʰɯ˧se˥gɤ˩se˩	ʈʰ ɯ ˧ s e ˥ g ɤ ˩ s e ˩  
ʈʰɯ˧˥	ʈʰ ɯ ˧˥  
ʈʰɯ˩ho˩dʑo˩	ʈʰ ɯ ˩ h o ˩ dʑ o ˩  
ʈʰɯ˩ho˩˥	ʈʰ ɯ ˩ h o ˩˥  
ʈʰɯ˩jo˩ɻ̍˩	ʈʰ ɯ ˩ jo ˩ ɻ̍ ˩  
ʈʰɯ˩kv̩˩bi˩	ʈʰ ɯ ˩ k v̩ ˩ b i ˩  
ʈʰɯ˩kwɤ˩tɕɯ˥lɑ˩	ʈʰ ɯ ˩ k wɤ ˩ tɕ ɯ ˥ l ɑ ˩  
ʈʰɯ˩kʰɯ˩bi˩ze˩	ʈʰ ɯ ˩ kʰ ɯ ˩ b i ˩ z e ˩  
ʈʰɯ˩mɤ˩lv̩˥	ʈʰ ɯ ˩ m ɤ ˩ l v̩ ˥  
ʈʰɯ˩mɤ˩lv̩˧	ʈʰ ɯ ˩ m ɤ ˩ l v̩ ˧  
ʈʰɯ˩se˩gɤ˥	ʈʰ ɯ ˩ s e ˩ g ɤ ˥  
ʈʰɯ˩ɲi˥tsɯ˩	ʈʰ ɯ ˩ ɲ i ˥ ts ɯ ˩  
ʐo˩kv̩˩tsɯ˥mæ˩	ʐ o ˩ k v̩ ˩ ts ɯ ˥ m æ ˩  
ʐo˩tɕʰæ˩ɻæ˥	ʐ o ˩ tɕʰ æ ˩ ɻ æ ˥  
ʐv̩˥hĩ˩ʈʂʰɯ˩	ʐ v̩ ˥ h ĩ ˩ ʈʂʰ ɯ ˩  
ʐv̩˧di˧	ʐ v̩ ˧ d i ˧  
ʐv̩˧di˧ki˥	ʐ v̩ ˧ d i ˧ k i ˥  
ʐv̩˧di˧pi˥kv̩˩ze˩	ʐ v̩ ˧ d i ˧ p i ˥ k v̩ ˩ z e ˩  
ʐv̩˧kʰv̩˩	ʐ v̩ ˧ kʰ v̩ ˩  
ʐv̩˧mi˧	ʐ v̩ ˧ m i ˧  
ʐv̩˧tsʰi˧ʑi˩	ʐ v̩ ˧ tsʰ i ˧ ʑ i ˩  
ʐv̩˧tsʰi˩	ʐ v̩ ˧ tsʰ i ˩  
ʐv̩˧tsʰi˩gv̩˩hɑ̃˩	ʐ v̩ ˧ tsʰ i ˩ g v̩ ˩ h ɑ̃ ˩  
ʐv̩˧tsʰi˩kʰv̩˩	ʐ v̩ ˧ tsʰ i ˩ kʰ v̩ ˩  
ʐv̩˧tsʰi˩kʰv̩˩ɳɯ˩ɳ	ʐ v̩ ˧ tsʰ i ˩ kʰ v̩ ˩ ɳ ɯ ˩ ɳ  
ʐv̩˧tsʰi˩ɭɯ˩	ʐ v̩ ˧ tsʰ i ˩ ɭ ɯ ˩  
ʐv̩˧v̩˧	ʐ v̩ ˧ v̩ ˧  
ʐv̩˧˥	ʐ v̩ ˧˥  
ʐv̩˩	ʐ v̩ ˩  
ʐv̩˩kv̩˩hĩ˥	ʐ v̩ ˩ k v̩ ˩ h ĩ ˥  
ʐv̩˩ɬi˩mi˩lɑ˥	ʐ v̩ ˩ ɬ i ˩ m i ˩ l ɑ ˥  
ʐv̩˩ɬi˩mi˩qo˩dʑo˩	ʐ v̩ ˩ ɬ i ˩ m i ˩ q o ˩ dʑ o ˩  
ʐv̩˩ɭɯ˥	ʐ v̩ ˩ ɭ ɯ ˥  
ʐv̩˩ɭɯ˩	ʐ v̩ ˩ ɭ ɯ ˩  
ʐv̩˩ɲi˩tsɯ˩	ʐ v̩ ˩ ɲ i ˩ ts ɯ ˩  
ʐw	ʐ w  
ʐwæ˧bv̩˧	ʐ wæ ˧ b v̩ ˧  
ʐwæ˧hɑ˧	ʐ wæ ˧ h ɑ ˧  
ʐwæ˧hɑ˧no˧˥	ʐ wæ ˧ h ɑ ˧ n o ˧˥  
ʐwæ˧mɤ˧zo˧ɲi˥	ʐ wæ ˧ m ɤ ˧ z o ˧ ɲ i ˥  
ʐwæ˧pv̩˩dzi˩	ʐ wæ ˧ p v̩ ˩ dz i ˩  
ʐwæ˧pv̩˩dzi˩ʁo˩to˩ɳɯ˩dʑo˩	ʐ wæ ˧ p v̩ ˩ dz i ˩ ʁ o ˩ t o ˩ ɳ ɯ ˩ dʑ o ˩  
ʐwæ˧tɕɯ˩	ʐ wæ ˧ tɕ ɯ ˩  
ʐwæ˧zɯ˧	ʐ wæ ˧ z ɯ ˧  
ʐwæ˧ʁo˧to˩	ʐ wæ ˧ ʁ o ˧ t o ˩  
ʐwæ˧ʈʂʰɯ˧dʑo˩	ʐ wæ ˧ ʈʂʰ ɯ ˧ dʑ o ˩  
ʐwæ˩kv̩˥	ʐ wæ ˩ k v̩ ˥  
ʐwæ˩mi˩tʰv̩˩v̩˩˥	ʐ wæ ˩ m i ˩ tʰ v̩ ˩ v̩ ˩˥  
ʐwæ˩mi˩˥	ʐ wæ ˩ m i ˩˥  
ʐwæ˩ɲi˥tsɯ˩	ʐ wæ ˩ ɲ i ˥ ts ɯ ˩  
ʐwæ˩ɲi˥ze˩	ʐ wæ ˩ ɲ i ˥ z e ˩  
ʐwɤ˧mɤ˧ho˩ze˩	ʐ wɤ ˧ m ɤ ˧ h o ˩ z e ˩  
ʐwɤ˧ʐwɤ˩	ʐ wɤ ˧ ʐ wɤ ˩  
ʐwɤ˧ʐwɤ˩dʑo˩	ʐ wɤ ˧ ʐ wɤ ˩ dʑ o ˩  
ʐwɤ˧ʐwɤ˩ɻ˩	ʐ wɤ ˧ ʐ wɤ ˩ ɻ ˩  
ʐwɤ˧˥	ʐ wɤ ˧˥  
ʐwɤ˩dʑo˥	ʐ wɤ ˩ dʑ o ˥  
ʐwɤ˩dʑo˩	ʐ wɤ ˩ dʑ o ˩  
ʐwɤ˩dʑo˩˥	ʐ wɤ ˩ dʑ o ˩˥  
ʐwɤ˩dʑɯ˩	ʐ wɤ ˩ dʑ ɯ ˩  
ʐwɤ˩dʑɯ˩kv̩˥	ʐ wɤ ˩ dʑ ɯ ˩ k v̩ ˥  
ʐwɤ˩dʑɯ˩tsɯ˥	ʐ wɤ ˩ dʑ ɯ ˩ ts ɯ ˥  
ʐwɤ˩hõ˩˥	ʐ wɤ ˩ h õ ˩˥  
ʐwɤ˩kv̩˩pi˥	ʐ wɤ ˩ k v̩ ˩ p i ˥  
ʐwɤ˩kv̩˩tsɯ˥	ʐ wɤ ˩ k v̩ ˩ ts ɯ ˥  
ʐwɤ˩mɤ˩hĩ˩hĩ˥tʰv̩˩	ʐ wɤ ˩ m ɤ ˩ h ĩ ˩ h ĩ ˥ tʰ v̩ ˩  
ʐwɤ˩pi˩tsɯ˥	ʐ wɤ ˩ p i ˩ ts ɯ ˥  
ʐwɤ˩tsɯ˩	ʐ wɤ ˩ ts ɯ ˩  
ʐwɤ˩zo˥	ʐ wɤ ˩ z o ˥  
ʐwɤ˩ɲi˥	ʐ wɤ ˩ ɲ i ˥  
ʐæ˧v̩˩	ʐ æ ˧ v̩ ˩  
ʐæ˩ʂæ˥hĩ˩dʑo˩	ʐ æ ˩ ʂ æ ˥ h ĩ ˩ dʑ o ˩  
ʐæ˩ʂæ˥hĩ˩ɳɯ˩	ʐ æ ˩ ʂ æ ˥ h ĩ ˩ ɳ ɯ ˩  
ʐæ˩ʂæ˧	ʐ æ ˩ ʂ æ ˧  
ʐæ˩˥	ʐ æ ˩˥  
ʐɤ˥	ʐ ɤ ˥  
ʐɤ˧hĩ˧	ʐ ɤ ˧ h ĩ ˧  
ʐɤ˧kv̩˧tsɯ˥	ʐ ɤ ˧ k v̩ ˧ ts ɯ ˥  
ʐɤ˧tso˧ɲi˥	ʐ ɤ ˧ ts o ˧ ɲ i ˥  
ʐɤ˩mi˩	ʐ ɤ ˩ m i ˩  
ʐɤ˩mi˩qo˥dʑo˩	ʐ ɤ ˩ m i ˩ q o ˥ dʑ o ˩  
ʐɤ˩mi˩ʈʂʰɯ˥	ʐ ɤ ˩ m i ˩ ʈʂʰ ɯ ˥  
ʐɤ˩ni˧hĩ˧ɻæ˥dʑo˩	ʐ ɤ ˩ n i ˧ h ĩ ˧ ɻ æ ˥ dʑ o ˩  
ʐɤ˩tso˥ɲi˩	ʐ ɤ ˩ ts o ˥ ɲ i ˩  
ʐɯ˧dzi˧	ʐ ɯ ˧ dz i ˧  
ʐɯ˧dzi˧dʑo˥	ʐ ɯ ˧ dz i ˧ dʑ o ˥  
ʐɯ˧dzi˧hĩ˧bv̩˧	ʐ ɯ ˧ dz i ˧ h ĩ ˧ b v̩ ˧  
ʐɯ˧hwɤ˩	ʐ ɯ ˧ h wɤ ˩  
ʐɯ˧hwɤ˩hĩ˩	ʐ ɯ ˧ h wɤ ˩ h ĩ ˩  
ʐɯ˧lɑ˧	ʐ ɯ ˧ l ɑ ˧  
ʐɯ˧sɯ˥	ʐ ɯ ˧ s ɯ ˥  
ʐɯ˧sɯ˧	ʐ ɯ ˧ s ɯ ˧  
ʐɯ˩mo˧	ʐ ɯ ˩ m o ˧  
ʐɯ˩mo˧pi˥	ʐ ɯ ˩ m o ˧ p i ˥  
ʐɯ˩mo˧tʰv̩˥dʑo˩	ʐ ɯ ˩ m o ˧ tʰ v̩ ˥ dʑ o ˩  
ʐɯ˩mo˧ʈʂʰɯ˥	ʐ ɯ ˩ m o ˧ ʈʂʰ ɯ ˥  
ʐɯ˩mo˧˥	ʐ ɯ ˩ m o ˧˥  
ʐɯ˩pi˥	ʐ ɯ ˩ p i ˥  
ʐɯ˩tsɯ˧	ʐ ɯ ˩ ts ɯ ˧  
ʐɯ˩ɳɯ˥	ʐ ɯ ˩ ɳ ɯ ˥  
ʐɯ˩ʐɤ˩ʐɯ˧ʐɤ˧pi˥	ʐ ɯ ˩ ʐ ɤ ˩ ʐ ɯ ˧ ʐ ɤ ˧ p i ˥  
ʑ	ʑ  
ʑi˥	ʑ i ˥  
ʑi˧dv̩˧	ʑ i ˧ d v̩ ˧  
ʑi˧mi˧dʑo˧	ʑ i ˧ m i ˧ dʑ o ˧  
ʑi˧mi˧ʈʂʰɯ˧	ʑ i ˧ m i ˧ ʈʂʰ ɯ ˧  
ʑi˧qʰwɤ˧qæ˧do˧	ʑ i ˧ qʰ wɤ ˧ q æ ˧ d o ˧  
ʑi˧qʰwɤ˧ʈʂʰɯ˧dʑo˩	ʑ i ˧ qʰ wɤ ˧ ʈʂʰ ɯ ˧ dʑ o ˩  
ʑi˧qʰwɤ˧˥	ʑ i ˧ qʰ wɤ ˧˥  
ʑi˧ɻ̍˥dʑo˩	ʑ i ˧ ɻ̍ ˥ dʑ o ˩  
ʑi˧ɻ̍˩	ʑ i ˧ ɻ̍ ˩  
ʑi˧ʁæ˧	ʑ i ˧ ʁ æ ˧  
ʑi˧˥	ʑ i ˧˥  
ʑi˩kʰɯ˩	ʑ i ˩ kʰ ɯ ˩  
ʑi˩mɤ˩hĩ˩	ʑ i ˩ m ɤ ˩ h ĩ ˩  
ʑi˩nv̩˩mi˩	ʑ i ˩ n v̩ ˩ m i ˩  
ʝ	ʝ  
ʝi˥hĩ˩lɑ˩	ʝ i ˥ h ĩ ˩ l ɑ ˩  
ʝi˥ho˩ze˩tsɯ˩	ʝ i ˥ h o ˩ z e ˩ ts ɯ ˩  
ʝi˥kv̩˩ze˩mæ˩	ʝ i ˥ k v̩ ˩ z e ˩ m æ ˩  
ʝi˥kʰɯ˩bi˩	ʝ i ˥ kʰ ɯ ˩ b i ˩  
ʝi˥kʰɯ˩dʑo˩	ʝ i ˥ kʰ ɯ ˩ dʑ o ˩  
ʝi˥mɤ˩ɖo˩	ʝ i ˥ m ɤ ˩ ɖ o ˩  
ʝi˥pi˩zo˩	ʝ i ˥ p i ˩ z o ˩  
ʝi˥zo˩kv̩˩	ʝ i ˥ z o ˩ k v̩ ˩  
ʝi˥ɲi˩	ʝ i ˥ ɲ i ˩  
ʝi˧bi˥	ʝ i ˧ b i ˥  
ʝi˧bi˧bi˧	ʝ i ˧ b i ˧ b i ˧  
ʝi˧bi˧di˧˥	ʝ i ˧ b i ˧ d i ˧˥  
ʝi˧di˥	ʝ i ˧ d i ˥  
ʝi˧di˧	ʝ i ˧ d i ˧  
ʝi˧hɯ˧	ʝ i ˧ h ɯ ˧  
ʝi˧jɤ˧˥	ʝ i ˧ jɤ ˧˥  
ʝi˧k	ʝ i ˧ k  
ʝi˧kv̩˥	ʝ i ˧ k v̩ ˥  
ʝi˧kv̩˥ɲi˩	ʝ i ˧ k v̩ ˥ ɲ i ˩  
ʝi˧kv̩˩ze˩mæ˩	ʝ i ˧ k v̩ ˩ z e ˩ m æ ˩  
ʝi˧kʰv̩˥ʝi˩kʰv̩˩dʑo˩	ʝ i ˧ kʰ v̩ ˥ ʝ i ˩ kʰ v̩ ˩ dʑ o ˩  
ʝi˧kʰwɤ˥	ʝ i ˧ kʰ wɤ ˥  
ʝi˧kʰɯ˩	ʝ i ˧ kʰ ɯ ˩  
ʝi˧le˧lv̩˩hĩ˩bv̩˩	ʝ i ˧ l e ˧ l v̩ ˩ h ĩ ˩ b v̩ ˩  
ʝi˧lo˧	ʝ i ˧ l o ˧  
ʝi˧lv̩˧bv̩˥	ʝ i ˧ l v̩ ˧ b v̩ ˥  
ʝi˧lv̩˧ɲi˥tsɯ˩	ʝ i ˧ l v̩ ˧ ɲ i ˥ ts ɯ ˩  
ʝi˧mɤ˧bi˧	ʝ i ˧ m ɤ ˧ b i ˧  
ʝi˧mɤ˧kv̩˩	ʝ i ˧ m ɤ ˧ k v̩ ˩  
ʝi˧mɤ˧zo˧ze˩	ʝ i ˧ m ɤ ˧ z o ˧ z e ˩  
ʝi˧pv̩˥kʰɯ˩	ʝ i ˧ p v̩ ˥ kʰ ɯ ˩  
ʝi˧pv̩˥kʰɯ˩ɲi˩mæ˩	ʝ i ˧ p v̩ ˥ kʰ ɯ ˩ ɲ i ˩ m æ ˩  
ʝi˧qv̩˥pi˩zo˩	ʝ i ˧ q v̩ ˥ p i ˩ z o ˩  
ʝi˧qv̩˥ʈʂʰɯ˩	ʝ i ˧ q v̩ ˥ ʈʂʰ ɯ ˩  
ʝi˧se˧hĩ˧bv̩˧	ʝ i ˧ s e ˧ h ĩ ˧ b v̩ ˧  
ʝi˧se˧ɲi˩pi˩	ʝ i ˧ s e ˧ ɲ i ˩ p i ˩  
ʝi˧sɯ˥dʑo˩	ʝ i ˧ s ɯ ˥ dʑ o ˩  
ʝi˧tʰv̩˧	ʝ i ˧ tʰ v̩ ˧  
ʝi˧zo˧ho˩	ʝ i ˧ z o ˧ h o ˩  
ʝi˧zo˧kv̩˩pi˩	ʝ i ˧ z o ˧ k v̩ ˩ p i ˩  
ʝi˧zo˧ɲi˥tsɯ˩	ʝ i ˧ z o ˧ ɲ i ˥ ts ɯ ˩  
ʝi˧ɣɯ˥	ʝ i ˧ ɣ ɯ ˥  
ʝi˧ɣɯ˥dzɑ˩qʰwɤ˩ʈʂʰɯ˩	ʝ i ˧ ɣ ɯ ˥ dz ɑ ˩ qʰ wɤ ˩ ʈʂʰ ɯ ˩  
ʝi˧ɣɯ˥ʈʂʰɯ˩	ʝ i ˧ ɣ ɯ ˥ ʈʂʰ ɯ ˩  
ʝi˧ɭɯ˧	ʝ i ˧ ɭ ɯ ˧  
ʝi˧ɲi˥tsɯ˩mæ˩	ʝ i ˧ ɲ i ˥ ts ɯ ˩ m æ ˩  
ʝi˧ɲi˩	ʝ i ˧ ɲ i ˩  
ʝi˧ɻ̍˩	ʝ i ˧ ɻ̍ ˩  
ʝi˧ʂæ˧	ʝ i ˧ ʂ æ ˧  
ʝi˩	ʝ i ˩  
ʝi˩dʑo˩	ʝ i ˩ dʑ o ˩  
ʝi˩kv̩˩	ʝ i ˩ k v̩ ˩  
ʝi˩kʰv̩˩hɯ˩tsɯ˩	ʝ i ˩ kʰ v̩ ˩ h ɯ ˩ ts ɯ ˩  
ʝi˩qʰwɤ˩	ʝ i ˩ qʰ wɤ ˩  
ʝi˩tɕʰɤ˧kʰwɤ˧	ʝ i ˩ tɕʰ ɤ ˧ kʰ wɤ ˧  
ʝi˩tʰɑ˩ɲi˩ze˩mæ˩	ʝ i ˩ tʰ ɑ ˩ ɲ i ˩ z e ˩ m æ ˩  
ʝi˩zo˩	ʝ i ˩ z o ˩  
ʝi˩ɲi˩	ʝ i ˩ ɲ i ˩  
ʝi˩ɲi˩tsɯ˩	ʝ i ˩ ɲ i ˩ ts ɯ ˩  
